дисертациски	d i s ɛ r t a t͡s i s k i
продолжува	p r ɔ d ɔ ɫ ʒ u v a
нададе	n a d a d ɛ
досади	d ɔ s a d i
киселини	k i s ɛ l i n i
рачуле	r a t͡ʃ u l ɛ
отсуство	ɔ t s u s t v ɔ
ненадарен	n ɛ n a d a ɾ ɛ n
нелиценцирање	n ɛ l i t͡s ɛ n t͡s i ɾ a ɲ ɛ
колови	k ɔ ɫ ɔ v i
анализира	a n a l i z i ɾ a
судбоносен	s u d b ɔ n ɔ s ɛ n
ловор	ɫ ɔ v ɔ r
слабокрвен	s ɫ a b ɔ k r̩ v ɛ n
семиологија	s ɛ m i j ɔ ɫ ɔ ɡ i j a
бесцелен	b ɛ s t͡s ɛ l ɛ n
отплетува	ɔ t p l ɛ t u v a
презентација	p r ɛ z ɛ n t a t͡s i j a
џадиња	d͡ʒ a d i ɲ a
неприменување	n ɛ p r i m ɛ n u v a ɲ ɛ
злосторство	z ɫ ɔ s t ɔ r s t v ɔ
издрибла	i z d r i b ɫ a
немирисање	n ɛ m i r i s a ɲ ɛ
велипеток	v ɛ l i p ɛ t ɔ k
неклиматизиран	n ɛ k l i m a t i z i ɾ a n
печива	p ɛ t͡ʃ i v a
неблокиран	n ɛ b ɫ ɔ k i ɾ a n
драг	d r a k
измиван	i z m i v a n
дадиња	d a d i ɲ a
инкубатори	i ŋ k u b a t ɔ ɾ i
трубен	t r u b ɛ n
кумановка	k u m a n ɔ f k a
оттука	ɔ t t u k a
неактуализирање	n ɛ a k t u a l i z i ɾ a ɲ ɛ
громогласен	ɡ r ɔ m ɔ ɡ ɫ a s ɛ n
норвешки	n ɔ r v ɛ ʃ k i
трапови	t r a p ɔ v i
кошаркар	k ɔ ʃ a r k a r
сврзе	s v r̩ z ɛ
догматизам	d ɔ ɡ m a t i z a m
женствено	ʒ ɛ n s t v ɛ n ɔ
добротворен	d ɔ b r ɔ t v ɔ ɾ ɛ n
хокеист	x ɔ k ɛ i s t
венецуелка	v ɛ n ɛ t͡s u ɛ ɫ k a
близост	b l i z ɔ s t
освестува	ɔ s v ɛ s t u v a
сенкар	s ɛ ŋ k a r
планктон	p ɫ a ŋ k t ɔ n
обезвластување	ɔ b ɛ z v ɫ a s t u v a ɲ ɛ
исполни	i s p ɔ ɫ n i
неиздржан	n ɛ i z d r̩ ʒ a n
незачувување	n ɛ z a t͡ʃ u v u v a ɲ ɛ
пеликански	p ɛ l i k a n s k i
распердашува	r a s p ɛ r d a ʃ u v a
препакување	p r ɛ p a k u v a ɲ ɛ
нокширче	n ɔ k ʃ i r t͡ʃ ɛ
мразулче	m r a z u ɫ t͡ʃ ɛ
стрв	s t r̩ f
специјалец	s p ɛ t͡s i j a l ɛ t͡s
раслојување	r a s ɫ ɔ j u v a ɲ ɛ
целосен	t͡s ɛ ɫ ɔ s ɛ n
аниматор	a n i m a t ɔ r
активација	a k t i v a t͡s i j a
лем	l ɛ m
висина	v i s i n a
мариово	m a r i j ɔ v ɔ
наградуван	n a ɡ r a d u v a n
пруги	p r u ɡ i
легенда	l ɛ ɡ ɛ n d a
пасинок	p a s i n ɔ k
покачува	p ɔ k a t͡ʃ u v a
тиња	t i ɲ a
свилар	s v i ɫ a r
черепен	t͡ʃ ɛ ɾ ɛ p ɛ n
бекнува	b ɛ k n u v a
ризичност	r i z i t͡ʃ n ɔ s t
потполковници	p ɔ t p ɔ ɫ k ɔ v n i t͡s i
срами	s r a m i
свикува	s v i k u v a
измасиран	i z m a s i ɾ a n
непопустливост	n ɛ p ɔ p u s t l i v ɔ s t
чести	t͡ʃ ɛ s t i
воскосува	v ɔ s k ɔ s u v a
избавување	i z b a v u v a ɲ ɛ
попишувач	p ɔ p i ʃ u v a t͡ʃ
неиспилен	n ɛ i s p i l ɛ n
тритомен	t r i t ɔ m ɛ n
кондензација	k ɔ n d ɛ n z a t͡s i j a
збесне	z b ɛ s n ɛ
пороби	p ɔ ɾ ɔ b i
урне	u r n ɛ
п	p ə
омекнување	ɔ m ɛ k n u v a ɲ ɛ
разлошен	r a z ɫ ɔ ʃ ɛ n
дегустаторски	d ɛ ɡ u s t a t ɔ r s k i
изнадаван	i z n a d a v a n
прелетување	p r ɛ l ɛ t u v a ɲ ɛ
подзнак	p ɔ d z n a k
витези	v i t ɛ z i
шеснаес	ʃ ɛ s n a ɛ s
сигурен	s i ɡ u ɾ ɛ n
изнамрчи	i z n a m r̩ t͡ʃ i
контрабасист	k ɔ n t r a b a s i s t
неавтоматизиран	n a f t ɔ m a t i z i ɾ a n
живинарски	ʒ i v i n a r s k i
дотекува	d ɔ t ɛ k u v a
индонезиец	i n d ɔ n ɛ z i j ɛ t͡s
ректално	r ɛ k t a ɫ n ɔ
ретроспективност	r ɛ t r ɔ s p ɛ k t i v n ɔ s t
забушаван	z a b u ʃ a v a
епископски	ɛ p i s k ɔ p s k i
исцелува	i s t͡s ɛ ɫ u v a
иван	i v a n
дочува	d ɔ t͡ʃ u v a
киселински	k i s ɛ l i n s k i
етиопјанка	ɛ t i ɔ p j a ŋ k a
бури	b u ɾ i
змејски	z m ɛ j s k i
чекорење	t͡ʃ ɛ k ɔ ɾ ɛ ɲ ɛ
автостоперка	a f t ɔ s t ɔ p ɛ r k a
угнетување	u ɡ n ɛ t u v a ɲ ɛ
пипање	p i p a ɲ ɛ
снижи	s n i ʒ i
премиериште	p r ɛ m i ɛ ɾ i ʃ t ɛ
обиколи	ɔ b i k ɔ l i
муслиман	m u s l i m a n
копнежливо	k ɔ p n ɛ ʒ l i v ɔ
трговија	t r̩ ɡ ɔ v i j a
саѓа	s a ɟ a
отрови	ɔ t r ɔ v i
вдахнат	v d a x n a t
авиониште	a v i ɔ n i ʃ t ɛ
клукне	k ɫ u k n ɛ
соединување	s ɔ ɛ d i n u v a ɲ ɛ
крофне	k r ɔ f n ɛ
ранчер	r a n t͡ʃ ɛ r
доделкување	d ɔ d ɛ ɫ k u v a ɲ ɛ
смали	s m a l i
вработува	v r a b ɔ t u v a
прајазик	p r a j a z i k
потенцијално	p ɔ t ɛ n t͡s i j a ɫ n ɔ
велешанче	v ɛ l ɛ ʃ a n t͡ʃ ɛ
лицитиран	l i t͡s i t i ɾ a n
необлекување	n ɛ ɔ b l ɛ k u v a ɲ ɛ
тримесечен	t r i m ɛ s ɛ t͡ʃ ɛ n
желатински	ʒ ɛ ɫ a t i n s k i
глобализиран	ɡ ɫ ɔ b a l i z i ɾ a n
превртува	p r ɛ v r̩ t u v a
потпевнување	p ɔ t p ɛ v n u v a ɲ ɛ
шеј	ʃ ɛ j
непоткупливо	n ɛ p ɔ t k u p l i v ɔ
одвртен	ɔ d v r̩ t ɛ n
тросед	t r ɔ s ɛ t
гнасотија	ɡ n a s ɔ t i j a
чизбургер	t͡ʃ i z b u r ɡ ɛ r
ѓонови	ɟ ɔ n ɔ v i
литератури	l i t ɛ ɾ a t u ɾ i
идиотизам	i d i j ɔ t i z a m
непрекинлив	n ɛ p r ɛ k i n l i f
трне	t r̩ n ɛ
хормонално	x ɔ r m ɔ n a ɫ n ɔ
несправедливост	n ɛ s p r a v ɛ d l i v ɔ s t
чорапиште	t͡ʃ ɔ r a p i ʃ t ɛ
раскопчуван	r a s k ɔ p t͡ʃ u v a n
пречкртување	p r ɛ t͡ʃ k r̩ t u v a ɲ ɛ
наменет	n a m ɛ n ɛ t
беспричински	b ɛ s p r i t͡ʃ i n s k i
наврнат	n a v r̩ n a t
светлост	s v ɛ t ɫ ɔ s t
дувла	d u v ɫ a
запиран	z a p i ɾ a n
помодарка	p ɔ m ɔ d a r k a
сеница	s ɛ n i t͡s a
продекански	p r ɔ d ɛ k a n s k i
кориснички	k ɔ r i s n i t͡ʃ k i
папирологија	p a p i ɾ ɔ ɫ ɔ ɡ i j a
неследен	n ɛ s l ɛ d ɛ n
доларче	d ɔ ɫ a r t͡ʃ ɛ
фасцинантен	f a s t͡s i n a n t ɛ n
видливост	v i d l i v ɔ s t
фаланга	f a ɫ a ŋ ɡ a
убацува	u b a t͡s u v a
изумира	i z u m i ɾ a
отрезнување	ɔ t r ɛ z n u v a ɲ ɛ
тротоарче	t r ɔ t ɔ a r t͡ʃ ɛ
дамаски	d a m a s k i
разочара	r a z ɔ t͡ʃ a ɾ a
заврне	z a v r̩ n ɛ
бирање	b i ɾ a ɲ ɛ
кајсиичка	k a j s i i t͡ʃ k a
смачкување	s m a t͡ʃ k u v a ɲ ɛ
гори	ɡ ɔ ɾ i
забучи	z a b u t͡ʃ i
ломе	ɫ ɔ m ɛ
сом	s ɔ m
предупреден	p r ɛ d u p r ɛ d ɛ n
однесуван	ɔ d n ɛ s u v a n
исцртување	i s t͡s r̩ t u v a ɲ ɛ
нетолкување	n ɛ t ɔ ɫ k u v a ɲ ɛ
помодар	p ɔ m ɔ d a r
предјадења	p r ɛ d j a d ɛ ɲ a
трошач	t r ɔ ʃ a t͡ʃ
облее	ɔ b l ɛ ɛ
земјовладение	z ɛ m j ɔ v ɫ a d ɛ n i j ɛ
оморика	ɔ m ɔ ɾ i k a
блесок	b l ɛ s ɔ k
свилари	s v i ɫ a ɾ i
станче	s t a n t͡ʃ ɛ
картографиран	k a r t ɔ ɡ r a f i ɾ a n
манипулиран	m a n i p u l i ɾ a n
соблазни	s ɔ b ɫ a z n i
дообликување	d ɔ ɔ b l i k u v a ɲ ɛ
низина	n i z i n a
предрасположение	p r ɛ d r a s p ɔ ɫ ɔ ʒ ɛ n i j ɛ
имбецили	i m b ɛ t͡s i l i
вентилатори	v ɛ n t i ɫ a t ɔ ɾ i
предвесница	p r ɛ d v ɛ s n i t͡s a
оптимистичност	ɔ p t i m i s t i t͡ʃ n ɔ s t
хараре	x a r a ɾ ɛ
расфрла	r a s f r̩ ɫ a
раскокан	r a s k ɔ k a n
борч	b ɔ r t͡ʃ
издушуван	i z d u ʃ u v a n
доклика	d ɔ k l i k a
кокос	k ɔ k ɔ s
паганки	p a ɡ a ŋ k i
куќичка	k u c i t͡ʃ k a
ледина	l ɛ d i n a
кораб	k ɔ ɾ a p
бодри	b ɔ d r i
изгазен	i z ɡ a z ɛ n
качествен	k a t͡ʃ ɛ s t v ɛ n
ризикуван	r i z i k u v a n
престига	p r ɛ s t i ɡ a
конгоанец	k ɔ ŋ ɡ ɔ a n ɛ t͡s
прпелкање	p r̩ p ɛ ɫ k a ɲ ɛ
дијалошки	d i j a ɫ ɔ ʃ k i
расадува	r a s a d u v a
опортунистка	ɔ p ɔ r t u n i s t k a
писоар	p i s ɔ a r
стомниште	s t ɔ m n i ʃ t ɛ
губитнички	ɡ u b i t n i t͡ʃ k i
шминкан	ʃ m i ŋ k a n
фенирање	f ɛ n i ɾ a ɲ ɛ
кити	k i t i
делчевски	d ɛ ɫ t͡ʃ ɛ f s k i
доуредуван	d ɔ u r ɛ d u v a n
услов	u s ɫ ɔ f
невосприемање	n ɛ v ɔ s p r i ɛ m a ɲ ɛ
нелуфтирање	n ɛ ɫ u f t i ɾ a ɲ ɛ
надареност	n a d a ɾ ɛ n ɔ s t
транспониран	t r a n s p ɔ n i ɾ a n
неготинец	n ɛ ɡ ɔ t i n ɛ t͡s
константно	k ɔ n s t a n t n ɔ
одвратност	ɔ d v r a t n ɔ s t
парафира	p a ɾ a f i ɾ a
неподмачкување	n ɛ p ɔ d m a t͡ʃ k u v a ɲ ɛ
песочници	p ɛ s ɔ t͡ʃ n i t͡s i
постење	p ɔ s t ɛ ɲ ɛ
глави	ɡ ɫ a v i
шегаџика	ʃ ɛ ɡ a d͡ʒ i k a
хагиографија	x a ɡ i j ɔ ɡ r a f i j a
пердув	p ɛ r d u f
трогателно	t r ɔ ɡ a t ɛ ɫ n ɔ
пури	p u ɾ i
неиспупчен	n ɛ i s p u p t͡ʃ ɛ n
доразгледување	d ɔ ɾ a z ɡ l ɛ d u v a ɲ ɛ
трореден	t r ɔ ɾ ɛ d ɛ n
бујност	b u j n ɔ s t
клепки	k l ɛ p k i
отровница	ɔ t r ɔ v n i t͡s a
лавини	ɫ a v i n i
намалуван	n a m a ɫ u v a n
неготвење	n ɛ ɡ ɔ t v ɛ ɲ ɛ
месно	m ɛ s n ɔ
композиции	k ɔ m p ɔ z i t͡s i i
генерално	ɡ ɛ n ɛ r a ɫ n ɔ
канцероген	k a n t͡s ɛ ɾ ɔ ɡ ɛ n
подмолен	p ɔ d m ɔ l ɛ n
претерување	p r ɛ t ɛ r u v a ɲ ɛ
бескарактерен	b ɛ s k a r a k t ɛ ɾ ɛ n
вокализира	v ɔ k a l i z i ɾ a
дамнешен	d a m n ɛ ʃ ɛ n
камо	k a m ɔ
служење	s ɫ u ʒ ɛ ɲ ɛ
меше	m ɛ ʃ ɛ
клеца	k l ɛ t͡s a
разбуричка	r a z b u ɾ i t͡ʃ k a
помазаница	p ɔ m a z a n i t͡s a
америциум	a m ɛ r i t͡s i j u m
битност	b i t n ɔ s t
девери	d ɛ v ɛ ɾ i
неопоравување	n ɛ ɔ p ɔ ɾ a v u v a ɲ ɛ
пијанка	p i j a ŋ k a
сипаници	s i p a n i t͡s i
антибиотички	a n t i b i ɔ t i t͡ʃ k i
вденуван	v d ɛ n u v a n
одбегнување	ɔ d b ɛ ɡ n u v a ɲ ɛ
летаргија	l ɛ t a r ɡ i j a
испохефта	i s p ɔ x ɛ f t a
крштеница	k r̩ ʃ t ɛ n i t͡s a
дипломски	d i p ɫ ɔ m s k i
расположено	r a s p ɔ ɫ ɔ ʒ ɛ n ɔ
бифокален	b i f ɔ k a l ɛ n
раженче	r a ʒ ɛ n t͡ʃ ɛ
целивање	t͡s ɛ l i v a ɲ ɛ
азили	a z i l i
ортак	ɔ r t a k
штипалки	ʃ t i p a ɫ k i
изјазен	i z j a z ɛ n
одраз	ɔ d r a s
неред	n ɛ ɾ ɛ t
превезен	p r ɛ v ɛ z ɛ n
флуиден	f ɫ u i d ɛ n
комбенце	k ɔ m b ɛ n t͡s ɛ
поофка	p ɔ ɔ f k a
соба	s ɔ b a
ламја	ɫ a m j a
хрват	x r̩ v a t
гулаб	ɡ u ɫ a p
брава	b r a v a
развојно	r a z v ɔ j n ɔ
појача	p ɔ j a t͡ʃ a
неконтролиран	n ɛ k ɔ n t r ɔ l i ɾ a n
предрасположуван	p r ɛ d r a s p ɔ ɫ ɔ ʒ u v a n
избрука	i z b r u k a
чуки	t͡ʃ u k i
кумулонимбусен	k u m u ɫ ɔ n i m b u s ɛ n
стефан	s t ɛ f a n
пичкари	p i t͡ʃ k a ɾ i
расчетка	r a ʃ t͡ʃ ɛ t k a
миловиден	m i ɫ ɔ v i d ɛ n
вонсезонски	v ɔ n s ɛ z ɔ n s k i
накострешува	n a k ɔ s t r ɛ ʃ u v a
реформист	r ɛ f ɔ r m i s t
фрустрирање	f r u s t r i ɾ a ɲ ɛ
статистичар	s t a t i s t i t͡ʃ a r
засолнет	z a s ɔ ɫ n ɛ t
заврзува	z a v r̩ z u v a
антагонизам	a n t a ɡ ɔ n i z a m
вообразено	v ɔ ɔ b r a z ɛ n ɔ
цвилење	t͡s v i l ɛ ɲ ɛ
поднамокри	p ɔ d n a m ɔ k r i
бут	b u t
усни	u s n i
разонода	r a z ɔ n ɔ d a
салон	s a ɫ ɔ n
неиселен	n ɛ i s ɛ l ɛ n
откочи	ɔ t k ɔ t͡ʃ i
притајува	p r i t a j u v a
непридржување	n ɛ p r i d r̩ ʒ u v a ɲ ɛ
прегрнат	p r ɛ ɡ r̩ n a t
раштркува	r a ʃ t r̩ k u v a
неповратен	n ɛ p ɔ v r a t ɛ n
небрежно	n ɛ b r ɛ ʒ n ɔ
пуристички	p u r i s t i t͡ʃ k i
дијагонален	d i j a ɡ ɔ n a l ɛ n
масен	m a s ɛ n
мбабане	m̩ b a b a n ɛ
доручек	d ɔ ɾ u t͡ʃ ɛ k
преса	p r ɛ s a
содржење	s ɔ d r̩ ʒ ɛ ɲ ɛ
засолнување	z a s ɔ ɫ n u v a ɲ ɛ
сантодомингоански	s a n t ɔ d ɔ m i ŋ ɡ ɔ a n s k i
варијанта	v a ɾ i j a n t a
пребричуван	p r ɛ b r i t͡ʃ u v a n
откупи	ɔ t k u p i
курвање	k u r v a ɲ ɛ
непростен	n ɛ p r ɔ s t ɛ n
џудо	d͡ʒ u d ɔ
налепници	n a l ɛ p n i t͡s i
алјаски	a ʎ a s k i
терористка	t ɛ ɾ ɔ r i s t k a
чембала	t͡ʃ ɛ m b a ɫ a
непара	n ɛ p a ɾ a
славољубивост	s ɫ a v ɔ ʎ u b i v ɔ s t
незалепен	n ɛ z a l ɛ p ɛ n
злотворен	z ɫ ɔ t v ɔ ɾ ɛ n
воздивнува	v ɔ z d i v n u v a
здружено	z d r u ʒ ɛ n ɔ
оружја	ɔ ɾ u ʒ j a
порочно	p ɔ ɾ ɔ t͡ʃ n ɔ
издлабуван	i z d ɫ a b u v a n
заговорник	z a ɡ ɔ v ɔ r n i k
заглавување	z a ɡ ɫ a v u v a ɲ ɛ
чувар	t͡ʃ u v a r
зашеметеност	z a ʃ ɛ m ɛ t ɛ n ɔ s t
астрономски	a s t r ɔ n ɔ m s k i
зобне	z ɔ b n ɛ
јонизиран	j ɔ n i z i ɾ a n
полно	p ɔ ɫ n ɔ
пицерија	p i t͡s ɛ ɾ i j a
кикиритка	k i k i r i t k a
харковски	x a r k ɔ f s k i
оклагија	ɔ k ɫ a ɡ i j a
сензуалност	s ɛ n z u a ɫ n ɔ s t
потир	p ɔ t i r
кавалер	k a v a l ɛ r
врвно	v r̩ v n ɔ
напнатост	n a p n a t ɔ s t
неозначен	n ɛ ɔ z n a t͡ʃ ɛ n
дунав	d u n a f
трипати	t r i p a t i
дополна	d ɔ p ɔ ɫ n a
прекисне	p r ɛ k i s n ɛ
солзен	s ɔ ɫ z ɛ n
осакатува	ɔ s a k a t u v a
болки	b ɔ ɫ k i
кигалиски	k i ɡ a l i s k i
конексија	k ɔ n ɛ k s i j a
палачинка	p a ɫ a t͡ʃ i ŋ k a
корумпиран	k ɔ ɾ u m p i ɾ a n
неизброен	n ɛ i z b r ɔ ɛ n
растаи	r a s t a i
земјопосед	z ɛ m j ɔ p ɔ s ɛ t
разбранува	r a z b r a n u v a
комесаријат	k ɔ m ɛ s a ɾ i j a t
калкирање	k a ɫ k i ɾ a ɲ ɛ
елен	ɛ l ɛ n
неистетовиран	n ɛ i s t ɛ t ɔ v i ɾ a n
билатерално	b i ɫ a t ɛ r a ɫ n ɔ
роеви	r ɔ ɛ v i
расече	r a s ɛ t͡ʃ ɛ
изотермичен	i z ɔ t ɛ r m i t͡ʃ ɛ n
соросоиден	s ɔ ɾ ɔ s ɔ i d ɛ n
опашки	ɔ p a ʃ k i
довиткува	d ɔ v i t k u v a
сношти	s n ɔ ʃ t i
давен	d a v ɛ n
џанак	d͡ʒ a n a k
словенски	s ɫ ɔ v ɛ n s k i
телекомуникациски	t ɛ l ɛ k ɔ m u n i k a t͡s i s k i
резимирање	r ɛ z i m i ɾ a ɲ ɛ
ѕвечкаво	d͡z v ɛ t͡ʃ k a v ɔ
мноштво	m n ɔ ʃ t v ɔ
забрзува	z a b r̩ z u v a
вајари	v a j a ɾ i
конечен	k ɔ n ɛ t͡ʃ ɛ n
стрес	s t r ɛ s
киевјанка	k i ɛ v j a ŋ k a
осаменост	ɔ s a m ɛ n ɔ s t
режимиште	r ɛ ʒ i m i ʃ t ɛ
внуков	v n u k ɔ f
засегне	z a s ɛ ɡ n ɛ
тест	t ɛ s t
преправање	p r ɛ p r a v a ɲ ɛ
непотполен	n ɛ p ɔ t p ɔ l ɛ n
необоснованост	n ɛ ɔ b ɔ s n ɔ v a n ɔ s t
навалуван	n a v a ɫ u v a n
материјалистка	m a t ɛ ɾ i j a l i s t k a
холдинг	x ɔ ɫ d i ŋ k
испотутка	i s p ɔ t u t k a
позеленува	p ɔ z ɛ l ɛ n u v a
хонијарски	x ɔ n i j a r s k i
камилица	k a m i l i t͡s a
узакони	u z a k ɔ n i
проблематизира	p r ɔ b l ɛ m a t i z i ɾ a
загрозеност	z a ɡ r ɔ z ɛ n ɔ s t
производителка	p r ɔ i z v ɔ d i t ɛ ɫ k a
зимата	z i m a t a
радијатор	r a d i j a t ɔ r
шалтер	ʃ a ɫ t ɛ r
бодибилдер	b ɔ d i b i ɫ d ɛ r
распишуван	r a s p i ʃ u v a n
чепкалка	t͡ʃ ɛ p k a ɫ k a
дупол	d u p ɔ ɫ
менѓуша	m ɛ ɲ ɟ u ʃ a
навечер	n a v ɛ t͡ʃ ɛ r
амалгамиран	a m a ɫ ɡ a m i ɾ a n
библиофил	b i b l i j ɔ f i ɫ
ќупови	c u p ɔ v i
бедирање	b ɛ d i ɾ a ɲ ɛ
удолу	u d ɔ ɫ u
боготски	b ɔ ɡ ɔ t s k i
грофови	ɡ r ɔ f ɔ v i
пламеница	p ɫ a m ɛ n i t͡s a
тиранизира	t i ɾ a n i z i ɾ a
овошје	ɔ v ɔ ʃ j ɛ
претрпен	p r ɛ t r̩ p ɛ n
шнајдер	ʃ n a j d ɛ r
помнење	p ɔ m n ɛ ɲ ɛ
фонетика	f ɔ n ɛ t i k a
засенчи	z a s ɛ n t͡ʃ i
придружуван	p r i d r u ʒ u v a n
домери	d ɔ m ɛ ɾ i
институт	i n s t i t u t
наковална	n a k ɔ v a ɫ n a
помавтан	p ɔ m a f t a n
испукува	i s p u k u v a
вртен	v r̩ t ɛ n
менарха	m ɛ n a r x a
англофил	a ŋ ɡ ɫ ɔ f i ɫ
расрди	r a s r̩ d i
кениски	k ɛ n i s k i
исекува	i s ɛ k u v a
аври	a v r i
сузбиен	s u z b i j ɛ n
цитоплазма	t͡s i t ɔ p ɫ a z m a
јазолче	j a z ɔ ɫ t͡ʃ ɛ
фокусирање	f ɔ k u s i ɾ a ɲ ɛ
истретира	i s t r ɛ t i ɾ a
формат	f ɔ r m a t
хронично	x r ɔ n i t͡ʃ n ɔ
бунарски	b u n a r s k i
радување	r a d u v a ɲ ɛ
затворан	z a t v ɔ ɾ a n
лекторира	l ɛ k t ɔ r i ɾ a
шкрга	ʃ k r̩ ɡ a
отпремнина	ɔ t p r ɛ m n i n a
балтија	b a ɫ t i j a
сопартиец	s ɔ p a r t i j ɛ t͡s
стрви	s t r̩ v i
родовник	r ɔ d ɔ v n i k
раселување	r a s ɛ ɫ u v a ɲ ɛ
нагласоци	n a ɡ ɫ a s ɔ t͡s i
ригански	r i ɡ a n s k i
акнување	a k n u v a ɲ ɛ
забен	z a b ɛ n
неделегиран	n ɛ d ɛ l ɛ ɡ i ɾ a n
противвоспалителен	p r ɔ t i v v ɔ s p a l i t ɛ l ɛ n
змиесто	z m i j ɛ s t ɔ
пригода	p r i ɡ ɔ d a
бодовен	b ɔ d ɔ v ɛ n
одличие	ɔ d l i t͡ʃ i j ɛ
изгубен	i z ɡ u b ɛ n
симона	s i m ɔ n a
ќесиште	c ɛ s i ʃ t ɛ
ладничок	ɫ a d n i t͡ʃ ɔ k
судење	s u d ɛ ɲ ɛ
монтажен	m ɔ n t a ʒ ɛ n
бесчувствителност	b ɛ ʃ t͡ʃ u f s t v i t ɛ ɫ n ɔ s t
штампа	ʃ t a m p a
килимарски	k i l i m a r s k i
затреба	z a t r ɛ b a
доле	d ɔ l ɛ
избоден	i z b ɔ d ɛ n
обучување	ɔ b u t͡ʃ u v a ɲ ɛ
оживее	ɔ ʒ i v ɛ ɛ
церче	t͡s ɛ r t͡ʃ ɛ
доплаќа	d ɔ p ɫ a c a
лингвист	l i ŋ ɡ v i s t
одвлекува	ɔ d v l ɛ k u v a
акварел	a k v a r ɛ ɫ
пречекорен	p r ɛ t͡ʃ ɛ k ɔ ɾ ɛ n
излачен	i z ɫ a t͡ʃ ɛ n
парижанка	p a r i ʒ a ŋ k a
буричкање	b u r i t͡ʃ k a ɲ ɛ
намачкување	n a m a t͡ʃ k u v a ɲ ɛ
детергент	d ɛ t ɛ r ɡ ɛ n t
полов	p ɔ ɫ ɔ f
непропустлив	n ɛ p r ɔ p u s t l i f
соја	s ɔ j a
поткрепи	p ɔ t k r ɛ p i
кувајќанка	k u v a j c a ŋ k a
вовчиња	v ɔ f t͡ʃ i ɲ a
напумпан	n a p u m p a n
утрапува	u t r a p u v a
сомуниште	s ɔ m u n i ʃ t ɛ
феноменологија	f ɛ n ɔ m ɛ n ɔ ɫ ɔ ɡ i j a
крикне	k r i k n ɛ
побутнуван	p ɔ b u t n u v a n
драматизира	d r a m a t i z i ɾ a
катче	k a t t͡ʃ ɛ
гризли	ɡ r i z l i
државјанин	d r̩ ʒ a v j a n i n
земјотресение	z ɛ m j ɔ t r ɛ s ɛ n i j ɛ
женољубец	ʒ ɛ n ɔ ʎ u b ɛ t͡s
изместување	i z m ɛ s t u v a ɲ ɛ
свршеница	s v r̩ ʃ ɛ n i t͡s a
вливајќи	v l i v a j c i
гризови	ɡ r i z ɔ v i
иновативност	i n ɔ v a t i v n ɔ s t
ломејски	ɫ ɔ m ɛ j s k i
интересирање	i n t ɛ ɾ ɛ s i ɾ a ɲ ɛ
немрднување	n ɛ m r̩ d n u v a ɲ ɛ
ветрулиња	v ɛ t r u l i ɲ a
скинува	s k i n u v a
поцрнува	p ɔ t͡s r̩ n u v a
прогноза	p r ɔ ɡ n ɔ z a
запленување	z a p l ɛ n u v a ɲ ɛ
соговорници	s ɔ ɡ ɔ v ɔ r n i t͡s i
портири	p ɔ r t i ɾ i
плаштаница	p ɫ a ʃ t a n i t͡s a
маѓепсница	m a ɟ ɛ p s n i t͡s a
мариовски	m a r i j ɔ f s k i
отрезнуван	ɔ t r ɛ z n u v a n
онеми	ɔ n ɛ m i
хиперактивно	x i p ɛ r a k t i v n ɔ
машкоданка	m a ʃ k ɔ d a ŋ k a
расади	r a s a d i
таинствен	t a i n s t v ɛ n
песниче	p ɛ s n i t͡ʃ ɛ
пајки	p a j k i
багажници	b a ɡ a ʒ n i t͡s i
обелување	ɔ b ɛ ɫ u v a ɲ ɛ
непредложување	n ɛ p r ɛ d ɫ ɔ ʒ u v a ɲ ɛ
почетоци	p ɔ t͡ʃ ɛ t ɔ t͡s i
маторици	m a t ɔ ɾ i t͡s i
непрепречен	n ɛ p r ɛ p r ɛ t͡ʃ ɛ n
реагира	r ɛ a ɡ i ɾ a
писател	p i s a t ɛ ɫ
тестер	t ɛ s t ɛ r
монокл	m ɔ n ɔ k ɫ̩
телиња	t ɛ l i ɲ a
уметничиште	u m ɛ t n i t͡ʃ i ʃ t ɛ
атаман	a t a m a n
оригиналност	ɔ ɾ i ɡ i n a ɫ n ɔ s t
бушилка	b u ʃ i ɫ k a
нередовен	n ɛ r ɛ d ɔ v ɛ n
попречно	p ɔ p r ɛ t͡ʃ n ɔ
неофашизам	n ɛ ɔ f a ʃ i z a m
боровинки	b ɔ r ɔ v i ŋ k i
нагмечуван	n a ɡ m ɛ t͡ʃ u v a n
екипиче	ɛ k i p i t͡ʃ ɛ
недостижно	n ɛ d ɔ s t i ʒ n ɔ
напакостува	n a p a k ɔ s t u v a
расфрлен	r a s f r̩ l ɛ n
муцки	m u t͡s k i
спасител	s p a s i t ɛ ɫ
пегла	p ɛ ɡ ɫ a
милина	m i l i n a
трупци	t r u p t͡s i
поднаместен	p ɔ d n a m ɛ s t ɛ n
расчепка	r a ʃ t͡ʃ ɛ p k a
дволичност	d v ɔ l i t͡ʃ n ɔ s t
егзотичност	ɛ ɡ z ɔ t i t͡ʃ n ɔ s t
титриран	t i t r i ɾ a n
слива	s l i v a
поднесување	p ɔ d n ɛ s u v a ɲ ɛ
михаил	m i x a i ɫ
прешкрта	p r ɛ ʃ k r̩ t a
заофка	z a ɔ f k a
фиде	f i d ɛ
генитивен	ɡ ɛ n i t i v ɛ n
налупан	n a ɫ u p a n
лекувачки	l ɛ k u v a t͡ʃ k i
небо	n ɛ b ɔ
изнесуван	i z n ɛ s u v a n
карта	k a r t a
зачитување	z a t͡ʃ i t u v a ɲ ɛ
подзачешла	p ɔ d z a t͡ʃ ɛ ʃ ɫ a
забушува	z a b u ʃ u v a
воздивне	v ɔ z d i v n ɛ
легитимно	l ɛ ɡ i t i m n ɔ
вжештен	v ʒ ɛ ʃ t ɛ n
разменет	r a z m ɛ n ɛ t
монети	m ɔ n ɛ t i
класифициран	k ɫ a s i f i t͡s i ɾ a n
санмаринец	s a n m a r i n ɛ t͡s
мизогинија	m i z ɔ ɡ i n i j a
нематеријално	n ɛ m a t ɛ ɾ i j a ɫ n ɔ
челичана	t͡ʃ ɛ l i t͡ʃ a n a
разљуби	r a z ʎ u b i
раскршува	r a s k r̩ ʃ u v a
калуѓерки	k a ɫ u ɟ ɛ r k i
сврзувачки	s v r̩ z u v a t͡ʃ k i
поплочи	p ɔ p ɫ ɔ t͡ʃ i
прередување	p r ɛ ɾ ɛ d u v a ɲ ɛ
покриви	p ɔ k r i v i
неличење	n ɛ l i t͡ʃ ɛ ɲ ɛ
аорта	a ɔ r t a
перцептивен	p ɛ r t͡s ɛ p t i v ɛ n
обезименет	ɔ b ɛ z i m ɛ n ɛ t
полуготов	p ɔ ɫ u ɡ ɔ t ɔ f
бибер	b i b ɛ r
утрапен	u t r a p ɛ n
патешественик	p a t ɛ ʃ ɛ s t v ɛ n i k
легално	l ɛ ɡ a ɫ n ɔ
менаџерски	m ɛ n a d͡ʒ ɛ r s k i
автомеханичари	a f t ɔ m ɛ x a n i t͡ʃ a ɾ i
простичок	p r ɔ s t i t͡ʃ ɔ k
намрси	n a m r̩ s i
наденува	n a d ɛ n u v a
мјанмар	m j a n m a r
воочлив	v ɔ ɔ t͡ʃ l i f
пионерски	p i j ɔ n ɛ r s k i
преиспита	p r ɛ i s p i t a
џавкајќи	d͡ʒ a f k a j c i
сонцуле	s ɔ n t͡s u l ɛ
неварирање	n ɛ v a r i ɾ a ɲ ɛ
калуѓерство	k a ɫ u ɟ ɛ r s t v ɔ
оддуван	ɔ d d u v a n
пропушта	p r ɔ p u ʃ t a
видрин	v i d r i n
обеспокои	ɔ b ɛ s p ɔ k ɔ i
фркне	f r̩ k n ɛ
ненадоместливост	n ɛ n a d ɔ m ɛ s t l i v ɔ s t
италијанец	i t a l i j a n ɛ t͡s
индустријализира	i n d u s t r i j a l i z i ɾ a
масиште	m a s i ʃ t ɛ
несебично	n ɛ s ɛ b i t͡ʃ n ɔ
пукнат	p u k n a t
ергативен	ɛ r ɡ a t i v ɛ n
спечалуван	s p ɛ t͡ʃ a ɫ u v a n
стандардизиран	s t a n d a r d i z i ɾ a n
подмладува	p ɔ d m ɫ a d u v a
ревматологија	r ɛ v m a t ɔ ɫ ɔ ɡ i j a
прекинувач	p r ɛ k i n u v a t͡ʃ
изумуван	i z u m u v a n
класика	k ɫ a s i k a
крекер	k r ɛ k ɛ r
мустаќлија	m u s t a c l i j a
слепо	s l ɛ p ɔ
еклер	ɛ k l ɛ r
богобојазливост	b ɔ ɡ ɔ b ɔ j a z l i v ɔ s t
изгладнување	i z ɡ ɫ a d n u v a ɲ ɛ
кодоши	k ɔ d ɔ ʃ i
вклучување	f k ɫ u t͡ʃ u v a ɲ ɛ
срца	s r̩ t͡s a
лемурче	l ɛ m u r t͡ʃ ɛ
дизелаш	d i z ɛ ɫ a ʃ
изживее	i ʒ ʒ i v ɛ ɛ
поткастрен	p ɔ t k a s t r ɛ n
неполнење	n ɛ p ɔ ɫ n ɛ ɲ ɛ
тиквица	t i k v i t͡s a
кумановски	k u m a n ɔ f s k i
ископување	i s k ɔ p u v a ɲ ɛ
љубејќи	ʎ u b ɛ j c i
веѓа	v ɛ ɟ a
нераскревање	n ɛ ɾ a s k r ɛ v a ɲ ɛ
ха	x a
нептун	n ɛ p t u n
лепотан	l ɛ p ɔ t a n
осуши	ɔ s u ʃ i
недавање	n ɛ d a v a ɲ ɛ
поштеди	p ɔ ʃ t ɛ d i
мнт	m ə n ə t ə
наблажување	n a b ɫ a ʒ u v a ɲ ɛ
налетува	n a l ɛ t u v a
разбистрување	r a z b i s t r u v a ɲ ɛ
резервација	r ɛ z ɛ r v a t͡s i j a
разбоксиран	r a z b ɔ k s i ɾ a n
ласици	ɫ a s i t͡s i
здодеан	z d ɔ d ɛ a n
хашки	x a ʃ k i
добрка	d ɔ b r̩ k a
малибу	m a l i b u
ќуркин	c u r k i n
фамилииште	f a m i l i i ʃ t ɛ
електризира	ɛ l ɛ k t r i z i ɾ a
реинкарнација	r ɛ i ŋ k a r n a t͡s i j a
кисели	k i s ɛ l i
повеќејазичен	p ɔ v ɛ c ɛ j a z i t͡ʃ ɛ n
гадурија	ɡ a d u ɾ i j a
огон	ɔ ɡ ɔ n
идентификување	i d ɛ n t i f i k u v a ɲ ɛ
доминирање	d ɔ m i n i ɾ a ɲ ɛ
грбче	ɡ r̩ p t͡ʃ ɛ
поплави	p ɔ p ɫ a v i
полза	p ɔ ɫ z a
оксидиран	ɔ k s i d i ɾ a n
лексикограф	l ɛ k s i k ɔ ɡ r a f
телефон	t ɛ l ɛ f ɔ n
ремонтира	r ɛ m ɔ n t i ɾ a
заслепувачки	z a s l ɛ p u v a t͡ʃ k i
брунејски	b r u n ɛ j s k i
одбирање	ɔ d b i ɾ a ɲ ɛ
солитер	s ɔ l i t ɛ r
нашлакан	n a ʃ ɫ a k a n
училишен	u t͡ʃ i l i ʃ ɛ n
заврши	z a v r̩ ʃ i
електричарка	ɛ l ɛ k t r i t͡ʃ a r k a
здравка	z d r a f k a
содржина	s ɔ d r̩ ʒ i n a
криќанец	k r i c a n ɛ t͡s
згазнува	z ɡ a z n u v a
немаркирање	n ɛ m a r k i ɾ a ɲ ɛ
барајќи	b a r a j c i
падарче	p a d a r t͡ʃ ɛ
омажи	ɔ m a ʒ i
лансиран	ɫ a n s i ɾ a n
пиратство	p i ɾ a t s t v ɔ
господ	ɡ ɔ s p ɔ t
продавница	p r ɔ d a v n i t͡s a
дрнка	d r̩ ŋ k a
варвари	v a r v a ɾ i
подбуцне	p ɔ d b u t͡s n ɛ
камилски	k a m i ɫ s k i
натумпани	n a t u m p a n i
изнуден	i z n u d ɛ n
макроекономија	m a k r ɔ ɛ k ɔ n ɔ m i j a
заглавен	z a ɡ ɫ a v ɛ n
два	d v a
брцање	b r̩ t͡s a ɲ ɛ
прелудиум	p r ɛ ɫ u d i j u m
сопственост	s ɔ p s t v ɛ n ɔ s t
мировен	m i ɾ ɔ v ɛ n
разурнувачки	r a z u r n u v a t͡ʃ k i
шарки	ʃ a r k i
немонтиран	n ɛ m ɔ n t i ɾ a n
адмирали	a d m i r a l i
нелегализирање	n ɛ l ɛ ɡ a l i z i ɾ a ɲ ɛ
превид	p r ɛ v i t
фреска	f r ɛ s k a
колоквиум	k ɔ ɫ ɔ k v i j u m
повртен	p ɔ v r̩ t ɛ n
топи	t ɔ p i
тенисериште	t ɛ n i s ɛ ɾ i ʃ t ɛ
океан	ɔ k ɛ a n
безропотен	b ɛ z r ɔ p ɔ t ɛ n
паузира	p a u z i ɾ a
подробност	p ɔ d r ɔ b n ɔ s t
плуто	p ɫ u t ɔ
бројче	b r ɔ j t͡ʃ ɛ
калеидоскоп	k a l ɛ i d ɔ s k ɔ p
инквизиција	i ŋ k v i z i t͡s i j a
конзистентен	k ɔ n z i s t ɛ n t ɛ n
рожба	r ɔ ʒ b a
хлор	x ɫ ɔ r
добитничка	d ɔ b i t n i t͡ʃ k a
датотека	d a t ɔ t ɛ k a
закажуван	z a k a ʒ u v a n
истумба	i s t u m b a
љ	ʎ ə
просторија	p r ɔ s t ɔ ɾ i j a
вообразби	v ɔ ɔ b r a z b i
панел	p a n ɛ ɫ
поништен	p ɔ n i ʃ t ɛ n
богота	b ɔ ɡ ɔ t a
спрегнат	s p r ɛ ɡ n a t
патарини	p a t a ɾ i n i
сенф	s ɛ ɱ f
шугаво	ʃ u ɡ a v ɔ
правилник	p r a v i ɫ n i k
истекува	i s t ɛ k u v a
растуран	r a s t u ɾ a n
солена	s ɔ l ɛ n a
архиварство	a r x i v a r s t v ɔ
истоштуван	i s t ɔ ʃ t u v a n
источкан	i s t ɔ t͡ʃ k a n
преморува	p r ɛ m ɔ ɾ u v a
вѕидан	v d͡z i d a n
неизговорлив	n ɛ i z ɡ ɔ v ɔ r l i f
закрила	z a k r i ɫ a
цер	t͡s ɛ r
двоглав	d v ɔ ɡ ɫ a f
ангажман	a ŋ ɡ a ʒ m a n
преиспитува	p r ɛ i s p i t u v a
вика	v i k a
објективност	ɔ b j ɛ k t i v n ɔ s t
докачен	d ɔ k a t͡ʃ ɛ n
ет	ɛ t
скијање	s k i j a ɲ ɛ
отплеткување	ɔ t p l ɛ t k u v a ɲ ɛ
мумла	m u m ɫ a
заклатување	z a k ɫ a t u v a ɲ ɛ
беспримерност	b ɛ s p r i m ɛ r n ɔ s t
џамиште	d͡ʒ a m i ʃ t ɛ
противприродно	p r ɔ t i f p r i ɾ ɔ d n ɔ
’рмбање	r̩ m b a ɲ ɛ
доистребен	d ɔ i s t r ɛ b ɛ n
нестрадање	n ɛ s t r a d a ɲ ɛ
плико	p l i k ɔ
дневен	d n ɛ v ɛ n
натрапничка	n a t r a p n i t͡ʃ k a
кингстон	k i ŋ k s t ɔ n
шампион	ʃ a m p i ɔ n
штурмовик	ʃ t u r m ɔ v i k
непамтење	n ɛ p a m t ɛ ɲ ɛ
шкотски	ʃ k ɔ t s k i
заљубува	z a ʎ u b u v a
фокусен	f ɔ k u s ɛ n
поротен	p ɔ ɾ ɔ t ɛ n
привилегија	p r i v i l ɛ ɡ i j a
филмаџии	f i ɫ m a d͡ʒ i i
зграпчен	z ɡ r a p t͡ʃ ɛ n
долготрајно	d ɔ ɫ ɡ ɔ t r a j n ɔ
здружен	z d r u ʒ ɛ n
шаманка	ʃ a m a ŋ k a
распојаса	r a s p ɔ j a s a
годи	ɡ ɔ d i
дисахарид	d i s a x a r i t
соговорник	s ɔ ɡ ɔ v ɔ r n i k
бигоросување	b i ɡ ɔ ɾ ɔ s u v a ɲ ɛ
јува	j u v a
пливање	p l i v a ɲ ɛ
пљукање	p ʎ u k a ɲ ɛ
суеверие	s u ɛ v ɛ ɾ i j ɛ
североисточен	s ɛ v ɛ ɾ ɔ i s t ɔ t͡ʃ ɛ n
трезно	t r ɛ z n ɔ
резистентно	r ɛ z i s t ɛ n t n ɔ
никозијка	n i k ɔ z i j k a
изгонување	i z ɡ ɔ n u v a ɲ ɛ
оцрни	ɔ t͡s r̩ n i
гоштева	ɡ ɔ ʃ t ɛ v a
возмутување	v ɔ z m u t u v a
гледан	ɡ l ɛ d a n
несплескан	n ɛ s p l ɛ s k a n
жанр	ʒ a n r̩
пилана	p i ɫ a n a
гостување	ɡ ɔ s t u v a ɲ ɛ
потекнување	p ɔ t ɛ k n u v a ɲ ɛ
паника	p a n i k a
негенериран	n ɛ ɡ ɛ n ɛ r i ɾ a n
гасеничар	ɡ a s ɛ n i t͡ʃ a r
нацеди	n a t͡s ɛ d i
глаголивост	ɡ ɫ a ɡ ɔ l i v ɔ s t
зрел	z r ɛ ɫ
дрвце	d r̩ f t͡s ɛ
толчник	t ɔ ɫ t͡ʃ n i k
нештетен	n ɛ ʃ t ɛ t ɛ n
нуакшотјанка	n u a k ʃ ɔ t j a ŋ k a
уличен	u l i t͡ʃ ɛ n
мотан	m ɔ t a n
манијачен	m a n i j a t͡ʃ ɛ n
крштевка	k r̩ ʃ t ɛ f k a
проклитичен	p r ɔ k l i t i t͡ʃ ɛ n
одговор	ɔ d ɡ ɔ v ɔ r
атар	a t a r
непокорност	n ɛ p ɔ k ɔ r n ɔ s t
бароници	b a r ɔ n i t͡s i
склучен	s k ɫ u t͡ʃ ɛ n
мисионерка	m i s i j ɔ n ɛ r k a
лаен	ɫ a ɛ n
хибридно	x i b r i d n ɔ
серолошки	s ɛ r ɔ ɫ ɔ ʃ k i
тапиран	t a p i ɾ a n
прикаска	p r i k a s k a
неотплатен	n ɛ ɔ t p ɫ a t ɛ n
регионализам	r ɛ ɡ i j ɔ n a l i z a m
вакуумиран	v a k u m i ɾ a n
ненагостен	n ɛ n a ɡ ɔ s t ɛ n
стокхолмци	s t ɔ k x ɔ ɫ m t͡s i
припадне	p r i p a d n ɛ
пребира	p r ɛ b i ɾ a
вонбрачно	v ɔ m b r a t͡ʃ n ɔ
командување	k ɔ m a n d u v a ɲ ɛ
просторно	p r ɔ s t ɔ r n ɔ
муабетче	m u a b ɛ t t͡ʃ ɛ
жупанија	ʒ u p a n i j a
изнакопан	i z n a k ɔ p a n
лепеза	l ɛ p ɛ z a
илјадница	i ʎ a d n i t͡s a
недовршен	n ɛ d ɔ v r̩ ʃ ɛ n
испремести	i s p r ɛ m ɛ s t i
врста	v r̩ s t a
лајка	ɫ a j k a
пржелика	p r̩ ʒ ɛ l i k a
спермицид	s p ɛ r m i t͡s i t
нередуциран	n ɛ ɾ ɛ d u t͡s i ɾ a n
прегазуван	p r ɛ ɡ a z u v a n
дивизија	d i v i z i j a
животинка	ʒ i v ɔ t i ŋ k a
проверува	p r ɔ v ɛ ɾ u v a
засмевање	z a s m ɛ v a ɲ ɛ
нуспроизвод	n u s p r ɔ i z v ɔ t
исчашен	i ʃ t͡ʃ a ʃ ɛ n
тастер	t a s t ɛ r
препевање	p r ɛ p ɛ v a ɲ ɛ
безмалку	b ɛ z m a ɫ k u
навидум	n a v i d u m
суванка	s u v a ŋ k a
географ	ɡ ɛ ɔ ɡ r a f
закрилник	z a k r i ɫ n i k
вијадукти	v i j a d u k t i
опсипан	ɔ p s i p a n
комитент	k ɔ m i t ɛ n t
најгвирц	n a j ɡ v i r t͡s
штрекнува	ʃ t r ɛ k n u v a
репортерка	r ɛ p ɔ r t ɛ r k a
неудобен	n ɛ u d ɔ b ɛ n
човечност	t͡ʃ ɔ v ɛ t͡ʃ n ɔ s t
јавачиште	j a v a t͡ʃ i ʃ t ɛ
импониран	i m p ɔ n i ɾ a n
одзади	ɔ d z a d i
сркан	s r̩ k a n
информиран	i ɱ f ɔ r m i ɾ a n
облие	ɔ b l i j ɛ
усвитува	u s v i t u v a
непроветрен	n ɛ p r ɔ v ɛ t r ɛ n
попее	p ɔ p ɛ ɛ
деветсто	d ɛ v ɛ t s t ɔ
дораскажува	d ɔ ɾ a s k a ʒ u v a
оптужување	ɔ p t u ʒ u v a ɲ ɛ
сомнителност	s ɔ m n i t ɛ ɫ n ɔ s t
крева	k r ɛ v a
разруши	r a z r u ʃ i
дебрчанец	d ɛ b r̩ t͡ʃ a n ɛ t͡s
епентеза	ɛ p ɛ n t ɛ z a
колнет	k ɔ ɫ n ɛ t
букира	b u k i ɾ a
неизгладен	n ɛ i z ɡ ɫ a d ɛ n
допроверува	d ɔ p r ɔ v ɛ ɾ u v a
чоколадиште	t͡ʃ ɔ k ɔ ɫ a d i ʃ t ɛ
повтарање	p ɔ f t a ɾ a ɲ ɛ
кореспонденција	k ɔ ɾ ɛ s p ɔ n d ɛ n t͡s i j a
поејќи	p ɔ ɛ j c i
кошници	k ɔ ʃ n i t͡s i
канаѓанка	k a n a ɟ a ŋ k a
осрамотуван	ɔ s r a m ɔ t u v a n
ако	a k ɔ
ајвари	a j v a ɾ i
обзнанет	ɔ b z n a n ɛ t
осакати	ɔ s a k a t i
гугање	ɡ u ɡ a ɲ ɛ
презакопуван	p r ɛ z a k ɔ p u v a n
рипнување	r i p n u v a ɲ ɛ
заклопи	z a k ɫ ɔ p i
препаратор	p r ɛ p a r a t ɔ r
плех	p l ɛ x
ливади	l i v a d i
непостење	n ɛ p ɔ s t ɛ ɲ ɛ
пушилница	p u ʃ i ɫ n i t͡s a
кљанка	k ʎ a ŋ k a
газа	ɡ a z a
етикетичка	ɛ t i k ɛ t i t͡ʃ k a
инцест	i n t͡s ɛ s t
прослави	p r ɔ s ɫ a v i
податок	p ɔ d a t ɔ k
нераздвоен	n ɛ r a z d v ɔ ɛ n
префарбан	p r ɛ f a r b a n
раширен	r a ʃ i ɾ ɛ n
онеспособување	ɔ n ɛ s p ɔ s ɔ b u v a ɲ ɛ
обусловуван	ɔ b u s ɫ ɔ v u v a n
пленик	p l ɛ n i k
молкома	m ɔ ɫ k ɔ m a
стокмува	s t ɔ k m u v a
обеќа	ɔ b ɛ c a
височок	v i s ɔ t͡ʃ ɔ k
меми	m ɛ m i
андорка	a n d ɔ r k a
пипа	p i p a
шилец	ʃ i l ɛ t͡s
налага	n a ɫ a ɡ a
српче	s r̩ p t͡ʃ ɛ
отпуштање	ɔ t p u ʃ t a ɲ ɛ
посипува	p ɔ s i p u v a
коректен	k ɔ r ɛ k t ɛ n
лажовен	ɫ a ʒ ɔ v ɛ n
гурабии	ɡ u r a b i i
колосален	k ɔ ɫ ɔ s a l ɛ n
подизлижан	p ɔ d i z l i ʒ a n
раскашавува	r a s k a ʃ a v u v a
сестриче	s ɛ s t r i t͡ʃ ɛ
кошта	k ɔ ʃ t a
потсмешлив	p ɔ t s m ɛ ʃ l i f
авантуристка	a v a n t u r i s t k a
сожалува	s ɔ ʒ a ɫ u v a
клоца	k ɫ ɔ t͡s a
морнар	m ɔ r n a r
змиест	z m i j ɛ s t
преживан	p r ɛ ʒ i v a n
прооден	p r ɔ ɔ d ɛ n
чудотворци	t͡ʃ u d ɔ t v ɔ r t͡s i
подизрамни	p ɔ d i z r a m n i
невлечење	n ɛ v l ɛ t͡ʃ ɛ ɲ ɛ
минималистка	m i n i m a l i s t k a
патешественици	p a t ɛ ʃ ɛ s t v ɛ n i t͡s i
мирудија	m i r u d i j a
собудува	s ɔ b u d u v a
подотрезнет	p ɔ d ɔ t r ɛ z n ɛ t
незакотвување	n ɛ z a k ɔ t v u v a ɲ ɛ
успаниченост	u s p a n i t͡ʃ ɛ n ɔ s t
глупаво	ɡ ɫ u p a v ɔ
брчење	b r̩ t͡ʃ ɛ ɲ ɛ
упс	u p s
земјотрес	z ɛ m j ɔ t r ɛ s
затвора	z a t v ɔ ɾ a
неприспособливо	n ɛ p r i s p ɔ s ɔ b l i v ɔ
невклопен	n ɛ f k ɫ ɔ p ɛ n
оптимален	ɔ p t i m a l ɛ n
испробува	i s p r ɔ b u v a
топаз	t ɔ p a s
неопходност	n ɛ ɔ p x ɔ d n ɔ s t
родилен	r ɔ d i l ɛ n
посветување	p ɔ s v ɛ t u v a ɲ ɛ
трети	t r ɛ t i
зевс	z ɛ f s
тутка	t u t k a
скројување	s k r ɔ j u v a ɲ ɛ
шанкери	ʃ a ŋ k ɛ ɾ i
шасија	ʃ a s i j a
жезло	ʒ ɛ z ɫ ɔ
опнување	ɔ p n u v a ɲ ɛ
оспорување	ɔ s p ɔ r u v a ɲ ɛ
стапување	s t a p u v a ɲ ɛ
епопеја	ɛ p ɔ p ɛ j a
арубиски	a r u b i s k i
дооблечен	d ɔ ɔ b l ɛ t͡ʃ ɛ n
филип	f i l i p
крадешкум	k r a d ɛ ʃ k u m
тамошен	t a m ɔ ʃ ɛ n
демантиран	d ɛ m a n t i ɾ a n
пишува	p i ʃ u v a
мнозински	m n ɔ z i n s k i
растечен	r a s t ɛ t͡ʃ ɛ n
јуфка	j u f k a
златица	z ɫ a t i t͡s a
меѓуножја	m ɛ ɟ u n ɔ ʒ j a
патоводен	p a t ɔ v ɔ d ɛ n
коскен	k ɔ s k ɛ n
богданци	b ɔ ɡ d a n t͡s i
малоумник	m a ɫ ɔ u m n i k
идолопоклоник	i d ɔ ɫ ɔ p ɔ k ɫ ɔ n i k
разврски	r a z v r̩ s k i
премелува	p r ɛ m ɛ ɫ u v a
геронтолошки	ɡ ɛ ɾ ɔ n t ɔ ɫ ɔ ʃ k i
хиерархиски	x i j ɛ r a r x i s k i
впечатливо	f p ɛ t͡ʃ a t l i v ɔ
несреќавање	n ɛ s r ɛ c a v a ɲ ɛ
лазар	ɫ a z a r
санхосеанец	s a ŋ x ɔ s ɛ a n ɛ t͡s
анка	a ŋ k a
полжавски	p ɔ ɫ ʒ a f s k i
оставински	ɔ s t a v i n s k i
курбан	k u r b a n
морски	m ɔ r s k i
професориште	p r ɔ f ɛ s ɔ ɾ i ʃ t ɛ
вакцини	v a k t͡s i n i
фунти	f u n t i
рудари	r u d a ɾ i
развратен	r a z v r a t ɛ n
разлошеност	r a z ɫ ɔ ʃ ɛ n ɔ s t
неовенат	n ɛ ɔ v ɛ n a t
стока	s t ɔ k a
страчкин	s t r a t͡ʃ k i n
урниса	u r n i s a
управувачи	u p r a v u v a t͡ʃ i
алоцира	a ɫ ɔ t͡s i ɾ a
чудовишност	t͡ʃ u d ɔ v i ʃ n ɔ s t
крекнување	k r ɛ k n u v a ɲ ɛ
шинат	ʃ i n a t
побиван	p ɔ b i v a n
смрди	s m r̩ d i
поддржувач	p ɔ d d r̩ ʒ u v a t͡ʃ
земјопоседник	z ɛ m j ɔ p ɔ s ɛ d n i k
поколение	p ɔ k ɔ l ɛ n i j ɛ
корпорациски	k ɔ r p ɔ r a t͡s i s k i
уназаден	u n a z a d ɛ n
управители	u p r a v i t ɛ l i
вдлабне	v d ɫ a b n ɛ
зачинет	z a t͡ʃ i n ɛ t
обожавателски	ɔ b ɔ ʒ a v a t ɛ ɫ s k i
мајмунка	m a j m u ŋ k a
здивне	z d i v n ɛ
елениште	ɛ l ɛ n i ʃ t ɛ
постепен	p ɔ s t ɛ p ɛ n
владар	v ɫ a d a r
ве	v ɛ
зрачење	z r a t͡ʃ ɛ ɲ ɛ
пивнува	p i v n u v a
лидерче	l i d ɛ r t͡ʃ ɛ
испитува	i s p i t u v a
деноноќие	d ɛ n ɔ n ɔ c i j ɛ
демонтирање	d ɛ m ɔ n t i ɾ a ɲ ɛ
столица	s t ɔ l i t͡s a
наиде	n a i d ɛ
лимонче	l i m ɔ n t͡ʃ ɛ
осовременува	ɔ s ɔ v r ɛ m ɛ n u v a
евентуално	ɛ v ɛ n t u a ɫ n ɔ
овчи	ɔ f t͡ʃ i
лајк	ɫ a j k
омачување	ɔ m a t͡ʃ u v a ɲ ɛ
воспоставување	v ɔ s p ɔ s t a v u v a ɲ ɛ
неетички	n ɛ ɛ t i t͡ʃ k i
доминикански	d ɔ m i n i k a n s k i
ас	a s
полјоделство	p ɔ ʎ ɔ d ɛ ɫ s t v ɔ
али	a l i
фоки	f ɔ k i
отсутно	ɔ t s u t n ɔ
отсликан	ɔ t s l i k a n
виничанче	v i n i t͡ʃ a n t͡ʃ ɛ
дпм	d ə p ə m ə
влагање	v ɫ a ɡ a ɲ ɛ
фаза	f a z a
класик	k ɫ a s i k
внедруван	v n ɛ d r u v a n
дочитан	d ɔ t͡ʃ i t a n
ликвидира	l i k v i d i ɾ a
амбуланти	a m b u ɫ a n t i
латиноамерикански	ɫ a t i n ɔ a m ɛ r i k a n s k i
подмлади	p ɔ d m ɫ a d i
калци	k a ɫ t͡s i
млати	m ɫ a t i
чибу	t͡ʃ i b u
бокалче	b ɔ k a ɫ t͡ʃ ɛ
трга	t r̩ ɡ a
доучува	d ɔ u t͡ʃ u v a
неспастрен	n ɛ s p a s t r ɛ n
кришум	k r i ʃ u m
миксер	m i k s ɛ r
скејтер	s k ɛ j t ɛ r
неисхранет	n ɛ i s x r a n ɛ t
сонча	s ɔ n t͡ʃ a
раја	r a j a
скандинавски	s k a n d i n a f s k i
ликвидирање	l i k v i d i ɾ a ɲ ɛ
некодифициран	n ɛ k ɔ d i f i t͡s i ɾ a n
небудење	n ɛ b u d ɛ ɲ ɛ
генијалец	ɡ ɛ n i j a l ɛ t͡s
рамнодушно	r a m n ɔ d u ʃ n ɔ
касај	k a s a j
завршно	z a v r̩ ʃ n ɔ
мачорски	m a t͡ʃ ɔ r s k i
трикотажен	t r i k ɔ t a ʒ ɛ n
творец	t v ɔ ɾ ɛ t͡s
раседлан	r a s ɛ d ɫ a n
романтично	r ɔ m a n t i t͡ʃ n ɔ
сања	s a ɲ a
верверичка	v ɛ r v ɛ ɾ i t͡ʃ k a
прекинување	p r ɛ k i n u v a ɲ ɛ
носорози	n ɔ s ɔ ɾ ɔ z i
плотови	p ɫ ɔ t ɔ v i
многулик	m n ɔ ɡ u l i k
науки	n a u k i
исфали	i s f a l i
нестиснат	n ɛ s t i s n a t
инжињер	i n ʒ i ɲ ɛ r
градбено	ɡ r a d b ɛ n ɔ
привлекуван	p r i v l ɛ k u v a n
недохранетост	n ɛ d ɔ x r a n ɛ t ɔ s t
преколнува	p r ɛ k ɔ ɫ n u v a
книжен	k n i ʒ ɛ n
горица	ɡ ɔ ɾ i t͡s a
конфигурира	k ɔ ɱ f i ɡ u r i ɾ a
малавијка	m a ɫ a v i j k a
нелекторирано	n ɛ l ɛ k t ɔ r i ɾ a n ɔ
поплавуван	p ɔ p ɫ a v u v a n
нагласува	n a ɡ ɫ a s u v a
’ркне	r̩ k n ɛ
инвалид	i ɱ v a l i t
зарѓави	z a r̩ ɟ a v i
неоткривање	n ɛ ɔ t k r i v a ɲ ɛ
напудрен	n a p u d r ɛ n
морков	m ɔ r k ɔ f
шашлив	ʃ a ʃ l i f
оглупавуван	ɔ ɡ ɫ u p a v u v a n
неаболиран	n ɛ a b ɔ l i ɾ a n
ладникав	ɫ a d n i k a f
мажественост	m a ʒ ɛ s t v ɛ n ɔ s t
зрее	z r ɛ ɛ
шура	ʃ u ɾ a
јаничарче	j a n i t͡ʃ a r t͡ʃ ɛ
несоблечен	n ɛ s ɔ b l ɛ t͡ʃ ɛ n
етикети	ɛ t i k ɛ t i
далечен	d a l ɛ t͡ʃ ɛ n
метреса	m ɛ t r ɛ s a
сјај	s j a j
појадување	p ɔ j a d u v a ɲ ɛ
подвлекува	p ɔ d v l ɛ k u v a
надменост	n a d m ɛ n ɔ s t
подносливо	p ɔ d n ɔ s l i v ɔ
хиенски	x i ɛ n s k i
стопли	s t ɔ p l i
дуалистка	d u a l i s t k a
доноси	d ɔ n ɔ s i
еуфемизам	ɛ u f ɛ m i z a m
леринчани	l ɛ r i n t͡ʃ a n i
гневови	ɡ n ɛ v ɔ v i
зголемен	z ɡ ɔ l ɛ m ɛ n
неѕидање	n ɛ d͡z i d a ɲ ɛ
кметува	k m ɛ t u v a
каузално	k a u z a ɫ n ɔ
менторка	m ɛ n t ɔ r k a
потсопне	p ɔ t s ɔ p n ɛ
разнебитен	r a z n ɛ b i t i
поти	p ɔ t i
отфрла	ɔ t f r̩ ɫ a
распали	r a s p a l i
итрец	i t r ɛ t͡s
троа	t r ɔ a
будалеење	b u d a l ɛ ɛ ɲ ɛ
лук	ɫ u k
говедарски	ɡ ɔ v ɛ d a r s k i
дошепнуван	d ɔ ʃ ɛ p n u v a n
ојаловен	ɔ j a ɫ ɔ v ɛ n
топорење	t ɔ p ɔ ɾ ɛ ɲ ɛ
маникерски	m a n i k ɛ r s k i
инспекторка	i n s p ɛ k t ɔ r k a
мотивираност	m ɔ t i v i ɾ a n ɔ s t
неподмитливост	n ɛ p ɔ d m i t l i v ɔ s t
проветруван	p r ɔ v ɛ t r u v a n
пресостави	p r ɛ s ɔ s t a v i
мое	m ɔ ɛ
империја	i m p ɛ ɾ i j a
кариран	k a r i ɾ a n
приврзаници	p r i v r̩ z a n i t͡s i
купен	k u p ɛ n
дождовници	d ɔ ʒ d ɔ v n i t͡s i
идилично	i d i l i t͡ʃ n ɔ
налутен	n a ɫ u t ɛ n
мамец	m a m ɛ t͡s
послужавник	p ɔ s ɫ u ʒ a v n i k
хибискус	x i b i s k u s
лабав	ɫ a b a f
заведен	z a v ɛ d ɛ n
збуни	z b u n i
непочитување	n ɛ p ɔ t͡ʃ i t u v a ɲ ɛ
маскатски	m a s k a t s k i
несреќен	n ɛ s r ɛ c ɛ n
осетлив	ɔ s ɛ t l i f
распознавање	r a s p ɔ z n a v a ɲ ɛ
облива	ɔ b l i v a
разлутување	r a z ɫ u t u v a ɲ ɛ
погано	p ɔ ɡ a n ɔ
ластиче	ɫ a s t i t͡ʃ ɛ
мајски	m a j s k i
молекули	m ɔ l ɛ k u l i
кофеин	k ɔ f ɛ i n
вежбовен	v ɛ ʒ b ɔ v ɛ n
мртвопроверител	m r̩ t v ɔ p r ɔ v ɛ ɾ i t ɛ ɫ
авторитетен	a f t ɔ ɾ i t ɛ t ɛ n
суета	s u ɛ t a
нагрдување	n a ɡ r̩ d u v a ɲ ɛ
добрина	d ɔ b r i n a
наследно	n a s l ɛ d n ɔ
фактури	f a k t u ɾ a
главатарски	ɡ ɫ a v a t a r s k i
рекетиран	r ɛ k ɛ t i ɾ a n
почва	p ɔ t͡ʃ v a
згоден	z ɡ ɔ d ɛ n
немигрирање	n ɛ m i ɡ r i ɾ a ɲ ɛ
еј	ɛ j
зорт	z ɔ r t
ќут	c u t
кама	k a m a
орасположи	ɔ ɾ a s p ɔ ɫ ɔ ʒ i
посвојуван	p ɔ s v ɔ j u v a n
материјалист	m a t ɛ ɾ i j a l i s t
виори	v i j ɔ ɾ i
бе	b ɛ
недошминкан	n ɛ d ɔ ʃ m i ŋ k a n
насмева	n a s m ɛ v a
овулација	ɔ v u ɫ a t͡s i j a
далечност	d a l ɛ t͡ʃ n ɔ s t
изземе	i z z ɛ m ɛ
портирски	p ɔ r t i r s k i
комитетлија	k ɔ m i t ɛ t l i j a
орка	ɔ r k a
распопуван	r a s p ɔ p u v a n
неоткован	n ɛ ɔ t k ɔ v a n
породилно	p ɔ r ɔ d i ɫ n ɔ
телефонира	t ɛ l ɛ f ɔ n i ɾ a
опаднат	ɔ p a d n a t
ќејф	c ɛ j f
богатство	b ɔ ɡ a t s t v ɔ
побожно	p ɔ b ɔ ʒ n ɔ
чамец	t͡ʃ a m ɛ t͡s
нишање	n i ʃ a ɲ ɛ
кифличка	k i f l i t͡ʃ k a
грешници	ɡ r ɛ ʃ n i t͡s i
успива	u s p i v a
вдомуван	v d ɔ m u v a n
демонтира	d ɛ m ɔ n t i ɾ a
гра	ɡ r a
копање	k ɔ p a ɲ ɛ
матурирање	m a t u r i ɾ a ɲ ɛ
заебавање	z a ɛ b a v a ɲ ɛ
окупира	ɔ k u p i ɾ a
лактозен	ɫ a k t ɔ z ɛ n
идеален	i d ɛ a l ɛ n
недознавање	n ɛ d ɔ z n a v a ɲ ɛ
катиљи	k a t i ʎ i
пициште	p i t͡s i ʃ t ɛ
јагленисан	j a ɡ l ɛ n i s a n
лулан	ɫ u ɫ a n
разгален	r a z ɡ a l ɛ n
латентен	ɫ a t ɛ n t ɛ n
јажар	j a ʒ a r
предочуван	p r ɛ d ɔ t͡ʃ u v a n
елеганција	ɛ l ɛ ɡ a n t͡s i j a
бессончев	b ɛ s s ɔ n t͡ʃ ɛ f
дораби	d ɔ ɾ a b i
одвраќање	ɔ d v r a c a ɲ ɛ
егоистка	ɛ ɡ ɔ i s t k a
павка	p a f k a
душкало	d u ʃ k a ɫ ɔ
диган	d i ɡ a n
замбиски	z a m b i s k i
алармен	a ɫ a r m ɛ n
принцези	p r i n t͡s ɛ z a
калабриски	k a ɫ a b r i s k i
географија	ɡ ɛ ɔ ɡ r a f i j a
ракопис	r a k ɔ p i s
неоколонијалистички	n ɛ ɔ k ɔ ɫ ɔ n i j a l i s t i t͡ʃ k i
увозлив	u v ɔ z l i f
смока	s m ɔ k a
згаснување	z ɡ a s n u v a ɲ ɛ
јаворишта	j a v ɔ ɾ i ʃ t a
клункање	k ɫ u ŋ k a ɲ ɛ
декоративен	d ɛ k ɔ ɾ a t i v ɛ n
урива	u ɾ i v a
неиздлабен	n ɛ i z d ɫ a b ɛ n
говетце	ɡ ɔ v ɛ t t͡s ɛ
бара	b a ɾ a
губитничка	ɡ u b i t n i t͡ʃ k a
укор	u k ɔ r
сенце	s ɛ n t͡s ɛ
имиграција	i m i ɡ r a t͡s i j a
пајачиште	p a j a t͡ʃ i ʃ t ɛ
пушка	p u ʃ k a
воздејство	v ɔ z d ɛ j s t v ɔ
идолка	i d ɔ ɫ k a
докачи	d ɔ k a t͡ʃ i
малтежанка	m a ɫ t ɛ ʒ a ŋ k a
интерактивност	i n t ɛ r a k t i v n ɔ s t
доплеткува	d ɔ p l ɛ t k u v a
размазуван	r a z m a z u v a n
масакрирање	m a s a k r i ɾ a ɲ ɛ
незаборавање	n ɛ z a b ɔ r a v a ɲ ɛ
меанџика	m ɛ a n d͡ʒ i k a
дендрохронологија	d ɛ n d r ɔ x r ɔ n ɔ ɫ ɔ ɡ i j a
духовнички	d u x ɔ v n i t͡ʃ k i
доктор	d ɔ k t ɔ r
крошничка	k r ɔ ʃ n i t͡ʃ k a
подразвесели	p ɔ d r a z v ɛ s ɛ l i
разбремени	r a z b r ɛ m ɛ n i
слезе	s l ɛ z ɛ
пираниште	p i r a n i ʃ t ɛ
нагаѓа	n a ɡ a ɟ a
изнаварен	i z n a v a ɾ ɛ n
размрежува	r a z m r ɛ ʒ u v a
пигмент	p i ɡ m ɛ n t
задоволуван	z a d ɔ v ɔ ɫ u v a n
грандиозен	ɡ r a n d i ɔ z ɛ n
партал	p a r t a ɫ
мебелира	m ɛ b ɛ l i ɾ a
годење	ɡ ɔ d ɛ ɲ ɛ
сугерирање	s u ɡ ɛ r i ɾ a ɲ ɛ
семантичар	s ɛ m a n t i t͡ʃ a r
млак	m ɫ a k
антифашистички	a n t i f a ʃ i s t i t͡ʃ k i
леопард	l ɛ ɔ p a r t
копенхашки	k ɔ p ɛ ŋ x a ʃ k i
потковуван	p ɔ t k ɔ v u v a n
оформуван	ɔ f ɔ r m u v a n
азијати	a z i j a t i
делкан	d ɛ ɫ k a n
наквасување	n a k v a s u v a ɲ ɛ
закачко	z a k a t͡ʃ k ɔ
богољубиво	b ɔ ɡ ɔ ʎ u b i v ɔ
изнапреден	i z n a p r ɛ d ɛ n
добродетел	d ɔ b r ɔ d ɛ t ɛ ɫ
основ	ɔ s n ɔ f
маршал	m a r ʃ a ɫ
птичка	p t i t͡ʃ k a
распуштено	r a s p u ʃ t ɛ n ɔ
бленење	b l ɛ n ɛ ɲ ɛ
трансформација	t r a n s f ɔ r m a t͡s i j a
теснински	t ɛ s n i n s k i
подготвително	p ɔ d ɡ ɔ t v i t ɛ ɫ n ɔ
првенство	p r̩ v ɛ n s t v ɔ
бришен	b r i ʃ ɛ n
геодетски	ɡ ɛ ɔ d ɛ t s k i
искорне	i s k ɔ r n ɛ
гросистички	ɡ r ɔ s i s t i t͡ʃ k i
петка	p ɛ t k a
прочитан	p r ɔ t͡ʃ i t a n
угостување	u ɡ ɔ s t u v a ɲ ɛ
шуми	ʃ u m i
архивист	a r x i v i s t
неменлив	n ɛ m ɛ n l i f
стоногалка	s t ɔ n ɔ ɡ a ɫ k a
бенин	b ɛ n i n
бута	b u t a
калкулира	k a ɫ k u l i ɾ a
доспремање	d ɔ s p r ɛ m a ɲ ɛ
нереизбран	n ɛ r ɛ i z b r a n
необјаснување	n ɛ ɔ b j a s n u v a ɲ ɛ
отпишува	ɔ t p i ʃ u v a
анонимизиран	a n ɔ n i m i z i ɾ a n
стандардно	s t a n d a r d n ɔ
нефенирање	n ɛ f ɛ n i ɾ a ɲ ɛ
кавадарчанка	k a v a d a r t͡ʃ a ŋ k a
засрамен	z a s r a m ɛ n
гана	ɡ a n a
обременува	ɔ b r ɛ m ɛ n u v a
грбовник	ɡ r̩ b ɔ v n i k
мугра	m u ɡ r a
нецитиран	n ɛ t͡s i t i ɾ a n
неклонирање	n ɛ k ɫ ɔ n i ɾ a ɲ ɛ
срамнет	s r a m n ɛ t
самоуштво	s a m ɔ u ʃ t v ɔ
поднебје	p ɔ d n ɛ b j ɛ
смеа	s m ɛ a
бактериолог	b a k t ɛ ɾ i j ɔ ɫ ɔ k
прерија	p r ɛ ɾ i j a
инхибирање	i ŋ x i b i ɾ a ɲ ɛ
приватизиран	p r i v a t i z i ɾ a n
мрзне	m r̩ z n ɛ
непотенцирање	n ɛ p ɔ t ɛ n t͡s i ɾ a ɲ ɛ
обессилува	ɔ b ɛ s s i ɫ u v a
студентка	s t u d ɛ n t k a
јамб	j a m p
тригодишен	t r i ɡ ɔ d i ʃ ɛ n
непошумен	n ɛ p ɔ ʃ u m ɛ n
незастанат	n ɛ z a s t a n a t
декодирање	d ɛ k ɔ d i ɾ a ɲ ɛ
грејач	ɡ r ɛ j a t͡ʃ
кумин	k u m i n
стршлениште	s t r̩ ʃ l ɛ n i ʃ t ɛ
доказ	d ɔ k a s
непримен	n ɛ p r i m ɛ n
непрекажан	n ɛ p r ɛ k a ʒ a n
абаџија	a b a d͡ʒ i j a
злочин	z ɫ ɔ t͡ʃ i n
замазнуван	z a m a z n u v a n
орјатка	ɔ r j a t k a
писмоносец	p i s m ɔ n ɔ s ɛ t͡s
партизанче	p a r t i z a n t͡ʃ ɛ
бормашина	b ɔ r m a ʃ i n a
хигрометар	x i ɡ r ɔ m ɛ t a r
апсолутен	a p s ɔ ɫ u t ɛ n
карамани	k a r a m a n i
гибелен	ɡ i b ɛ l ɛ n
рапсодија	r a p s ɔ d i j a
затрудни	z a t r u d n i
тракторист	t r a k t ɔ r i s t
отпишување	ɔ t p i ʃ u v a ɲ ɛ
честитка	t͡ʃ ɛ s t i t k a
морничаво	m ɔ r n i t͡ʃ a v ɔ
распостеле	r a s p ɔ s t ɛ l ɛ
подмети	p ɔ d m ɛ t i
ќерки	c ɛ r k i
чадје	t͡ʃ a d j ɛ
фала	f a ɫ a
поштува	p ɔ ʃ t u v a
неженење	n ɛ ʒ ɛ n ɛ ɲ ɛ
вкусуван	f k u s u v a n
невлезен	n ɛ v l ɛ z ɛ n
пишман	p i ʃ m a n
бејрут	b ɛ j r u t
стекнува	s t ɛ k n u v a
оклопник	ɔ k ɫ ɔ p n i k
калинка	k a l i ŋ k a
лекомисленост	l ɛ k ɔ m i s l ɛ n ɔ s t
одвиткан	ɔ d v i t k a n
насобира	n a s ɔ b i ɾ a
симбиоза	s i m b i ɔ z a
фалбаџика	f a ɫ b a d͡ʒ i k a
спојува	s p ɔ j u v a
враќе	v r a c ɛ
избезумувачки	i z b ɛ z u m u v a t͡ʃ k i
вкусен	f k u s ɛ n
незаверен	n ɛ z a v ɛ ɾ ɛ n
ленинистички	l ɛ n i n i s t i t͡ʃ k i
прерипан	p r ɛ ɾ i p a n
семен	s ɛ m ɛ n
костурчани	k ɔ s t u r t͡ʃ a n ɛ t͡s
меритократија	m ɛ ɾ i t ɔ k r a t i j a
нормализира	n ɔ r m a l i z i ɾ a
цртежи	t͡s r̩ t ɛ ʒ i
насечен	n a s ɛ t͡ʃ ɛ n
туткање	t u t k a ɲ ɛ
строго	s t r ɔ ɡ ɔ
обесцени	ɔ b ɛ s t͡s ɛ n i
пролетер	p r ɔ l ɛ t ɛ r
хирургија	x i r u r ɡ i j a
амарилис	a m a r i l i s
расчленуван	r a ʃ t͡ʃ l ɛ n u v a n
налудничав	n a ɫ u d n i t͡ʃ a f
прекласифицира	p r ɛ k ɫ a s i f i t͡s i ɾ a
берзански	b ɛ r z a n s k i
сошие	s ɔ ʃ i j ɛ
рождество	r ɔ ʒ d ɛ s t v ɔ
женчуле	ʒ ɛ n t͡ʃ u l ɛ
впери	f p ɛ ɾ i
конго	k ɔ ŋ ɡ ɔ
обвие	ɔ b v i j ɛ
замолкнува	z a m ɔ ɫ k n u v a
другарски	d r u ɡ a r s k i
брадиче	b r a d i t͡ʃ ɛ
збунувачки	z b u n u v a t͡ʃ k i
желче	ʒ ɛ ɫ t͡ʃ ɛ
несменето	n ɛ s m ɛ n ɛ t ɔ
овенување	ɔ v ɛ n u v a ɲ ɛ
богословие	b ɔ ɡ ɔ s ɫ ɔ v i j ɛ
либела	l i b ɛ ɫ a
скротуван	s k r ɔ t u v a n
подбивно	p ɔ d b i v n ɔ
недохранет	n ɛ d ɔ x r a n ɛ t
опуси	ɔ p u s i
намигнување	n a m i ɡ n u v a ɲ ɛ
метафизички	m ɛ t a f i z i t͡ʃ k i
леичка	l ɛ i t͡ʃ k a
пренесувач	p r ɛ n ɛ s u v a t͡ʃ
недеактивиран	n ɛ d ɛ a k t i v i ɾ a n
сервисериште	s ɛ r v i s ɛ ɾ i ʃ t ɛ
педофилка	p ɛ d ɔ f i ɫ k a
саксофонист	s a k s ɔ f ɔ n i s t
лусачанец	ɫ u s a t͡ʃ a n ɛ t͡s
плацента	p ɫ a t͡s ɛ n t a
вомјази	v ɔ m j a z i
техерански	t ɛ x ɛ ɾ a n s k i
геометриски	ɡ ɛ ɔ m ɛ t r i s k i
зрнце	z r̩ n t͡s ɛ
манамка	m a n a m k a
младичок	m ɫ a d i t͡ʃ ɔ k
спонзориште	s p ɔ n z ɔ ɾ i ʃ t ɛ
долгосежно	d ɔ ɫ ɡ ɔ s ɛ ʒ n ɔ
трнливост	t r̩ n l i v ɔ s t
рамнодушен	r a m n ɔ d u ʃ ɛ n
зашили	z a ʃ i l i
бивол	b i v ɔ ɫ
производител	p r ɔ i z v ɔ d i t ɛ ɫ
натпатници	n a t p a t n i t͡s i
лаф	ɫ a f
везејќи	v ɛ z ɛ j c i
наводенување	n a v ɔ d ɛ n u v a ɲ ɛ
расплеска	r a s p l ɛ s k a
неудавен	n ɛ u d a v ɛ n
усмрдува	u s m r̩ d u v a
сложувалки	s ɫ ɔ ʒ u v a ɫ k i
нутриционист	n u t r i t͡s i j ɔ n i s t
парцијален	p a r t͡s i j a l ɛ n
мирнотија	m i r n ɔ t i j a
отстои	ɔ t s t ɔ i
прешива	p r ɛ ʃ i v a
сетилно	s ɛ t i ɫ n ɔ
пинокио	p i n ɔ k i j ɔ
обединување	ɔ b ɛ d i n u v a ɲ ɛ
занаети	z a n a ɛ t i
ацко	a t͡s k ɔ
масовно	m a s ɔ v n ɔ
допразни	d ɔ p r a z n i
распламтен	r a s p ɫ a m t ɛ n
неусисан	n ɛ u s i s a n
вицепремиерка	v i t͡s ɛ p r ɛ m i ɛ r k a
преградување	p r ɛ ɡ r a d u v a ɲ ɛ
револуционизира	r ɛ v ɔ ɫ u t͡s i j ɔ n i z i ɾ a
зјае	z j a ɛ
харков	x a r k ɔ f
шмрчка	ʃ m r̩ t͡ʃ k a
незастапен	n ɛ z a s t a p ɛ n
феуд	f ɛ u t
трепери	t r ɛ p ɛ ɾ i
загушен	z a ɡ u ʃ ɛ n
недоспремен	n ɛ d ɔ s p r ɛ m ɛ n
плетка	p l ɛ t k a
дојранчанки	d ɔ j r a n t͡ʃ a ŋ k i
бескарактерност	b ɛ s k a r a k t ɛ r n ɔ s t
стравотен	s t r a v ɔ t ɛ n
инцестуозно	i n t͡s ɛ s t u ɔ z n ɔ
спонзорче	s p ɔ n z ɔ r t͡ʃ ɛ
прекречен	p r ɛ k r ɛ t͡ʃ ɛ n
лоби	ɫ ɔ b i
синдром	s i n d r ɔ m
инкубација	i ŋ k u b a t͡s i j a
анкарец	a ŋ k a ɾ ɛ t͡s
подоен	p ɔ d ɔ ɛ n
прататковина	p r a t a t k ɔ v i n a
ненадзиран	n ɛ n a d z i ɾ a n
џорџтаунци	d͡ʒ ɔ r t͡ʃ t a u n t͡s i
шокира	ʃ ɔ k i ɾ a
намрштува	n a m r̩ ʃ t u v a
скокотнат	s k ɔ k ɔ t n a t
арсен	a r s ɛ n
непопустливо	n ɛ p ɔ p u s t l i v ɔ
неостварен	n ɛ ɔ s t v a ɾ ɛ n
прошверца	p r ɔ ʃ v ɛ r t͡s a
облекуван	ɔ b l ɛ k u v a n
предгорја	p r ɛ d ɡ ɔ r j a
фабрика	f a b r i k a
номинирање	n ɔ m i n i ɾ a ɲ ɛ
варен	v a ɾ ɛ n
густо	ɡ u s t ɔ
промашува	p r ɔ m a ʃ u v a
преформулира	p r ɛ f ɔ r m u l i ɾ a
пајажина	p a j a ʒ i n a
досолува	d ɔ s ɔ ɫ u v a
лупење	ɫ u p ɛ ɲ ɛ
аклиматизационен	a k l i m a t i z a t͡s i ɔ n ɛ n
секад	s ɛ k a t
позира	p ɔ z i ɾ a
нефлексибилен	n ɛ f l ɛ k s i b i l ɛ n
човекоубиство	t͡ʃ ɔ v ɛ k ɔ u b i s t v ɔ
прилегнување	p r i l ɛ ɡ n u v a ɲ ɛ
школува	ʃ k ɔ ɫ u v a
урнува	u r n u v a
ансамбл	a n s a m b ɫ̩
потсоблече	p ɔ t s ɔ b l ɛ t͡ʃ ɛ
неизбањат	n ɛ i z b a ɲ a t
разгрнат	r a z ɡ r̩ n a t
брчкајќи	b r̩ t͡ʃ k a j c i
рецептор	r ɛ t͡s ɛ p t ɔ r
слепоочница	s l ɛ p ɔ ɔ t͡ʃ n i t͡s a
мувлосување	m u v ɫ ɔ s u v a ɲ ɛ
трауматичен	t r a u m a t i t͡ʃ ɛ n
њујорк	ɲ u j ɔ r k
тегови	t ɛ ɡ ɔ v i
повреди	p ɔ v r ɛ d i
разжестување	r a ʒ ʒ ɛ s t u v a ɲ ɛ
бунтувајќи	b u n t u v a j c i
кремови	k r ɛ m ɔ v i
тупотење	t u p ɔ t ɛ ɲ ɛ
делегитимира	d ɛ l ɛ ɡ i t i m i ɾ a
угостителство	u ɡ ɔ s t i t ɛ ɫ s t v ɔ
петмина	p ɛ t m i n a
омикрон	ɔ m i k r ɔ n
сеул	s ɛ u ɫ
помакедончува	p ɔ m a k ɛ d ɔ n t͡ʃ u v a
лексикографски	l ɛ k s i k ɔ ɡ r a f s k i
триумфално	t r i j u ɱ f a ɫ n ɔ
бладајќи	b ɫ a d a j c i
црни	t͡s r̩ n i
развезува	r a z v ɛ z u v a
достоинство	d ɔ s t ɔ i n s t v ɔ
ланчан	ɫ a n t͡ʃ a n
шушкавци	ʃ u ʃ k a f t͡s i
топонимија	t ɔ p ɔ n i m i j a
препораки	p r ɛ p ɔ ɾ a k i
незаврзување	n ɛ z a v r̩ z u v a ɲ ɛ
полјак	p ɔ ʎ a k
прошара	p r ɔ ʃ a ɾ a
манипуланти	m a n i p u ɫ a n t i
заблудува	z a b ɫ u d u v a
продуценти	p r ɔ d u t͡s ɛ n t i
соучесништво	s ɔ u t͡ʃ ɛ s n i ʃ t v ɔ
ибриче	i b r i t͡ʃ ɛ
бановина	b a n ɔ v i n a
дотрошуван	d ɔ t r ɔ ʃ u v a n
гени	ɡ ɛ n i
комичарски	k ɔ m i t͡ʃ a r s k i
сали	s a l i
перфиден	p ɛ r f i d ɛ n
зашеметен	z a ʃ ɛ m ɛ t ɛ n
магионичарка	m a ɡ i j ɔ n i t͡ʃ a r k a
непропорционално	n ɛ p r ɔ p ɔ r t͡s i j ɔ n a ɫ n ɔ
произведе	p r ɔ i z v ɛ d ɛ
давеник	d a v ɛ n i k
преграден	p r ɛ ɡ r a d ɛ n
разглоби	r a z ɡ ɫ ɔ b i
крастав	k r a s t a f
вруќини	v r u c i n i
висококатници	v i s ɔ k ɔ k a t n i t͡s i
алчно	a ɫ t͡ʃ n ɔ
насмевнат	n a s m ɛ v n a t
нерасхефтан	n ɛ r a s x ɛ f t a n
трансакциски	t r a n s a k t͡s i s k i
ѕиркан	d͡z i r k a n
момичиња	m ɔ m i t͡ʃ i ɲ a
мафне	m a f n ɛ
љубителски	ʎ u b i t ɛ ɫ s k i
аматерче	a m a t ɛ r t͡ʃ ɛ
експеримент	ɛ k s p ɛ ɾ i m ɛ n t
чанти	t͡ʃ a n t i
инвеститор	i ɱ v ɛ s t i t ɔ r
џумка	d͡ʒ u m k a
соблече	s ɔ b l ɛ t͡ʃ ɛ
исчупан	i ʃ t͡ʃ u p a n
укажување	u k a ʒ u v a ɲ ɛ
психолингвистички	p s i x ɔ l i ŋ ɡ v i s t i t͡ʃ k i
комарци	k ɔ m a r t͡s i
неубеден	n ɛ u b ɛ d ɛ n
масер	m a s ɛ r
настојува	n a s t ɔ j u v a
неотварање	n ɛ ɔ t v a ɾ a ɲ ɛ
расипник	r a s i p n i k
меритократски	m ɛ ɾ i t ɔ k r a t s k i
игла	i ɡ ɫ a
неподмирување	n ɛ p ɔ d m i r u v a ɲ ɛ
дур	d u r
онанист	ɔ n a n i s t
вглобување	v ɡ ɫ ɔ b u v a ɲ ɛ
чувство	t͡ʃ u f s t v ɔ
катен	k a t ɛ n
часовниче	t͡ʃ a s ɔ v n i t͡ʃ ɛ
козметичарка	k ɔ z m ɛ t i t͡ʃ a r k a
родовит	r ɔ d ɔ v i t
наслутен	n a s ɫ u t ɛ n
варварство	v a r v a r s t v ɔ
парченце	p a r t͡ʃ ɛ n t͡s ɛ
пацифист	p a t͡s i f i s t
фиран	f i ɾ a n
полноглавци	p ɔ ɫ n ɔ ɡ ɫ a f t͡s i
надваси	n a d v a s i
шарлатан	ʃ a r ɫ a t a n
бебуленце	b ɛ b u l ɛ n t͡s ɛ
прекуморски	p r ɛ k u m ɔ r s k i
сталеж	s t a l ɛ ʃ
тироиден	t i ɾ ɔ i d ɛ n
нетемпиран	n ɛ t ɛ m p i ɾ a n
богомил	b ɔ ɡ ɔ m i ɫ
нумерира	n u m ɛ r i ɾ a
отпаѓање	ɔ t p a ɟ a ɲ ɛ
танзаниски	t a n z a n i s k i
непрецизен	n ɛ p r ɛ t͡s i z ɛ n
бурмански	b u r m a n s k i
мачкање	m a t͡ʃ k a ɲ ɛ
разнежи	r a z n ɛ ʒ i
неодбивање	n ɛ ɔ d b i v a ɲ ɛ
несмасен	n ɛ s m a s ɛ n
забрадување	z a b r a d u v a ɲ ɛ
самонаплата	s a m ɔ n a p ɫ a t a
ободрувачки	ɔ b ɔ d r u v a t͡ʃ k i
безуморен	b ɛ z u m ɔ ɾ ɛ n
неподмладен	n ɛ p ɔ d m ɫ a d ɛ n
побиен	p ɔ b i j ɛ n
рушевина	r u ʃ ɛ v i n a
негушанки	n ɛ ɡ u ʃ a ŋ k i
пневматика	p n ɛ v m a t i k a
управуван	u p r a v u v a n
земјопис	z ɛ m j ɔ p i s
експресионист	ɛ k s p r ɛ s i j ɔ n i s t
преторијка	p r ɛ t ɔ ɾ i j k a
бордел	b ɔ r d ɛ ɫ
соучесница	s ɔ u t͡ʃ ɛ s n i t͡s a
налози	n a ɫ ɔ z i
малдивијка	m a ɫ d i v i j k a
кадифе	k a d i f ɛ
сузбивање	s u z b i v a ɲ ɛ
бесшеќерен	b ɛ ʃ ʃ ɛ c ɛ ɾ ɛ n
гркинка	ɡ r̩ k i ŋ k a
избавен	i z b a v ɛ n
изебе	i z ɛ b ɛ
вразуми	v r a z u m i
приметување	p r i m ɛ t u v a ɲ ɛ
излапа	i z ɫ a p a
развеселен	r a z v ɛ s ɛ l ɛ n
изваден	i z v a d ɛ n
мајче	m a j t͡ʃ ɛ
сочувува	s ɔ t͡ʃ u v u v a
фетишист	f ɛ t i ʃ i s t
пророштво	p r ɔ ɾ ɔ ʃ t v ɔ
секташтво	s ɛ k t a ʃ t v ɔ
ресен	r ɛ s ɛ n
врколачки	v r̩ k ɔ ɫ a t͡ʃ k i
раскинок	r a s k i n ɔ k
прераскажан	p r ɛ r a s k a ʒ a n
нахалност	n a x a ɫ n ɔ s t
собеседничка	s ɔ b ɛ s ɛ d n i t͡ʃ k a
творен	t v ɔ ɾ ɛ n
натпревари	n a t p r ɛ v a ɾ i
мажите	m a ʒ i t ɛ
местенка	m ɛ s t ɛ ŋ k a
бунтовници	b u n t ɔ v n i t͡s i
вртипоп	v r̩ t i p ɔ p
пролаз	p r ɔ ɫ a s
влече	v l ɛ t͡ʃ ɛ
долу	d ɔ ɫ u
изместува	i z m ɛ s t u v a
комедиограф	k ɔ m ɛ d i j ɔ ɡ r a f
емигрантка	ɛ m i ɡ r a n t k a
предострожност	p r ɛ d ɔ s t r ɔ ʒ n ɔ s t
кога	k ɔ ɡ a
разжалостен	r a ʒ ʒ a ɫ ɔ s t ɛ n
времиња	v r ɛ m i ɲ a
поѕвони	p ɔ d͡z v ɔ n i
состојби	s ɔ s t ɔ j b i
анонимизира	a n ɔ n i m i z i ɾ a
порази	p ɔ ɾ a z i
абонент	a b ɔ n ɛ n t
преврзување	p r ɛ v r̩ z u v a ɲ ɛ
бубалица	b u b a l i t͡s a
флизер	f l i z ɛ r
ориентациски	ɔ ɾ i j ɛ n t a t͡s i s k i
пожарна	p ɔ ʒ a r n a
плускав	p ɫ u s k a f
немец	n ɛ m ɛ t͡s
маврициус	m a v r i t͡s i j u s
пораснува	p ɔ r a s n u v a
досушува	d ɔ s u ʃ u v a
примарно	p r i m a r n ɔ
додоманец	d ɔ d ɔ m a n ɛ t͡s
незаборавно	n ɛ z a b ɔ ɾ a v n ɔ
бамачанка	b a m a t͡ʃ a ŋ k a
чекалница	t͡ʃ ɛ k a ɫ n i t͡s a
плеснат	p l ɛ s n a t
растревожуван	r a s t r ɛ v ɔ ʒ u v a n
отсечоци	ɔ t s ɛ t͡ʃ ɔ t͡s i
квартален	k v a r t a l ɛ n
бездомници	b ɛ z d ɔ m n i t͡s i
мовлив	m ɔ v l i f
превисоко	p r ɛ v i s ɔ k ɔ
неисфризиран	n ɛ i s f r i z i ɾ a n
манипулантка	m a n i p u ɫ a n t k a
злодела	z ɫ ɔ d ɛ ɫ a
хаванец	x a v a n ɛ t͡s
линчување	l i n t͡ʃ u v a ɲ ɛ
лиџба	l i d͡ʒ b a
казнен	k a z n ɛ n
некриминализирање	n ɛ k r i m i n a l i z i ɾ a ɲ ɛ
боциче	b ɔ t͡s i t͡ʃ ɛ
наврапит	n a v r a p i t
преоптеретува	p r ɛ ɔ p t ɛ r ɛ t u v a
бакардисувајќи	b a k a r d i s u v a j c i
кал	k a ɫ
гурабија	ɡ u r a b i j a
несамостојност	n ɛ s a m ɔ s t ɔ j n ɔ s t
боцичка	b ɔ t͡s i t͡ʃ k a
нагол	n a ɡ ɔ ɫ
простачиште	p r ɔ s t a t͡ʃ i ʃ t ɛ
демонтажа	d ɛ m ɔ n t a ʒ a
неконструктивно	n ɛ k ɔ n s t r u k t i v n ɔ
изнаправи	i z n a p r a v i
расчепкан	r a ʃ t͡ʃ ɛ p k a n
растревожи	r a s t r ɛ v ɔ ʒ i
дневник	d n ɛ v n i k
крадлив	k r a d l i f
посетеност	p ɔ s ɛ t ɛ n ɔ s t
актиниум	a k t i n i j u m
несовесност	n ɛ s ɔ v ɛ s n ɔ s t
надвикан	n a d v i k a n
теслиште	t ɛ s l i ʃ t ɛ
гасометар	ɡ a s ɔ m ɛ t a r
штиман	ʃ t i m a n
мол	m ɔ ɫ
довалка	d ɔ v a ɫ k a
пластифициран	p ɫ a s t i f i t͡s i ɾ a n
циганштина	t͡s i ɡ a n ʃ t i n a
вати	v a t i
бришне	b r i ʃ n ɛ
криптира	k r i p t i ɾ a
киевјанец	k i ɛ v j a n ɛ t͡s
конфигуриран	k ɔ ɱ f i ɡ u r i ɾ a n
спроведе	s p r ɔ v ɛ d ɛ
штетење	ʃ t ɛ t ɛ ɲ ɛ
паркет	p a r k ɛ t
метериз	m ɛ t ɛ ɾ i s
коментатор	k ɔ m ɛ n t a t ɔ r
длапка	d ɫ a p k a
опиран	ɔ p i ɾ a n
бернец	b ɛ r n ɛ t͡s
термостат	t ɛ r m ɔ s t a t
откопча	ɔ t k ɔ p t͡ʃ a
набеден	n a b ɛ d ɛ n
дудинка	d u d i ŋ k a
реалистичен	r ɛ a l i s t i t͡ʃ ɛ n
наврапито	n a v r a p i t ɔ
ливадичка	l i v a d i t͡ʃ k a
раздвои	r a z d v ɔ i
отплетка	ɔ t p l ɛ t k a
мотори	m ɔ t ɔ ɾ i
славејски	s ɫ a v ɛ j s k i
нормализација	n ɔ r m a l i z a t͡s i j a
сатанизира	s a t a n i z i ɾ a
манифест	m a n i f ɛ s t
онанија	ɔ n a n i j a
подрипнува	p ɔ d r i p n u v a
возникне	v ɔ z n i k n ɛ
малави	m a ɫ a v i
изграден	i z ɡ r a d ɛ n
пакистански	p a k i s t a n s k i
евли	ɛ v l i
трисобен	t r i s ɔ b ɛ n
ордија	ɔ r d i j a
танчер	t a n t͡ʃ ɛ r
уважуван	u v a ʒ u v a n
прасловенски	p r a s ɫ ɔ v ɛ n s k i
атлас	a t ɫ a s
намекне	n a m ɛ k n ɛ
топови	t ɔ p ɔ v i
известува	i z v ɛ s t u v a
ресор	r ɛ s ɔ r
слободарски	s ɫ ɔ b ɔ d a r s k i
беџови	b ɛ d͡ʒ ɔ v i
корупција	k ɔ r u p t͡s i j a
интригира	i n t r i ɡ i ɾ a
неиспасиран	n ɛ i s p a s i ɾ a n
пудра	p u d r a
вкуси	f k u s i
лупа	ɫ u p a
излошен	i z ɫ ɔ ʃ ɛ n
бунгалов	b u ŋ ɡ a ɫ ɔ f
стипендија	s t i p ɛ n d i j a
непобарување	n ɛ p ɔ b a r u v a ɲ ɛ
жештина	ʒ ɛ ʃ t i n a
глогинка	ɡ ɫ ɔ ɡ i ŋ k a
причува	p r i t͡ʃ u v a
заплетка	z a p l ɛ t k a
поистоветуван	p ɔ i s t ɔ v ɛ t u v a n
скаперници	s k a p ɛ r n i t͡s i
избуши	i z b u ʃ i
непредизвикување	n ɛ p r ɛ d i z v i k u v a ɲ ɛ
погледнување	p ɔ ɡ l ɛ d n u v a ɲ ɛ
сатир	s a t i r
арамбаша	a r a m b a ʃ a
пополнува	p ɔ p ɔ ɫ n u v a
балон	b a ɫ ɔ n
багра	b a ɡ r a
поднебја	p ɔ d n ɛ b j a
небендисување	n ɛ b ɛ n d i s u v a ɲ ɛ
вжарен	v ʒ a ɾ ɛ n
купе	k u p ɛ
отежнувачки	ɔ t ɛ ʒ n u v a t͡ʃ k i
ќирил	c i ɾ i ɫ
автомобилски	a f t ɔ m ɔ b i ɫ s k i
штетници	ʃ t ɛ t n i t͡s i
јавувајќи	j a v u v a j c i
јунци	j u n t͡s i
клава	k ɫ a v a
собере	s ɔ b ɛ ɾ ɛ
зла	z ɫ a
братучеда	b r a t u t͡ʃ ɛ d a
редактира	r ɛ d a k t i ɾ a
облекува	ɔ b l ɛ k u v a
дијабетес	d i j a b ɛ t ɛ s
бурно	b u r n ɔ
плешка	p l ɛ ʃ k a
цуцкање	t͡s u t͡s k a ɲ ɛ
дознаен	d ɔ z n a ɛ n
плик	p l i k
трпање	t r̩ p a ɲ ɛ
негаснење	n ɛ ɡ a s n ɛ ɲ ɛ
воздигнат	v ɔ z d i ɡ n a t
вруќина	v r u c i n a
сожителка	s ɔ ʒ i t ɛ ɫ k a
пожарни	p ɔ ʒ a r n i
седумдести	s ɛ d u m d ɛ s t i
печок	p ɛ t͡ʃ ɔ k
накитување	n a k i t u v a ɲ ɛ
обвинителен	ɔ b v i n i t ɛ l ɛ n
индијче	i n d i j t͡ʃ ɛ
црепна	t͡s r ɛ p n a
незатоплување	n ɛ z a t ɔ p ɫ u v a ɲ ɛ
репортер	r ɛ p ɔ r t ɛ r
дневно	d n ɛ v n ɔ
сијалица	s i j a l i t͡s a
прага	p r a ɡ a
евалуација	ɛ v a ɫ u a t͡s i j a
преклопува	p r ɛ k ɫ ɔ p u v a
бодрост	b ɔ d r ɔ s t
зацрцори	z a t͡s r̩ t͡s ɔ ɾ i
клириншки	k l i ɾ i n ʃ k i
издлабување	i z d ɫ a b u v a ɲ ɛ
букурештанка	b u k u r ɛ ʃ t a ŋ k a
протекционистка	p r ɔ t ɛ k t͡s i j ɔ n i s t k a
своеглавост	s v ɔ ɛ ɡ ɫ a v ɔ s t
вектор	v ɛ k t ɔ r
тектоника	t ɛ k t ɔ n i k a
посмртница	p ɔ s m r̩ t n i t͡s a
комар	k ɔ m a r
импонирање	i m p ɔ n i ɾ a ɲ ɛ
интригантка	i n t r i ɡ a n t k a
пленство	p l ɛ n s t v ɔ
жеднеење	ʒ ɛ d n ɛ ɛ ɲ ɛ
правец	p r a v ɛ t͡s
баклавичка	b a k ɫ a v i t͡ʃ k a
изврива	i z v r i v a
намигнува	n a m i ɡ n u v a
сакраментален	s a k r a m ɛ n t a l ɛ n
ротор	r ɔ t ɔ r
македонка	m a k ɛ d ɔ ŋ k a
синџирче	s i n d͡ʒ i r t͡ʃ ɛ
најаве	n a j a v ɛ
изострен	i z ɔ s t r ɛ n
табеларен	t a b ɛ ɫ a ɾ ɛ n
потпадне	p ɔ t p a d n ɛ
формализација	f ɔ r m a l i z a t͡s i j a
фризури	f r i z u ɾ i
буцкајќи	b u t͡s k a j c i
продаде	p r ɔ d a d ɛ
размерлив	r a z m ɛ r l i f
уставно	u s t a v n ɔ
препраќање	p r ɛ p r a c a ɲ ɛ
незадржување	n ɛ z a d r̩ ʒ u v a ɲ ɛ
залижан	z a l i ʒ a n
ќунк	c u ŋ k
направен	n a p r a v ɛ n
закоравен	z a k ɔ ɾ a v ɛ n
келнерка	k ɛ ɫ n ɛ r k a
диоптер	d i ɔ p t ɛ r
одвојување	ɔ d v ɔ j u v a ɲ ɛ
освоена	ɔ s v ɔ ɛ n a
сирена	s i r ɛ n a
милосрдие	m i ɫ ɔ s r̩ d i j ɛ
врвеж	v r̩ v ɛ ʃ
ксенофобично	k s ɛ n ɔ f ɔ b i t͡ʃ n ɔ
крило	k r i ɫ ɔ
катмандски	k a t m a n t s k i
пазува	p a z u v a
оставка	ɔ s t a f k a
преглуп	p r ɛ ɡ ɫ u p
човечно	t͡ʃ ɔ v ɛ t͡ʃ n ɔ
дотресен	d ɔ t r ɛ s ɛ n
огин	ɔ ɡ i n
непреводливост	n ɛ p r ɛ v ɔ d l i v ɔ s t
меродавно	m ɛ r ɔ d a v n ɔ
наточува	n a t ɔ t͡ʃ u v a
кујна	k u j n a
пантеистички	p a n t ɛ i s t i t͡ʃ k i
дијадема	d i j a d ɛ m a
четврточен	t͡ʃ ɛ t v r̩ t ɔ t͡ʃ ɛ n
изгине	i z ɡ i n ɛ
неполиен	n ɛ p ɔ l i j ɛ n
вртка	v r̩ t k a
ледникав	l ɛ d n i k a f
нагрби	n a ɡ r̩ b i
хартиен	x a r t i j ɛ n
сметки	s m ɛ t k i
мапутоанка	m a p u t ɔ a ŋ k a
вкусувајќи	f k u s u v a j c i
фразеологија	f r a z ɛ ɔ ɫ ɔ ɡ i j a
ненадејно	n ɛ n a d ɛ j n ɔ
греши	ɡ r ɛ ʃ i
необразложено	n ɛ ɔ b r a z ɫ ɔ ʒ ɛ n ɔ
четриесе	t͡ʃ ɛ t r i j ɛ s ɛ
сенчење	s ɛ n t͡ʃ ɛ ɲ ɛ
вртоглав	v r̩ t ɔ ɡ ɫ a f
доближуван	d ɔ b l i ʒ u v a n
џезерка	d͡ʒ ɛ z ɛ r k a
наговара	n a ɡ ɔ v a ɾ a
квартет	k v a r t ɛ t
чекалници	t͡ʃ ɛ k a ɫ n i t͡s i
репариран	r ɛ p a r i ɾ a n
шкаф	ʃ k a f
птици	p t i t͡s i
затропа	z a t r ɔ p a
феминацист	f ɛ m i n a t͡s i s t
третоодделенче	t r ɛ t ɔ ɔ d d ɛ l ɛ n t͡ʃ ɛ
внатре	v n a t r ɛ
близнак	b l i z n a k
невакцинирање	n ɛ v a k t͡s i n i ɾ a ɲ ɛ
бармен	b a r m ɛ n
триста	t r i s t a
шутовски	ʃ u t ɔ f s k i
доспреми	d ɔ s p r ɛ m i
џогери	d͡ʒ ɔ ɡ ɛ ɾ i
валандовски	v a ɫ a n d ɔ f s k i
сезнаечки	s ɛ z n a ɛ t͡ʃ k i
надразнетост	n a d r a z n ɛ t ɔ s t
доличен	d ɔ l i t͡ʃ ɛ n
техеранка	t ɛ x ɛ ɾ a ŋ k a
криминолог	k r i m i n ɔ ɫ ɔ k
модернизатор	m ɔ d ɛ r n i z a t ɔ r
експлицитно	ɛ k s p l i t͡s i t n ɔ
фактурира	f a k t u r i ɾ a
бусени	b u s ɛ n i
прагови	p r a ɡ ɔ v i
бојкоти	b ɔ j k ɔ t i
телавивка	t ɛ ɫ a v i f k a
притворува	p r i t v ɔ ɾ u v a
перничка	p ɛ r n i t͡ʃ k a
искоренува	i s k ɔ ɾ ɛ n u v a
цементира	t͡s ɛ m ɛ n t i ɾ a
небраска	n ɛ b r a s k a
ограничувања	ɔ ɡ r a n i t͡ʃ u v a ɲ a
синоќа	s i n ɔ c a
колан	k ɔ ɫ a n
востание	v ɔ s t a n i j ɛ
обичаи	ɔ b i t͡ʃ a i
грозотија	ɡ r ɔ z ɔ t i j a
кичевчанец	k i t͡ʃ ɛ f t͡ʃ a n ɛ t͡s
наводен	n a v ɔ d ɛ n
салце	s a ɫ t͡s ɛ
неотскокнување	n ɛ ɔ t s k ɔ k n u v a ɲ ɛ
насмее	n a s m ɛ ɛ
ослонуван	ɔ s ɫ ɔ n u v a n
воздигање	v ɔ z d i ɡ a ɲ ɛ
зараснува	z a r a s n u v a
деспотизам	d ɛ s p ɔ t i z a m
натнува	n a t n u v a
локна	ɫ ɔ k n a
образуван	ɔ b r a z u v a n
засукување	z a s u k u v a ɲ ɛ
мравја	m r a v j a
кореографски	k ɔ ɾ ɛ ɔ ɡ r a f s k i
меѓународно	m ɛ ɟ u n a ɾ ɔ d n ɔ
дамка	d a m k a
акушерство	a k u ʃ ɛ r s t v ɔ
милување	m i ɫ u v a ɲ ɛ
рогоз	r ɔ ɡ ɔ s
пољак	p ɔ ʎ a k
неустрашен	n ɛ u s t r a ʃ ɛ n
дијаметрален	d i j a m ɛ t r a l ɛ n
џапнување	d͡ʒ a p n u v a ɲ ɛ
неинтервенирање	n ɛ i n t ɛ r v ɛ n i ɾ a ɲ ɛ
валандовчанец	v a ɫ a n d ɔ f t͡ʃ a n ɛ t͡s
комуницира	k ɔ m u n i t͡s i ɾ a
клавичембало	k ɫ a v i t͡ʃ ɛ m b a ɫ ɔ
самува	s a m u v a
достигне	d ɔ s t i ɡ n ɛ
прекрстување	p r ɛ k r̩ s t u v a ɲ ɛ
кауза	k a u z a
дни	d n i
сметачки	s m ɛ t a t͡ʃ k i
швалерисување	ʃ v a l ɛ ɾ i s u v a ɲ ɛ
гостилничар	ɡ ɔ s t i ɫ n i t͡ʃ a r
соопштение	s ɔ ɔ p ʃ t ɛ n i j ɛ
изделка	i z d ɛ ɫ k a
нецентрализирано	n ɛ t͡s ɛ n t r a l i z i ɾ a n ɔ
квиз	k v i s
дораскажан	d ɔ r a s k a ʒ a n
незначаен	n ɛ z n a t͡ʃ a ɛ n
магистрирање	m a ɡ i s t r i ɾ a ɲ ɛ
послушност	p ɔ s ɫ u ʃ n ɔ s t
фрустрира	f r u s t r i ɾ a
крвно	k r̩ v n ɔ
скакулец	s k a k u l ɛ t͡s
антиталент	a n t i t a l ɛ n t
препарирање	p r ɛ p a r i ɾ a ɲ ɛ
принцип	p r i n t͡s i p
као	k a ɔ
еревански	ɛ r ɛ v a n s k i
дозатвори	d ɔ z a t v ɔ ɾ i
наруча	n a ɾ u t͡ʃ a
протеран	p r ɔ t ɛ ɾ a n
вмеша	v m ɛ ʃ a
закономерен	z a k ɔ n ɔ m ɛ ɾ ɛ n
погерманчи	p ɔ ɡ ɛ r m a n t͡ʃ i
наведнување	n a v ɛ d n u v a ɲ ɛ
туширање	t u ʃ i ɾ a ɲ ɛ
непретставен	n ɛ p r ɛ t s t a v ɛ n
пристаништа	p r i s t a n i ʃ t a
заледува	z a l ɛ d u v a
батали	b a t a l i
организми	ɔ r ɡ a n i z m i
забавиште	z a b a v i ʃ t ɛ
сеприсутен	s ɛ p r i s u t ɛ n
ѓубреџиски	ɟ u b r ɛ d͡ʒ i s k i
мандарински	m a n d a r i n s k i
радовишанец	r a d ɔ v i ʃ a n ɛ t͡s
некомпатибилно	n ɛ k ɔ m p a t i b i ɫ n ɔ
заштедува	z a ʃ t ɛ d u v a
воведно	v ɔ v ɛ d n ɔ
имј	i m ə j ə
мрсулави	m r̩ s u ɫ a v i
обвивка	ɔ b v i f k a
креда	k r ɛ d a
годинашен	ɡ ɔ d i n a ʃ ɛ n
гастритис	ɡ a s t r i t i s
подгорчување	p ɔ d ɡ ɔ r t͡ʃ u v a ɲ ɛ
промеша	p r ɔ m ɛ ʃ a
привезочиште	p r i v ɛ z ɔ t͡ʃ i ʃ t ɛ
зетски	z ɛ t s k i
реформиран	r ɛ f ɔ r m i ɾ a n
автобуска	a f t ɔ b u s k a
оддржува	ɔ d d r̩ ʒ u v a
цревце	t͡s r ɛ f t͡s ɛ
залаци	z a ɫ a t͡s i
дилиски	d i l i s k i
главоболка	ɡ ɫ a v ɔ b ɔ ɫ k a
самариум	s a m a ɾ i j u m
нескротен	n ɛ s k r ɔ t ɛ n
црево	t͡s r ɛ v ɔ
заемање	z a ɛ m a ɲ ɛ
модернист	m ɔ d ɛ r n i s t
неосуетен	n ɛ ɔ s u ɛ t ɛ n
касне	k a s n ɛ
девет	d ɛ v ɛ t
охрабрување	ɔ x r a b r u v a ɲ ɛ
микроскопи	m i k r ɔ s k ɔ p i
зборовно	z b ɔ ɾ ɔ v n ɔ
аха	a x a
исшетан	i ʃ ʃ ɛ t a n
билкарки	b i ɫ k a r k i
судови	s u d ɔ v i
билатерален	b i ɫ a t ɛ r a l ɛ n
давател	d a v a t ɛ ɫ
желудочен	ʒ ɛ ɫ u d ɔ t͡ʃ ɛ n
интровертен	i n t r ɔ v ɛ r t ɛ n
претчувствуван	p r ɛ t t͡ʃ u f s t v u v a n
парталко	p a r t a ɫ k ɔ
раштркан	r a ʃ t r̩ k a n
бунар	b u n a r
преместуван	p r ɛ m ɛ s t u v a n
чачкање	t͡ʃ a t͡ʃ k a ɲ ɛ
доистребуван	d ɔ i s t r ɛ b u v a n
сплини	s p l i n i
наесен	n a ɛ s ɛ n
напредува	n a p r ɛ d u v a
молер	m ɔ l ɛ r
потиснување	p ɔ t i s n u v a ɲ ɛ
стокми	s t ɔ k m i
апелирање	a p ɛ l i ɾ a ɲ ɛ
вообичајување	v ɔ ɔ b i t͡ʃ a j u v a ɲ ɛ
ц	t͡s ə
наградиште	n a ɡ r a d i ʃ t ɛ
неподатлив	n ɛ p ɔ d a t l i f
поручек	p ɔ ɾ u t͡ʃ ɛ k
топографија	t ɔ p ɔ ɡ r a f i j a
херметички	x ɛ r m ɛ t i t͡ʃ k i
бански	b a n s k i
мустаќ	m u s t a c
млека	m l ɛ k a
џогер	d͡ʒ ɔ ɡ ɛ r
колнење	k ɔ ɫ n ɛ ɲ ɛ
мешанци	m ɛ ʃ a n t͡s i
смотанковци	s m ɔ t a ŋ k ɔ f t͡s i
лоботомија	ɫ ɔ b ɔ t ɔ m i j a
ископан	i s k ɔ p a n
наместува	n a m ɛ s t u v a
погмечи	p ɔ ɡ m ɛ t͡ʃ i
гулабов	ɡ u ɫ a b ɔ f
игроорка	i ɡ r ɔ ɔ r k a
закрпен	z a k r̩ p ɛ n
прилагодливо	p r i ɫ a ɡ ɔ d l i v ɔ
матеа	m a t ɛ a
гуши	ɡ u ʃ i
отпадне	ɔ t p a d n ɛ
видин	v i d i n
небегање	n ɛ b ɛ ɡ a ɲ ɛ
избројан	i z b r ɔ j a n
колективизира	k ɔ l ɛ k t i v i z i ɾ a
водоотпорно	v ɔ d ɔ ɔ t p ɔ r n ɔ
уснен	u s n ɛ n
алабастер	a ɫ a b a s t ɛ r
македонско	m a k ɛ d ɔ n s k ɔ
бае	b a ɛ
суштественост	s u ʃ t ɛ s t v ɛ n ɔ s t
ратови	r a t ɔ v i
домет	d ɔ m ɛ t
гостилничарски	ɡ ɔ s t i ɫ n i t͡ʃ a r s k i
зимски	z i m s k i
велибор	v ɛ l i b ɔ r
рафиниран	r a f i n i ɾ a n
запамти	z a p a m t i
суетност	s u ɛ t n ɔ s t
криволов	k r i v ɔ ɫ ɔ f
буки	b u k i
искалкулира	i s k a ɫ k u l i ɾ a
слушне	s ɫ u ʃ n ɛ
тиркизен	t i r k i z ɛ n
поткажан	p ɔ t k a ʒ a n
термодинамички	t ɛ r m ɔ d i n a m i t͡ʃ k i
зашамара	z a ʃ a m a ɾ a
пренесува	p r ɛ n ɛ s u v a
презвитер	p r ɛ z v i t ɛ r
бинго	b i ŋ ɡ ɔ
мачно	m a t͡ʃ n ɔ
побудување	p ɔ b u d u v a ɲ ɛ
плагијатор	p ɫ a ɡ i j a t ɔ r
франкфурт	f r a ŋ k f u r t
ѓаолка	ɟ a ɔ ɫ k a
доткае	d ɔ t k a ɛ
ѓеврек	ɟ ɛ v r ɛ k
месење	m ɛ s ɛ ɲ ɛ
преродбеничка	p r ɛ ɾ ɔ d b ɛ n i t͡ʃ k a
римјанин	r i m j a n i n
челист	t͡ʃ ɛ l i s t
хиндуист	x i n d u i s t
опишува	ɔ p i ʃ u v a
одмрзне	ɔ d m r̩ z n ɛ
грбно	ɡ r̩ b n ɔ
намуртеност	n a m u r t ɛ n ɔ s t
прелетан	p r ɛ l ɛ t a n
непоминат	n ɛ p ɔ m i n a t
исправуван	i s p r a v u v a n
шарски	ʃ a r s k i
пченичен	p t͡ʃ ɛ n i t͡ʃ ɛ n
подложен	p ɔ d ɫ ɔ ʒ ɛ n
слатко	s ɫ a t k ɔ
ноќно	n ɔ c n ɔ
квалитетен	k v a l i t ɛ t ɛ n
истурен	i s t u ɾ ɛ n
битка	b i t k a
двосмислен	d v ɔ s m i s l ɛ n
белец	b ɛ l ɛ t͡s
меѓуверски	m ɛ ɟ u v ɛ r s k i
нераководен	n ɛ ɾ a k ɔ v ɔ d ɛ n
инвентивен	i ɱ v ɛ n t i v ɛ n
томографија	t ɔ m ɔ ɡ r a f i j a
книжевен	k n i ʒ ɛ v ɛ n
колективност	k ɔ l ɛ k t i v n ɔ s t
цирокумулус	t͡s i ɾ ɔ k u m u ɫ u s
велингтонски	v ɛ l i ŋ k t ɔ n s k i
постоен	p ɔ s t ɔ ɛ n
златарници	z ɫ a t a r n i t͡s i
сендвичиште	s ɛ n d v i t͡ʃ i ʃ t ɛ
исонча	i s ɔ n t͡ʃ a
одоброволен	ɔ d ɔ b r ɔ v ɔ l ɛ n
специфицирање	s p ɛ t͡s i f i t͡s i ɾ a ɲ ɛ
предлага	p r ɛ d ɫ a ɡ a
порочност	p ɔ ɾ ɔ t͡ʃ n ɔ s t
одведува	ɔ d v ɛ d u v a
печатиште	p ɛ t͡ʃ a t i ʃ t ɛ
лекари	l ɛ k a ɾ i
пожарникар	p ɔ ʒ a r n i k a r
брегови	b r ɛ ɡ ɔ v i
соединетост	s ɔ ɛ d i n ɛ t ɔ s t
отпорно	ɔ t p ɔ r n ɔ
штеден	ʃ t ɛ d ɛ n
обесуван	ɔ b ɛ s u v a n
кас	k a s
тимар	t i m a r
сешто	s ɛ ʃ t ɔ
обол	ɔ b ɔ ɫ
транзитен	t r a n z i t ɛ n
бледило	b l ɛ d i ɫ ɔ
шури	ʃ u ɾ i
зјапне	z j a p n ɛ
марјана	m a r j a n a
тирана	t i r a n a
сродство	s r ɔ t s t v ɔ
радикализам	r a d i k a l i z a m
балкан	b a ɫ k a n
рожби	r ɔ ʒ b i
сатиричари	s a t i r i t͡ʃ a ɾ i
пореметуван	p ɔ ɾ ɛ m ɛ t u v a n
нерепетиран	n ɛ ɾ ɛ p ɛ t i ɾ a n
догнивање	d ɔ ɡ n i v a ɲ ɛ
архитект	a r x i t ɛ k t
прекројуван	p r ɛ k r ɔ j u v a n
менувачница	m ɛ n u v a t͡ʃ n i t͡s a
прабаби	p r a b a b i
неутешно	n ɛ u t ɛ ʃ n ɔ
северџански	s ɛ v ɛ r d͡ʒ a n s k i
ендокринологија	ɛ n d ɔ k r i n ɔ ɫ ɔ ɡ i j a
жнеење	ʒ n ɛ ɛ ɲ ɛ
фундаментален	f u n d a m ɛ n t a l ɛ n
несервиран	n ɛ s ɛ r v i ɾ a n
возвеличување	v ɔ z v ɛ l i t͡ʃ u v a ɲ ɛ
злорадосно	z ɫ ɔ r a d ɔ s n ɔ
различен	r a z l i t͡ʃ ɛ n
зурла	z u r ɫ a
скренува	s k r ɛ n u v a
неморален	n ɛ m ɔ ɾ a l ɛ n
малаја	m a ɫ a j a
