woohoo	w uː h uː
pictural	p ɪ k t͡ʃ ə ɹ ə l
stasi	s t ɑː z i
literature	l ɪ t ɚ t͡ʃ ɚ
horrendous	h ə ɹ ɛ n d ə s
wickiup	w ɪ k i ʌ p
blasphemy	b l æ s f ə m i
jacksonian	d͡ʒ æ k s o ʊ n i ə n
wacko	w æ k ə ʊ
ruckus	ɹ ʌ k ə s
garboil	ɡ ɑː ɹ b ɔ ɪ l
nuxálk	n uː h ɒ l k
danger	d e ɪ n d͡ʒ ɚ
boulogne	b ə l ɔ ɪ n
mullah	m ʊ l ə
karakalpakstan	k ɑ ɹ ə k ɑ l p ɑ k s t æ n
oats	o ʊ t s
leicestrian	l ɛ s t ɹ ɪ ə n
cuirass	k j ʊ ɹ æ s
cribble	k ɹ ɪ b ə l
ivanovna	ɪ v æ n ə v n ə
zzzs	z iː z
baritsu	b ɑː ɹ ɪ t s uː
okie	o ʊ k i
copay	k o ʊ p e ɪ
fascism	f æ ʃ ɪ z ə m
ingravidate	ɪ ŋ ɡ ɹ æ v ɪ d e ɪ t
preprepare	p ɹ i p ɹ ɪ p ɛ ɹ
superseminate	s uː p ə ɹ s ɛ m ɪ n e ɪ t
bebusy	b ɪ b ɪ z i
starven	s t ɑ ɹ v ə n
equinoctial	iː k w ə n ɑ k ʃ ə l
pipradol	p ɪ p ɹ ə d ɒ l
tetraeteris	t ɛ t r ə ɛ d ə r ə s
storie	s t ɔː ɹ i
accommodation	ə k ɑ m ə d e ɪ ʃ ə n
accentual	æ k s ɛ n t͡ʃ u ə l
redder	ɹ ɛ d ɚ
employed	ɛ m p l ɔ ɪ d
emma	ɛ m ə
fact	f æ k t
commitment	k ə m ɪ t m ə n t
valuable	v æ l j u ə b l̩
nausicaa	n ɔː s ɪ k i ə
politique	p ɑ l ə t ɪ k
frowned	f ɹ a ʊ n d
terpenoid	t ɝ p ə n ɔ ɪ d
howler	h a ʊ l ɚ
bolder	b o ʊ l d ə ɹ
turkey	t ɝ k i
pigtail	p ɪ ɡ t e ɪ l
australian	ɔ s t ɹ ɛ l i ə n
efforce	ɪ f ɔː ɹ s
aleglitazar	æ l ə ɡ l ɪ t ə z ɑ ɹ
livor	l a ɪ v ɔ ə ɹ
cuzco	k uː s k o ʊ
mortal	m ɔ ɹ t ə l
pines	p a ɪ n z
cabg	k æ b ɪ d͡ʒ
personality	p ɝ s ə n æ l ɪ t i
retransfer	ɹ iː t ɹ æ n s f ə ɹ
expressions	ɪ k s p ɹ ɛ ʃ ə n z
nutty	n ʌ t i
tokanui	t ɒ k ɑː n uː iː
blackings	b l æ k ɪ ŋ z
handwavium	h æ n d w e ɪ v i ə m
sureness	ʃ ʊ ɹ n ə s
hogmanay	h ɑ ɡ m ə n e ɪ
outburst	a ʊ t b ɝ s t
omnipresent	ɑ m n ɪ p ɹ ɛ z n̩ t
besilesomab	b ɛ s ɪ l ɛ s ə m æ b
mondegreen	m ɑ n d ə ɡ ɹ iː n
rhythmlessly	ɹ ɪ ð m̩ l ə s l i
chard	t͡ʃ ɑ ɹ d
trudeau	t ɹ uː d o ʊ
telegraphy	t ə l ɛ ɡ ɹ ə f i
nipple	n ɪ p ə l
finalize	f a ɪ n ə l a ɪ z
nippon	n ɪ p ɑ n
shitting	ʃ ɪ t ɪ ŋ
advent	æ d v ə n t
busted	b ʌ s t ə d
stomp	s t ɑ m p
methicilin	m ɛ θ ɪ s ɪ l ɪ n
succame	s ə k e ɪ m
hypospadias	h a ɪ p ə s p e ɪ d i ə s
youthenize	j uː θ ə n a ɪ z
sandwich	s æ n d w ɪ d͡ʒ
remigrate	ɹ iː m a ɪ ɡ ɹ e ɪ t
crewkerne	k ɹ uː k ə ɹ n
rearview	ɹ i ɹ v j uː
knew	n j u ʊ̯
deign	d e ɪ n
judd	d͡ʒ ʌ d
cervical	s ɝ v ɪ k l̩
irrawaddy	ɪ ɹ ə w ɑ d i
lachrymose	l æ k ɹ ɪ m o ʊ s
ammo	æ m o ʊ
tobiano	t ə ʊ b i ɑː n ə ʊ
spetchel	s p e t͡ʃ l
broadsword	b ɹ ɔ d s ɔ ɹ d
ansa	æ n s ə
acumination	ə k j uː m ɪ n e ɪ ʃ ə n
beads	b iː d z
steadiness	s t ɛ d i n ə s
winked	w ɪ ŋ k t
careworn	k ɛ ə ɹ w ɔ ɹ n
fountain	f a ʊ n t n̩
skein	s k e ɪ n
dudess	d j uː d ɛ s
watchlist	w ɔ t͡ʃ l ɪ s t
fluvoxamine	f l uː v ɑ k s ə m iː n
misguilt	m ɪ s ɡ ɪ l t
bluntly	b l ʌ n t l i
stradivarius	s t ɹ æ d ə v ɛ ɹ i ə s
setup	s ɛ t ʌ p
flashlight	f l æ ʃ l a ɪ t
prepotent	p ɹ ɪ p o ʊ t ə n t
union	j uː n i ə n
fasces	f æ s iː z
jubile	d͡ʒ u b ə l
aevum	i v ə m
indexes	ɪ n d ɛ k s ɪ z
streetlet	s t ɹ iː t l ə t
misluck	m ɪ s l ʌ k
cooch	k uː t͡ʃ
eloquate	ɛ l ə k w e ɪ t
rectum	ɹ ɛ k t ə m
fragility	f ɹ ə d͡ʒ ɪ l ɪ t i
rusyn	r uː s ɪ n
tornedalen	t ɔː ɹ n ə d ɑː l ə n
resurrection	ɹ ɛ z ə ɹ ɛ k ʃ n̩
deneisha	d ɪ n iː ʃ ə
tickets	t ɪ k ɪ t s
thrilled	θ ɹ ɪ l d
debugger	d i b ʌ ɡ ə ɹ
ichnusaite	ɪ k n u s ə a ɪ t
entertained	ɛ n t ɚ t e ɪ n d
luxury	l ʌ k ʃ ə ɹ i
sparerib	s p ɛ ɚ ɹ ɪ b
climatic	k l a ɪ m æ t ɪ k
llandudno	l æ n d ɪ d n o ʊ
afresh	ʌ f ɹ ɛ ʃ
karin	k æ r ɪ n
nanase	n a n a s e
morris	m ɒ ɹ ɪ s
decima	d ɛ s ɪ m ə
ravine	ɹ æ v ɪ n
academical	æ k ə d ɛ m ɪ k l̩
obese	o ʊ b i s
quadraturist	k w ɒ d ɹ ə t͡ʃ ə ɹ ɪ s t
opry	ɒ p ɹ i
unartistic	ʌ n ɑ ɹ t ɪ s t ɪ k
impoverished	ɪ m p ɑ v ə ɹ ɪ ʃ t
froze	f ɹ o ʊ z
chillax	t͡ʃ ɪ l æ k s
optofluidics	ɑ p t o ʊ f l u ɪ d ɪ k s
digitigrade	d ɪ d͡ʒ ə t ə ɡ ɹ e ɪ d
arbitration	ɑ ɹ b ɪ t ɹ e ɪ ʃ ə n
duckling	d ʌ k l ɪ ŋ
adhocratic	æ d h ə k ɹ æ d ɪ k
pupal	p j uː p ə l
benzopyrazine	b ɛ n z ə ʊ p a ɪ ɹ ə z iː n
whimsy	w ɪ m z i
profusely	p ɹ ə f j u s l i
poontang	p uː n t æ ŋ
diamond	d a ɪ ə m ə n d
diaphoneme	d a ɪ ə f o ʊ n i m
cannoli	k ə n o ʊ l i
bulky	b ʌ l k i
terrier	t ɛ ɹ i ə ɹ
hadleigh	h æ d l i
preferred	p ɹ ɪ f ɝ d
fip	f ɪ p
waily	w e ɪ l i
gamaliel	ɡ æ m ə l iː ə l
redowa	ɹ ɛ d ə v ə
orinoco	o ʊ ɹ ɪ n o ʊ k o ʊ
jargle	d͡ʒ ɑː ɹ ɡ ə l
broil	b ɹ ɔ ɪ l
romansch	ɹ o ʊ m æ n ʃ
maybach	m a ɪ b ɑː k
intone	ɪ n t o ʊ n
ortiz	ɔ ɹ t i s
haking	h e ɪ k ɪ ŋ
uncountability	ʌ n k a ʊ n t ə b ɪ l ɪ t i
baulk	b ɔ k
belongs	b ɪ l ɔ ŋ z
tac	t æ k
skirl	s k ɜː l
sunbathe	s ʌ n b e ɪ ð
drossel	d ɹ ɒ s ə l
panther	p æ n θ ɚ
fonio	f ə ʊ n j ə ʊ
acampsia	ə k æ m p s i ə
is	ɪ z
peta	p iː t ə
bolster	b o ʊ l s t ɚ
jerrie	d͡ʒ ɛ ɹ i
dewey	d uː i
batavia	b ə t e ɪ v i ə
cyberocracy	s a ɪ b ə ɹ ɒ k ɹ ə s i
dominions	d ə m ɪ n j ə n z
semantics	s ɪ m æ n t ɪ k s
indifferent	ɪ n d ɪ f ə ɹ ə n t
canvass	k æ n v ə s
melodramata	m ɛ l ə d ɹ ɑ m ə t ə
polytheistic	p ɒ l ɪ θ iː ɪ s t ɪ k
blissfully	b l ɪ s f l i
unionization	j uː n j ə n a ɪ z e ɪ ʃ ə n
staphylococcus	s t æ f ə l ə k ɔ k ə s
adorableness	ə d ɔː ɹ ə b ə l n ə s
shleps	ʃ l ɛ p s
baking	b e ɪ k ɪ ŋ ɡ
utonian	j uː t o ʊ n i ə n
abdominogenital	æ b d ɑ m ɪ n o ʊ d͡ʒ ɛ n ɪ t l̩
linwood	l ɪ n w ʊ d
kiang	k i æ ŋ
flowrate	f l o ʊ ɹ e ɪ t
superomnipotence	s uː p ə ɹ ɒ m n ɪ p ə t ə n s
question	k w ɛ s t j ə n
hen	h ɛ n
algedonic	æ l d͡ʒ ɪ d ɒ n ɪ k
shadowy	ʃ æ d o ʊ i
windward	w ɪ n d w ə ɹ d
ganguro	ɡ ɑː n ɡ u ɹ ə ʊ
woodstock	w ʊ d s t ɒ k
evapotranspirational	ɪ v æ p o ʊ t ɹ æ n s p ɪ ɹ e ɪ ʃ ə n ə l
hettotype	h ɛ t ə t a ɪ p
udall	j uː d ɔː l
sequelae	s ɪ k w iː l i
attainments	ə t e ɪ n m ə n t s
pasithea	p ə s ɪ θ ɪ ə
cautiouser	k ɔː ʃ ə s ə ɹ
runs	ɹ ʌ n z
slight	s l a ɪ t
clowns	k l a ʊ n z
weeper	w i p ɚ
resonate	ɹ ɛ z ə n e ɪ t
renaldo	ɹ ɪ n æ l d ə ʊ
admirers	æ d m a ɪ ɚ ɚ z
hey	h e ɪ
visceral	v ɪ s ɚ ə l
louth	l a ʊ ð
clusters	k l ʌ s t ɚ z
mysoped	m a ɪ s ə ʊ p ɛ d
welly	w ɛ l i
rockower	ɹ ɑ k a ʊ ɚ
inkling	ɪ ŋ k l ɪ ŋ
carnivorously	k ɑː ɹ n ɪ v ə ɹ ə s l i
outermost	a ʊ t ɚ m o ʊ s t
aldehyde	æ l d ɪ h a ɪ d
haboku	h ɑ b o ʊ k u
abstinence	æ b s t ɪ n ə n s
paum	p ɑː m
clotho	k l o ʊ θ o ʊ
illation	ə l e ɪ ʃ ə n
conlanger	k ɑ n l æ ŋ ɚ
manor	m æ n ə ɹ
bowery	b a ʊ ə ɹ i
lyric	l ɪ ɹ ɪ k
phenoxypropazine	f ə n ɒ s k i p ɹ ə ʊ p ə z iː n
bardolatrous	b ɑː ɹ d ɒ l ə t ɹ ə s
scrappy	s k ɹ æ p i
taxi	t æ k s i
brand	b r æ n d
assess	ə s ɛ s
abundancy	ə b ʌ n d n̩ s i
lair	l ɛ ɚ
foraminifer	f ɔ ɹ ə m ɪ n ə f ɚ
lend	l ɛ n d
agartala	ə ɡ ə ɹ t ə l ə
signification	s ɪ ɡ n ɪ f ɪ k e ɪ ʃ ə n
latency	l e ɪ t ə n s i
whatsoever	h w ʌ t s o ʊ ɛ v ɚ
festschrift	f ɛ s t ʃ ɹ ɪ f t
acculturate	ə k ʌ l t͡ʃ ə ɹ e ɪ t
reese	ɹ i s
codecs	k o ʊ d ɛ k s
zizania	z ɪ z e ɪ n i ə
hemmel	h ɛ m ə l
donepezil	d o ʊ n ɛ p ə z ɪ l
danish	d e ɪ n ɪ ʃ
sink	s ɪ ŋ k
yawp	j ɔː p
afterward	æ f t ɚ w ɚ d
arrives	ə ɹ a ɪ v z
synopsis	s ɪ n ɑ p s ɪ s
omega	o ʊ m e ɪ ɡ ə
sanskrit	s æ n s k ɹ ɪ t
ge'ez	ɡ iː ɛ z
relic	ɹ ɛ l ɪ k
thorax	θ ɔ ɹ æ k s
dalry	d æ l ɹ a ɪ
silhouette	s ɪ l uː w ɛ t
illegal	ɪ l i ɡ ə l
yakky	j æ k i
strikesthrough	s t ɹ æ ɪ k s θ ɹ u
absolvitory	æ b s ɑ l v ə t ɔ ɹ i
clavichord	k l æ v ɪ k ɔ ɹ d
friend	f ɹ ɛ n d
proleptical	p ɹ ə ʊ l ɛ p t ɪ k ə l
inquest	ɪ ŋ k w ɛ s t
computerette	k ə m p j u t ɚ ɹ ɛ t
tetracycline	t ɛ t ɹ ə s a ɪ k l iː n
wug	w ʌ ɡ
snaked	s n e ɪ k t
humdinger	h ʌ m d ɪ ŋ ɚ
ned	n ɛ d
attract	ə t ɹ æ k t
preëmptory	p ɹ iː ɛ m p t ə ɹ i
satire	s æ t a ɪ ɹ
petrine	p i t ɹ a ɪ n
kinney	k ɪ n i
aramaic	æ ɹ ə m e i ɪ k
fenoldopam	f ɪ n o ʊ l d ə p æ m
spelunk	s p iː l ʌ ŋ k
stringer	s t ɹ ɪ ŋ ɚ
euro	j ɝ o ʊ
teschenite	t ɛ ʃ ə n a ɪ t
bassooned	b ə s uː n d
dre	d ɹ e ɪ
goosefoot	ɡ uː s f ʊ t
blumenthal	b l uː m ə n t ɑː l
quibble	k w ɪ b ə l
salicional	s ə l ɪ ʃ n ə l
hyperbolize	h a ɪ p ɝ b ə l a ɪ z
ghana	ɡ æ n ə
worldly	w ɜː ɹ l d l i
abiotically	e ɪ b a ɪ ɑ t ɪ k l i
bampot	b æ m p ɒ t
indinavir	ɪ n d ɪ n ə v ɪ ɹ
stubbington	s t ʌ b ɪ ŋ t ə n
adenines	æ d ɪ n ɪ n z
pitcher	p ɪ t͡ʃ ɚ
pallium	p æ l i ə m
fishhook	f ɪ ʃ h ʊ k
made	m e ɪ d
vinblastine	v ɪ n b l æ s t iː n
ingredient	ɪ n ɡ ɹ iː d i ə n t
schwa	ʃ w ɑ
intemperance	ɪ n t ɛ m p ɛ ɹ ə n s
heaumes	h ə ʊ m z
sirius	s ɪ ɹ i ə s
mésalliance	m e ɪ z ə l a ɪ ə n s
peaceful	p iː s f ə l
cruising	k ɹ uː z ɪ ŋ
blow	b l o ʊ
wenis	j uː n ə s
saturate	s æ t͡ʃ ə ɹ e ɪ t
naught	n ɔ t
collectible	k ə l ɛ k t ɪ b ə l
quietly	k w a ɪ ɪ t l i
keene	k iː n
ryelage	ɹ a ɪ l ɪ d͡ʒ
overspecialize	o ʊ v ɚ s p ɛ ʃ ə l a ɪ z
prof	p ɹ ɑ f
ciss	s ɪ s
engross	ɛ n ɡ ɹ o ʊ s
frigorific	f ɹ ɪ ɡ ə ɹ ɪ f ɪ k
bebless	b i b l ɛ s
handless	h æ n d l ə s
paddocking	p æ d ə k ɪ ŋ
ingenuous	ɪ n d͡ʒ ɛ n j u ə s
residency	ɹ ɛ z ɪ d ə n s i
leucotome	l uː k ə t ə ʊ m
clutched	k l ʌ t͡ʃ t
jinn	d͡ʒ ɪ n
nunavut	n j uː n ə v uː t
salutatory	s ə l uː t ə t ɔː ɹ iː
panga	p a ŋ ɡ ə
aguise	ə ɡ a ɪ z
fus'ha	f ʊ s h ə
tones	t o ʊ n z
these've	ð i z ə v
tyne	t a ɪ n
pitjantjatjara	p ɪ t͡ʃ ə n t͡ʃ ə t͡ʃ aː r ə
gambol	ɡ æ m b ə l
intake	ɪ n t e ɪ k
wiradjuric	w ɪ r aː d͡ʒ u r iː k
malaxable	m ə l æ k s ə b ə l
abiturient	ɑ b ɪ t u ɹ i ɛ n t
metagnomy	m ə t æ ɡ n ə m i
biscotto	b ɪ s k ɑ t o ʊ
fieldwork	f i l d w ɝ k
sailor	s e ɪ l ɚ
theater	θ i ə t ɚ
completist	k ə m p l iː t ɪ s t
hizouse	h ɪ z a ʊ s
specialist	s p ɛ ʃ ə l ɪ s t
downblend	d o u n b l ɛ n d
tushker	t ʌ ʃ k ə ɹ
bona	b ə ʊ n ə
nictitate	n ɪ k t ɪ t e ɪ t
murray	m ɜ ɹ i
unwittingly	ʌ n w ɪ t ɪ ŋ l i
dinorwig	d ɪ n ɔ r w ɪ ɡ
spelk	s p ɛ l k
cricoarytenoidei	k ɹ a ɪ k o ʊ æ ɹ ə t i n ɔ ɪ d i a ɪ
enthronize	ɛ n θ ɹ o ʊ n a ɪ z
vecuronium	v ɛ k j ə ɹ o ʊ n i ə m
rhinocerotes	ɹ a ɪ n ɑː s ə ɹ o ʊ t s
seedtime	s iː d t a ɪ m
quarrel	k w ɔ ɹ ə l
swamp	s w ɑ m p
gorget	ɡ o ɹ d͡ʒ ə t
draw	d ɹ ɔ
hobart	h ə ʊ b ɑː t
fopdoodle	f ɑ p d u d ə l
billed	b ɪ l d
orbital	ɔ ɹ b ə t l̩
anagoge	æ n ə ɡ o ʊ d͡ʒ i
ashkelon	æ ʃ k ə l ɒ n
groyper	ɡ r ɔ ɪ p ɝ
invariance	i n v ɛ ə ɹ i ə n s
fascinum	f æ s ɪ n ə m
pharmacovigilance	f ɑ ɹ m ə k o ʊ v ɪ d͡ʒ ɪ l ə n s
anaptyxis	æ n ə p t ɪ k s ɪ s
panipuri	p ɑ n i p ʊ ɹ i
pondicherry	p ɒ n d ɪ t ʃ ɛ ɹ i
calmy	k ɑː m i
influencer	ɪ n f l u ə n s ə ɹ
decking	d ɛ k ɪ ŋ
delage	d ə l a ʒ
blends	b l ɛ n d z
sokushinbutsu	s ɒ k u ʃ ɪ n b ʊ t s uː
peeking	p iː k ɪ ŋ
wanton	w ɑ n t ə n
volvelle	v ɑ l v ɛ l
lessen	l ɛ s ə n
sprightly	s p ɹ a ɪ t l i
areole	æ ɹ i o ʊ l
privilege	p ɹ ɪ v ɪ l ɪ d͡ʒ
pulls	p ʊ l z
spoke	s p ə ʊ k
bedight	b ɪ d a ɪ t
skive	s k a ɪ v
semeion	s ɪ m a ɪ ɒ n
astral	æ s t ɹ ə l
culantro	k uː l æ n t ɹ o ʊ
tracks	t ɹ æ k s
baconic	b ə k ə ʊ n ɪ k
crediting	k ɹ ɛ d ɪ t ɪ ŋ
nulled	n ʌ l d
verstehen	v ə ɹ ʃ t e ɪ ə n
shalt	ʃ æ l t
erythremia	ɛ ɹ ɪ θ ɹ iː m i ə
alludes	ə l uː d z
redebug	ɹ iː d iː b ʌ ɡ
nodule	n ɑː d͡ʒ uː l
trews	t ɹ uː z
rasorial	ɹ ə s ɔː ɹ ɪ ə l
antiquity	æ n t ɪ k w ə t i
commencement	k ə m ɛ n s m ə n t
cowbit	k a ʊ b ɪ t
skens	s k ɛ n z
nief	n iː f
pisciculture	p ɪ s ɪ k ʌ l t͡ʃ ə ɹ
flabellate	f l ə b ɛ l ə t
flimsy	f l ɪ m z i
acanthopodous	æ k æ n θ ɑ p ə d ə s
dais	d e ɪ ɪ s
recurve	ɹ ɪ k ɜː ɹ v
gaff	ɡ æ f
whaler	w e ɪ l ɚ
thumbtack	θ ʌ m t æ k
requisite	ɹ ɛ k w ɪ z ɪ t
erythrocyte	ə ɹ ɪ θ ɹ ə s a ɪ t
bixie	b iː ʃ e ɪ
clicking	k l ɪ k ɪ ŋ
secure	s ə k j ɔ ɹ
awaze	ɑ w ɑ z e ɪ
rolleston	ɹ ɒ l ə s t ə n
evaluative	ɪ v æ l j u ə t ɪ v
revertent	ɹ ɪ v ɜː ɹ t ə n t
continue	k ə n t ɪ n j uː
temazepam	t ə m æ z ə p æ m
raajmahal	r ɑː d͡ʒ m ə h ə l
polished	p ɑ l ɪ ʃ t
ways	w e ɪ z
oolith	o ʊ ə l ɪ θ
natasha	n ə t æ ʃ ə
bastes	b e ɪ s t s
trenches	t ɹ ɛ n t͡ʃ ɪ z
accentor	ə k s ɛ n t ɚ
bowtie	b o ʊ t a ɪ
obadiah	o ʊ b ə d a ɪ ə
figgy	f ɪ ɡ i
chippendale	t͡ʃ ɪ p n̩ d e ɪ l
boneseeker	b o ʊ n s i k ɚ
salak	s ə l æ k
septicaemic	s ɛ p t ɪ s iː m ɪ k
ureter	j ʊ ə ɹ iː t ə ɹ
netty	n ɛ t i
honeysuckle	h ʌ n iː s ʌ k ə l
dematerialize	d i m ə t ɪ ɹ i ə l a ɪ z
veriest	v ɛ ɹ i ə s t
buchi	b ʊ t͡ʃ i
extremities	ɪ k s t ɹ ɛ m ə t i z
perilla	p ə ɹ ɪ l ə
sicel	s ɪ k ə l
operand	ɑ p ə ɹ æ n d
hertz	h ɝ t s
benzonatate	b ɛ n z o ʊ n ə t e ɪ t
agoraphobia	æ ɡ ɚ ə f o ʊ b i ə
tufty	t ʌ f t i
brooke	b ɹ ʊ k
bristly	b ɹ ɪ s l i
dispenser	d ɪ s p ɛ n s ə
stancel	s t æ n s ə l
tortfeasor	t ɔ ɹ t f iː z ɚ
whirled	h w ɝ l d
advancer	ə d v æ n s ɚ
evaporite	ɪ v æ p ə ɹ a ɪ t
gridlock	ɡ ɹ ɪ d l ɑ k
swelt	s w ɛ l t
powldoody	p a ʊ l d uː d i
firelock	f a ɪ ə ɹ l ɑ k
kielbasa	k i l b ɑ s ə
suggestions	s ə ɡ d͡ʒ ɛ s t͡ʃ ə n z
govvy	ɡ ʌ v i
arty	ɑː ɹ t i
phrasebooks	f ɹ e ɪ z b ʊ k s
neutrophile	n uː t ɹ o ʊ̯ f a ɪ̯ ɫ
function	f ʌ ŋ k ʃ ə n
longevous	l ɔ n d͡ʒ iː v ə s
pyroxene	p a ɪ ɹ ɑ k s i n
sunita	s uː n iː t ə
quartet	k w ɔː ɹ t ɛ t
loot	l uː t
vacua	v æ k j u ə
cacoethes	k a k ə ʊ iː θ iː z
fryatt	f ɹ a ɪ ə t
bagger	b æ ɡ ɚ
handstand	h æ n d s t æ n d
astrobleme	æ s t ɹ o ʊ b l i m
myiasis	m a ɪ a ɪ ə s ɪ s
finical	f ɪ n ɪ k ə l
tetrylammonium	t ɛ t ɹ ə l ə m o ʊ n i ə m
transcribe	t r æ n s k ɹ a ɪ b
permeable	p ɜː ɹ m i ə b ə l
impatiently	ɪ m p e ɪ ʃ ə n t l i
stoor	s t ɔ ɚ
pentetrazol	p ɛ n t ɛ t ɹ ə z ɒ l
pittance	p ɪ t ə n s
add	æ d
irritate	ɪ ɹ ɪ t e ɪ t
overvast	ə ʊ v ə b ɝ s t
ginnie	d͡ʒ ɪ n i
greatness	ɡ ɹ e ɪ t n ə s
aquiline	æ k w ɪ l a ɪ n
synonym	s ɪ n ə n ɪ m
ciabatta	t͡ʃ ə b ɑː t a
absaroke	æ b s o ɹ k i
abouts	ə b a ʊ t s
dearly	d ɪ ɹ l i
acanthocephalid	ə k æ n t θ ə s ɛ f ə l ɪ d
reactionary	ɹ i æ k t͡ʃ ə n ɛ ɚ i
muntjac	m ʌ n t d͡ʒ æ k
quiche	k iː ʃ
subscriber	s ə b s k ɹ a ɪ b ɚ
eunice	j uː n ɪ s
hygraulic	h a ɪ ɡ ɹ ɒ l ɪ k
skills	s k ɪ l z
preparative	p ɹ ə p æ ɹ ə t ɪ v
taro	t ɑ ɹ o ʊ
ily	ɪ l i
science	s a ɪ ə n s
harpagon	h ɑː ɹ p ə ɡ ɒ n
amman	ɑː m ɑː n
mariah	m ə ɹ a ɪ ə
keeler	k i l ɚ
mccrea	m ɪ k k r e ɪ
liniment	l ɪ n ə m ə n t
pepcid	p ɛ p s ɪ d
workflow	w ɝ k f l o ʊ
lapsarian	l æ p s ɛ ə ɹ ɪ ə n
piphilologist	p a ɪ f ɪ l ɑ l ə d͡ʒ ɪ s t
derich	d i ɹ ɪ t͡ʃ
desnuda	d ɛ s n u d ɑ
fafia	f æ f i ə
azymous	e ɪ z a ɪ m ə s
horizontal	h ɔː ɹ ə z ɑː n t ə l
priceless	p ɹ a ɪ s l ə s
masterly	m æ s t ɚ l i
poussette	p uː s ɛ t
kitbag	k ɪ t b æ ɡ
scorpio	s k ɔː ɹ p ɪ o ʊ
kinshasa	k ɪ n ʃ ɑː s ə
beaver	b i v ɚ
kerygma	k ə ɹ ɪ ɡ m ə
oma	o ʊ m ɑ
doo	d u
aber	æ b ɚ
centred	s ɛ n t ə ɹ d
clitoral	k l ɪ t ɔ ɹ ə l
abductor	æ b d ʌ k t ɚ
featly	f iː t l i
copsy	k ɒ p s i
snipelike	s n a ɪ p l a ɪ k
oligophrenia	ɒ l ɪ ɡ o ʊ f ɹ iː n ɪ ə
acoelomic	e ɪ s iː l ɒ m ɪ k
oryx	o ʊ ɹ ɪ k s
cheating	t͡ʃ iː t ɪ ŋ
hullock	h ʌ l ə k
beckett	b ɛ k ɪ t
workmanship	w ɜː k m ə n ʃ ɪ p
abducens	æ b d j u s ɛ n z
casanova	k æ s ə n o ʊ v ə
slimebucket	s l a i m b ʌ k ɪ t
civility	s ɪ v ɪ l ɪ t i
monish	m ɒ n ɪ ʃ
ivanhoe	a ɪ v ə n h o ʊ
stirred	s t ɝ d
waterwork	w ɔ t ɚ w ɚ k
flavorsome	f l e ɪ v ɚ s ə m
fibulares	f ɪ b j ə l ɛ ɹ i z
holofernes	h ɑː l ə f ɝː n iː z
dzud	d z uː d
sounding	s a ʊ n d ɪ ŋ
zeppola	t s ɛ p ə l ə
won	w ɑ n
askance	ə s k æ n s
ra	ɹ ɑː
ordinary	ɔ ɹ d ɪ n ɛ ə ɹ i
ratisbon	ɹ æ t ɪ z b ɑ n
besought	b ɪ s ɔː t
bacup	b e ɪ k ʌ p
bangalore	b æ ŋ ɡ ə l o ɹ
reciprocal	ɹ ɪ s ɪ p ɹ ə k ə l
chore	t͡ʃ ɔ ɹ
buddhist	b u d ɪ s t
paracosm	p æ ɹ ə k ɒ z ə m
shenyang	ʃ ɛ n j æ ŋ
skunk	s k ʌ ŋ k
massey	m æ s i
animus	æ n ɪ m ə s
mexicali	m ɛ k s ɪ k æ l i
flouting	f l a ʊ t ɪ ŋ
forbid	f ɚ b ɪ d
retrospective	ɹ ɛ t ɹ ə ʊ s p ɛ k t ɪ v
dalmatian	d æ l m e ɪ ʃ ə n
regle	ɹ ɛ ɡ ə l
etesian	ɪ t iː z ɪ ə n
cumin	k j u m ɪ n
phac	p iː h æ k
potency	p ə ʊ t ə n s i
reversionary	ɹ ə v ɝ ʒ ə n ɛ ɹ i
amassment	ə m æ s m ə n t
tentacular	t ɛ n t æ k j uː l ə ɹ
continental	k ɑ n t ɪ n ɛ n t l̩
dessiatina	d ɛ s j ə t iː n ə
repent	ɹ iː p ə n t
calmer	k ɑː m ə
cruised	k ɹ uː z d
pitch	p ɪ t͡ʃ
lunatic	l uː n ə t ɪ k
sazerac	s æ z ə ɹ æ k
dickies	d ɪ k i z
sternocleidomastoidei	s t ɝ n ə k l a ɪ d ə m æ s t ɔ ɪ d i a ɪ
cuissard	k w i s ɑ ɹ d
acanthosoma	ə k æ n θ ə s o ʊ m ə
connote	k ə n o ʊ t
poliorcetics	p o ʊ l i ɔ ɹ s ɛ t ɪ k s
abnegation	æ b n ə ɡ e ɪ ʃ ə n
lamely	l e ɪ m l i
circles	s ɝ k l̩ z
tatting	t æ t ɪ ŋ
infinitesimal	ɪ n f ɪ n ɪ t ɛ s ɪ m ə l
cardinal	k ɑ ɹ d n ə l
infrahyoid	ɪ n f ɹ ə h a ɪ ɔ ɪ d
longsword	l ɔ ŋ s ɔ ɹ d
gutter	ɡ ʌ t ɚ
scrivening	s k ɹ ɪ v ɛ n ɪ ŋ
condyle	k ɒ n d a ɪ l
dudley	d ʌ d l i
loll	l ɑ l
catamaran	k æ t ə m ə ɹ æ n
soldanrie	s o ʊ l d ə n ɹ i
cotyledon	k ɑ t ə l iː d ə n
carts	k ɑ ɹ t s
waul	w ɔː l
galoshes	ɡ ə l ɒ ʃ ɪ z
mses	m ɪ z ə z
reprise	ɹ ɪ p ɹ a ɪ z
wavelength	w e ɪ v l ɛ ŋ k θ
me	m i
superbeing	s u p ɚ b i ŋ
gosewehr	ɡ o ʊ z w ɛ ə ɹ
throwendish	θ r ə ʊ ə n d ɪ ʃ
adirondack	æ d ɪ ɹ ɑ n d æ k
adolph	e ɪ d ɑ l f
interception	ɪ n t ɚ s ɛ p ʃ ə n
acrylate	æ k ɹ ɪ l e ɪ t
sadist	s e ɪ d ɪ s t
feud	f j uː d
absorptive	æ b s ɔ ɹ p t ɪ v
whorlton	w ɔː ɹ l t ə n
thaxted	θ æ k s t ɪ d
stairs	s t ɛ ɹ z
gibraltar	d͡ʒ ɪ b ɹ ɒ l t ə ɹ
perplexity	p ə ɹ p l ɛ k s ə d i
varronian	v æ ɹ o ʊ n i ə n
lawn	l ɔ n
bespawl	b ɪ s p ɔ l
romanesque	ɹ o ʊ m ə n ɛ s k
isogriv	a ɪ s o ʊ ɡ ɹ ɪ v
rustacean	ɹ ʌ s t e ɪ ʃ ə n
armiger	ɑː ɹ m ɪ d͡ʒ ɚ
anatoli	æ n ə t o ʊ l i
which've	w ɪ t͡ʃ ə v
anguine	æ ŋ ɡ w ɪ n
demonstrate	d ɛ m ə n s t ɹ e ɪ t
disbud	d ɪ s b ʌ d
slavi	s l ɑ v i
lubra	l uː b ɹ ə
haggle	h æ ɡ ə l
sho	ʃ o ʊ
shocking	ʃ ɑ k ɪ ŋ
shanxi	ʃ ɑ n ʃ i
female	f iː m e ɪ l
rested	ɹ ɛ s t ə d
taciturn	t æ s ɪ t ɝ n
sumptuous	s ʌ m p t͡ʃ u ə s
commonplace	k ɑ m ə n p l e ɪ s
abdominocardiac	æ b d ɑ m ɪ n o ʊ k ɑ ɹ d i æ k
amok	ə m ɒ k
soteriology	s ə ʊ t ɪ ə ɹ ɪ ɒ l ə d͡ʒ i
crow	k ɹ o ʊ
ablaze	ə b l e ɪ z
deluded	d ɪ l uː d ɪ d
upward	ʌ p w ɜː ɹ d
munificence	m j uː n ɪ f ɪ s ə n s
shrining	ʃ ɹ a ɪ n ɪ ŋ
head	h ɛ d
bowel	b a ʊ l
seesaw	s i s ɔ
henpeck	h ɛ n p ɛ k
luzon	l u z ɔ n
whether	w ɛ ð ə ɹ
gosplan	ɡ ɒ s p l æ n
subtrahend	s ʌ b t ɹ ə h ɛ n d
mordant	m ɔː ɹ d ə n t
artel	ɑː ɹ t ɛ l
discus	d ɪ s k ə s
scrunge	s k ɹ ʌ n d͡ʒ
abscision	æ b s ɪ ʒ n̩
recalcitrate	ɹ ɪ k æ l s ɪ t ɹ e ɪ t
trillion	t ɹ ɪ l j ə n
sifter	s ɪ f t ɚ
sambuq	s æ m b u k
ecstatica	ɛ k s t æ t ɪ k ə
natal	n e ɪ t ə l
baidu	b a ɪ d uː
comprehension	k ɑ m p ɹ ɪ h ɛ n ʃ n̩
daimyo	d a ɪ m j o ʊ
penglai	p ɛ ŋ l a ɪ
hewings	h j uː ɪ ŋ z
ricochetted	ɹ ɪ k ə ʃ ɛ t ɪ d
meaburn	m iː b ɜː r n
petrarch	p i t ɹ ɑ ɹ k
uliginous	j uː l ɪ d͡ʒ ɪ n ə s
amalek	æ m ə l ɛ k
insular	ɪ n s j ə l ɚ
hexapod	h ɛ k s ə p ɑ d
quartan	k w ɔ ɹ t ə n
sugarcoat	ʃ ʊ ɡ ɚ k o ʊ t
cantillation	k æ n t ɪ l e ɪ ʃ ə n
tribulation	t ɹ ɪ b j ə l e ɪ̯ ʃ ə n
dulce	d ʌ l s
diomedes	d a ɪ ə m iː d iː z
flaneur	f l ɑ n ʊ ɚ
saury	s ɔː ɹ i
kelvin	k ɛ l v ə n
adorbs	ə d ɔ ɹ b z
zolpidem	z o ʊ l p ɪ d ɛ m
boulevard	b ʊ l ə v ɑ ɹ d
tarnish	t ɑ ɹ n ɪ ʃ
squirmy	s k w ɝ m i
conjurer	k ʌ n d͡ʒ ə ɹ ə ɹ
shopworn	ʃ ɒ p w ɔː ɹ n
nuqta	n ʊ k t ə
alkalic	æ l k æ l ɪ k
bobo	b o ʊ b o ʊ
antiphon	æ n t ɪ f ɑ n
coldham	k ə ʊ l d ə m
pledged	p l ɛ d͡ʒ d
einstein	a ɪ n s t a ɪ n
bentwood	b ɛ n t w ʊ d
tropic	t ɹ ɒ p ɪ k
epidermis	ɛ p ə d ɝ m ə s
necessitous	n ə s ɛ s ə t ə s
hummel	h ʌ m ə l
frontal	f ɹ ʌ n l̩
responsiveness	ɹ ɪ s p ɒ n s ɪ v n ɪ s
numinous	n j u m ə n ə s
fungi	f u n d͡ʒ i
pestling	p ɛ s ə l ɪ ŋ
undulant	ʌ n d͡ʒ ʊ l ə n t
permission	p ɚ m ɪ ʃ ə n
supratrochlear	s u p ɹ ə t ɹ ɑ k l i ɚ
hold	h o ʊ l d
soda	s o ʊ d ə
dilate	d a ɪ l e ɪ t
flapping	f l æ p ɪ ŋ
alif	a l ɪ f
tholeiite	θ o ʊ l i a ɪ t
pentateuch	p ɛ n t ə t j uː k
fatal	f e ɪ t ə l
eponychium	ɛ p ə n ɪ k i ə m
maybe	m e ɪ b i
anyways	ɛ n i w e ɪ z
phenylsilatrane	f ɛ n ɪ l s ɪ l ə t ɹ e ɪ n
hyoidal	h a ɪ ɔ ɪ d ə l
epics	ɛ p ɪ k s
tenses	t ɛ n s ɪ z
sakes	s e ɪ k s
hashish	h æ ʃ iː ʃ
labefaction	l æ b ə f æ k ʃ ə n
liraglutide	l ɪ ɹ æ ɡ l ʊ t a ɪ d
tucson	t uː s ɒ n
seguin	s ə ɡ iː n
football	f ʊ t b ɔ l
naively	n a ɪ i v l i
wandy	w ɒ n d i
trumps	t ɹ a m p s
khedive	k ə d iː v
contraband	k ɑ n t ɹ ə b æ n d
acidic	ə s ɪ d ɪ k
lactulose	l æ k t j ʊ l o ʊ s
acuity	ə k j uː ɪ t i
thimbling	θ ɪ m b l ɪ ŋ
gymnasium	d͡ʒ ɪ m n e ɪ z i ə m
irritated	ɪ ɹ ɪ t e ɪ t ɪ d
aliter	æ l ɪ t ɚ
bloaty	b l o ʊ t i
ballerino	b æ l ə ɹ iː n o ʊ
concordant	k ə ŋ k ɔː ɹ d ə n t
mucosoplasty	m j u k o ʊ z o ʊ p l æ s t i
slapdash	s l æ p d æ ʃ
ion	a ɪ o ʊ n
virtue	v ɝ t͡ʃ u
afghan	æ f ɡ æ n
gibnut	ɡ ɪ b n ʌ t
redden	ɹ ɛ d n̩
twelvetide	t w ɛ l v t a ɪ d
missouran	m ə z ɝ ə n
willpower	w ɪ l p a ʊ ɚ
ethane	ɛ θ e ɪ n
prequel	p ɹ iː k w ə l
hexadecimal	h ɛ k s ə d ɛ s ɪ m ə l
suppawn	s ə p ɔː n
ethea	iː θ ɪ ə
micronova	m a ɪ k ɹ o n o ʊ v ə
boast	b o ʊ s t
flexed	f l ɛ k s t
leapfrog	l iː p f ɹ ɑ ɡ
sanguinolent	s æ ŋ ɡ w ɪ n ə l ə n t
mylar	m a ɪ l ɑ ɹ
philistine	f ɪ l ɪ s t a ɪ n
dipole	d a ɪ p o ʊ l
captopril	k æ p t ə p ɹ ɪ l
misoneism	m a ɪ s ə n iː ɪ z ə m
jetsam	d͡ʒ ɛ t s ə m
impresario	ɪ m p r ɪ s ɑː r ɪ ə ʊ
blamable	b l e ɪ m ə b ə l
molar	m o ʊ l ɚ
ancestral	æ n s ɛ s t ə ɹ ə l
whacks	w æ k s
strengthened	s t ɹ ɛ ŋ θ ə n d
heathrow	h iː θ ɹ o ʊ
despotic	d ɛ s p ɑ t ɪ k
balearic	b æ l i æ ɹ ɪ k
squeenix	s k w iː n ɪ k s
lambda	l æ m d ə
lhasa	l ɑː s ə
fembitch	f ɛ m b ɪ t͡ʃ
pest	p ɛ s t
ethionamide	ɛ θ a ɪ ɑ n ə m a ɪ d
blokes	b l o ʊ k s
braked	b ɹ e ɪ k t
notoriety	n o ʊ t ɚ a ɪ ə t i
eclectic	ɛ k l ɛ k t ɪ k
niding	n a ɪ d ɪ ŋ
prucalopride	p ɹ u k æ l ə p ɹ a ɪ d
verset	v ɚ s ə t
bulletproof	b ʊ l ɪ t p ɹ uː f
piers	p ɪ ɹ z
tumbril	t ʌ m b ɹ ɪ l
foolhardy	f u l h ɑ ɹ d i
nerf	n ɝ f
premarin	p ɹ ɛ m ə ɹ ɪ n
ebony	ɛ b ə n i
meropic	m ɛ ɹ o ʊ p ɪ k
unakas	j u n e ɪ k ə z
linty	l ɪ n t i
eutrapely	j uː t ɹ æ p ə l ɪ
cosmopoleis	k ɒ z m ɒ p ɒ l ɛ ɪ z
patch	p æ t͡ʃ
advantageous	æ d v ə n t e ɪ d͡ʒ ə s
turin	t ə ɹ ɪ n
terrenceville	t ɛ ɹ ə n s v ɪ l
cymbalist	s ɪ m b ə l ɪ s t
stallon	s t æ l ə n
nauseated	n ɔː z i e ɪ t ɪ d
incumbent	ɪ n k ʌ m b ə n t
inconsistent	ɪ n k ə n s ɪ s t ə n t
douchebag	d uː ʃ b æ ɡ
maguire	m ə ɡ w a ɪ ɹ
optics	ɑ p t ɪ k s
howdah	h a ʊ d ə
beneke	b ɛ n ə k i
slaver	s l e ɪ v ɚ
basheer	b ə ʃ i ɹ
airport	ɛ ɹ p ɔ ɹ t
banes	b e ɪ n z
teas	t iː z
presses	p ɹ ɛ s ɪ z
plateaux	p l æ t o ʊ z
zoledronate	z o ʊ l ɛ d ɹ ə n e ɪ t
eiffel	a ɪ f l̩
call't	k ɔː l t
whales	w e ɪ l z
sting	s t ɪ ŋ
serpette	s ɜː ɹ p ɛ t
sleepiphany	s l ɛ p ɪ f ə n i
coquette	k o ʊ k ɛ t
gymnastics	d͡ʒ ɪ m n æ s t ɪ k s
freyja	f ɹ e ɪ ə
fandub	f æ n d ʌ b
daunt	d ɔ n t
vaguely	v e ɪ ɡ l i
tender	t ɛ n d ə
diagenesis	d a ɪ ə d͡ʒ ɛ n ə s ɪ s
adusk	ə d ʌ s k
antics	æ n t ɪ k s
clumb	k l ʌ m
driscoll	d ɹ ɪ s k ə l
glitches	ɡ l ɪ t͡ʃ ɪ z
academics	æ k ə d ɛ m ɪ k s
hubby	h ʌ b i
trike	t ɹ a ɪ k
serves	s ɝ v z
trekkie	t ɹ ɛ k i
untakeable	ʌ n t e ɪ k ə b l̩
voluntary	v ɑ l ə n t ɛ ɹ i
drawings	d ɹ ɔ ɪ ŋ z
pensive	p ɛ n s ɪ v
hardscrabble	h ɑ ɹ d s k ɹ æ b ə l
alps	æ l p s
yarn	j ɑ ɹ n
palingenesy	p æ l ɪ n d͡ʒ ɛ n ə s i
floyd	f l ɔ ɪ d
transgression	t ɹ æ n s ɡ ɹ ɛ ʃ ə n
scamp	s k a m p
quoll	k w o ʊ l
baubon	b ɔː b ə n
elf	ɛ l f
kingdom	k ɪ ŋ d ə m
stakes	s t e ɪ k s
adianoeta	e ɪ d a ɪ ə n ə ʊ iː t ə
halfpenny	h e ɪ p ə n i
baddams	b æ d ə m z
glossitis	ɡ l ɒ s a ɪ t ɪ s
metabolite	m ɪ t æ b ə l a ɪ t
canadiens	k ə n e ɪ d i ə n z
grid	ɡ ɹ ɪ d
rotherham	ɹ ɒ ð ə ɹ ə m
almah	æ l m ə
deceives	d ɪ s iː v z
binds	b a ɪ n d z
pearl	p ɝ l
swept	s w ɛ p t
affluence	æ f l u ə n s
apoxyomenos	ə p ɑ k s i ɑ m ə n ɑ s
adoxographer	e ɪ d ɑ k s ɑ ɡ ɹ ə f ɚ
penelope	p ɪ n ɛ l ə p i
sherman	ʃ ɜː ɹ m ə n
palaces	p æ l ɪ s ɪ z
viewed	v j uː d
disgruntlement	d ɪ s ɡ ɹ ʌ n t ə l m ɪ n t
zed	z ɛ d
yangon	j ɑ ŋ ɡ o ʊ n
therapeutic	θ ɛ ɹ ə p j uː t ɪ k
unprofitable	ʌ n p ɹ ɑ f ɪ t ə b l̩
quartararo	k w ɔ ɹ t ə ɹ ɑː ɹ o ʊ
obtain	ə b t e ɪ n
bushy	b ʊ ʃ i
gleeman	ɡ l iː m ə n
auspice	ɔ s p ɪ s
bighead	b ɪ ɡ h ɛ d
myokine	m a ɪ ə ʊ k a ɪ n
whistle	w ɪ s l̩
organisation	ɔ ɹ ɡ ə n ɪ z e ɪ ʃ ə n
kate	k e ɪ t
runway	ɹ ʌ n w e ɪ
arraigning	ə ɹ e ɪ n ɪ ŋ
masquerade	m æ s k ə ɹ e ɪ d
pledging	p l ɛ d͡ʒ ɪ ŋ
bins	b ɪ n z
tampa	t æ m p ə
sclerotal	s k l ə ɹ ə ʊ t ə l
geoglyph	d͡ʒ iː ə ɡ l ɪ f
dover	d o ʊ v ɚ
mawn	m ɔː n
conscience	k ɑ n ʃ ə n s
floss	f l ɔ s
haudenosaunee	h o ʊ d ə n o ʊ ʃ o ʊ n i
merde	m ɛː ɹ d
multifold	m ʌ l t ə f o ʊ l d
yourself	j ɔ ɹ s ɛ l f
fire	f a ɪ ə ɹ
hermeneutical	h ɝ m ə n j uː t ɪ k ə l
apoptosis	æ p ə p t o ʊ s ə s
ruritanian	ɹ ʊ ɹ ɪ t e ɪ n i ə n
comparably	k ɒ m p æ ɹ ə b l̩ i
broiler	b ɹ ɔ ɪ l ɚ
looter	l u t ɚ
dissertation	d ɪ s ɚ t e ɪ ʃ ə n
ultravast	ʌ l t ɹ ə v æ s t
bagels	b e ɪ ɡ ə l z
zygomatic	z a ɪ ɡ ə m æ t ɪ k
copter	k ɑ p t ɚ
abaculus	ə b æ k j ə l ə s
perform	p ɚ f ɔ ɹ m
hugely	h j uː d͡ʒ l i
consonantal	k ɑ n s ə n æ n t ə l
subterfuge	s ʌ b t ə ɹ f j uː d͡ʒ
western	w ɛ s t ɚ n
puppies	p ʌ p i z
nunation	n ʌ n e ɪ ʃ n̩
entertainer	ɛ n t ə t e ɪ n ə
animadversion	æ n ɪ m æ d v ɝː ʃ ə n
galangal	ɡ ə l æ ŋ ɡ ə l
ensue	ɪ n s uː
humming	h ʌ m ɪ ŋ
quaich	k w e ɪ k
greenspan	ɡ ɹ iː n s p æ n
egoboo	iː ɡ ə ʊ b uː
chloride	k l ɔ ɹ a ɪ d
mincer	m ɪ n s ɚ
roach	ɹ o ʊ t͡ʃ
hydroxymethylsulfonate	h a ɪ d r ɑ k s i m ɛ θ ə l s ʌ l f ə n e ɪ t
squoze	s k w o ʊ z
dressy	d ɹ ɛ s i
inventor	ɪ n v ɛ n t ɚ
kerberos	k ɜ ɹ b ə ɹ ə s
invoke	ɪ n v o ʊ k
slowpoke	s l o ʊ p o ʊ k
primitive	p ɹ ɪ m ɪ t ɪ v
recant	ɹ ə k æ n t
julian	d͡ʒ uː l i ə n
ritz	ɹ ɪ t s
metaphysics	m ɛ t ə f ɪ z ɪ k s
najis	n ɑ d͡ʒ ɪ s
aran	æ ɹ ə n
grove	ɡ ɹ o ʊ v
jaw	d͡ʒ ɑ
fbi	ɛ f b iː a ɪ
jbiebs	d͡ʒ e ɪ b i b s
mound	m a ʊ n d
eco	iː k ə ʊ
cockle	k ɒ k l̩
cnemides	n ɛ m ɪ d iː z
omnivorous	ɑ m n ɪ v ɝ ə s
reify	ɹ e ɪ ə f a ɪ
statistic	s t ə t ɪ s t ɪ k
crosswind	k ɹ ɑː s w ɪ n d
blacon	b l e ɪ k ə n
trelawney	t ɹ ə l ɔː n i
deadline	d ɛ d l a ɪ n
theme	θ iː m
farsi	f ɑː ɹ s i
victims	v ɪ k t ɪ m z
ecumenopoleis	ɛ k j u m ɛ n ɒ p ɒ l ɛ ɪ z
abditory	æ b d ɪ t ə ɹ i
lice	l a ɪ s
ectasis	ɛ k t ə s ɪ s
bday	b iː d e ɪ
nullibiety	n ʌ l ɪ b a ɪ ɪ t i
confess	k ə n f ɛ s
colport	k ɒ l p ɔː ɹ t
paradoxical	p ɛ ɹ ə d ɑː k s ɪ k ə l
altman	ɔː l t m ə n
missend	m ɪ s s ɛ n d
splooge	s p l uː d͡ʒ
fairing	f ɛ ɹ ɪ ŋ
gracilis	ɡ r æ s ə l ɪ s
driffield	d ɹ ɪ f iː l d
thereabout	ð ɛ ɹ ə b a ʊ t
apparel	ə p æ ɹ ə l
crumbs	k ɹ ʌ m z
hayward	h e ɪ w ə ɹ d
gnostic	n ɑ s t ɪ k
pederast	p i d ə ɹ æ s t
inman	ɪ n m ə n
redaction	ɹ ə d æ k ʃ ə n
eldritch	ɛ l d ɹ ɪ t͡ʃ
nicaragua	n ɪ k ə ɹ ɑ ɡ w ə
kittlish	k ɪ t ə l ɪ ʃ
emir	ɛ m ɪ ə ɹ
dactylology	d æ k t ə l ɑ l ə d͡ʒ i
clit	k l ɪ t
jinhua	d͡ʒ ɪ n h w ɑː
relentlessness	ɹ ɪ l ɛ n t l ə s n ə s
volitation	v ɑ l ɪ t e ɪ ʃ ə n
ludomusicologist	l u d o ʊ m j u z ɪ k ɑ l ə d͡ʒ ɪ s t
changchun	t͡ʃ æ ŋ t͡ʃ ʊ n
alces	æ l s iː z
vow	v a ʊ
cezve	d͡ʒ ɛ z v e ɪ
supraclavicular	s u p ɹ ə k l æ v ɪ k j ə l ɚ
fractionality	f ɹ æ k ʃ ə n æ l ɪ t i
nack	n æ k
outwall	a ʊ t w ɔː l
sconce	s k ɑ n s
fitzpatrick	f ɪ t s p æ t ɹ ɪ k
arrival	ə ɹ a ɪ v ə l
markovian	m ɑ ɹ k o ʊ v i ə n
anacrogynous	æ n ə k ɹ ɑ d͡ʒ ɪ n ə s
languid	l æ ŋ ɡ w ə d
autumnal	ɔ t ʌ m n ə ɫ
chaste	t͡ʃ e ɪ s t
dauber	d ɔː b ə ɹ
classify	k l æ s ə f a ɪ
exorbitancy	ɪ ɡ z ɔː ɹ b ɪ t ə n s i
lain	l e ɪ n
poon	p uː n
conley	k ɒ n l ɪ
tarns	t ɑː ɹ n z
chomophyte	k ə ʊ m ə ʊ f a ɪ t
interpellate	ɪ n t ə ɹ p ɛ l e ɪ t
dern	d ɜː ɹ n
larve	l ɑː ɹ v
stephanie	s t ɛ f ə n i
beprose	b ɪ p ɹ ə ʊ z
boughten	b ɔː t ə n
killer	k ɪ l ɚ
vocales	v o ʊ k e ɪ l i z
tsushima	s uː ʃ iː m ə
connective	k ə n ɛ k t ɪ v
biggs	b ɪ ɡ z
europe	j ɝ ə p
ramification	ɹ æ m ə f ə k e ɪ ʃ ə n
taqueria	t ɑ k ə ɹ iː ə
infection	ɪ n f ɛ k ʃ ə n
sinicise	s ɪ n ə s a ɪ z
fiche	f iː ʃ
hydrolysate	h a ɪ d ɹ ɒ l ɪ s ə t
nasal	n e ɪ z ə l
odessa	ə ʊ d ɛ s ə
matador	m æ t ə d ɔ ɹ
berniecrat	b ɝ n i k ɹ æ t
civitas	k i w ɪ t ɑ s
necklace	n ɛ k l ə s
elam	iː l ə m
vouchsafe	v a ʊ t͡ʃ s e ɪ f
eisteddfodau	a ɪ s t ɛ ð v ɒ d a ɪ
viable	v a ɪ ə b ə l
needs	n i d z
stumble	s t ʌ m b ə l
arnaut	ɑ ɹ n a ʊ t
deliberate	d ɪ l ɪ b ə ɹ e ɪ t
octopus	ɑ k t ə p ə s
havant	h æ v ə n t
carmel	k ɑ ɹ m l̩
savagery	s æ v ɪ d͡ʒ ɹ ɪ
echo	ɛ k o ʊ
sandy	s æ n d i
foolings	f uː l ɪ ŋ z
peeping	p iː p ɪ ŋ
alucard	æ l ə k ɑː ɹ d
choral	k ɔ ɹ ə l
axolotl	æ k s ə l ɑ t ə l
germen	d͡ʒ ɝ m ə n
slowth	s l o ʊ θ
sotol	s o ʊ t o ʊ l
tsuba	s u b ə
communist	k ɑ m j u n ɪ s t
askeses	ə s k i s i z
squabash	s k w ə b æ ʃ
remediless	ɹ ɛ m ə d i l ɪ s
military	m ɪ l ɪ t ɛ ɹ i
acaricide	ə k ɛ ɹ ə s i d
prosecco	p ɹ o ʊ s ɛ k o ʊ
diiodohydroxyquinoline	d a ɪ a ɪ ə d o ʊ h a ɪ d ɹ ɑ k s ɪ k w ɪ n ə l i n
prominence	p ɹ ɑ m ɪ n ə n s
sourceable	s ɔ ɹ s ə b ə l
civilise	s ɪ v ɪ l a ɪ z
thunderstruck	θ ʌ n d ɚ s t ɹ ʌ k
righteousness	ɹ a ɪ t͡ʃ ə s n ə s
paycheck	p e ɪ t͡ʃ ɛ k
abacate	æ b ə k ɑ t i
cefozopran	s ə f ɑ z ə p ɹ æ n
paperback	p e ɪ p ɚ b æ k
bulgur	b ʊ l ɡ ə ɹ
parture	p ɑː ɹ t j ʊ ə ɹ
leia	l e ɪ ə
poppets	p ɒ p ɪ t s
khata	k ɑ t ɑ
tearful	t ɪ ɹ f ə l
puisne	p j u n i
gangnam	ɡ ɑ ŋ n ɑ m
thimbled	θ ɪ m b ə l d
jocularity	d͡ʒ ɑ k j ə l ɛ ɹ ɪ t i
extrapsychic	ɛ k s t ɹ ə s a ɪ k ɪ k
pultaceous	p ʌ l t e ɪ ʃ ə s
chic	ʃ i k
wouldn't	w ʊ d n̩ t
viviane	v ɪ v i æ n
competence	k ɒ m p ə t ə n s
towards	t o ʊ ɚ d z
biokinesis	b a ɪ o ʊ k ɪ n i s ɪ s
galápagos	ɡ ə l æ p ə ɡ o ʊ s
legion	l iː d͡ʒ ə n
interfrastically	ɪ n t ɚ f ɹ æ s t ɪ k ʌ l i
propice	p ɹ ə p a ɪ s
nucleus	n uː k l i ə s
extensively	ɛ k s t ɛ n s ɪ v l i
pethidine	p ɛ θ ɪ d iː n
lupercus	l uː p ɜː ɹ k ə s
budgerigar	b ʌ d͡ʒ ə ɹ i ɡ ɑ ɹ
toning	t o ʊ n ɪ ŋ
pope	p o ʊ p
overstudious	o ʊ v ɚ s t j uː d i ə s
zoonosis	z o ʊ ɒ n ə s ɪ s
hark	h ɑː ɹ k
knobbler	n ɑ b l ɚ
teleophyte	t ɛ l iː ə ʊ f a ɪ t
delate	d ə l e ɪ t
inter	ɪ n t ɝ
bohunk	b o ʊ h ʌ ŋ k
gujari	ɡ u d͡ʒ ɑː ɹ i
plausive	p l ɔː z ɪ v
dissuade	d ɪ s w e ɪ d
machinist	m ə ʃ iː n ɪ s t
dessert	d ɪ z ɝ t
concave	k ɑ n k e ɪ v
alistair	æ l i s t ɚ
nostril	n ɒ s t ɹ ə l
arthur	ɑ ɹ θ ɚ
stagirite	s t æ d͡ʒ ɪ ɹ ʌ ɪ t
cork	k ɔ ɹ k
roomth	ɹ uː m θ
bentley	b e n t l iː
jamoke	d͡ʒ ə m ə ʊ k
parson	p ɑ ɹ s ə n
zotepine	z o ʊ t ə p iː n
lasts	l æ s t s
haze	h e ɪ z
perf	p ɜː ɹ f
pudor	p j uː d ɔː
hank	h æ ŋ k
galwegian	ɡ ɔ l w i d͡ʒ ə n
greater	ɡ ɹ e ɪ t ə ɹ
dubbings	d ʌ b ɪ ŋ z
too	t u
misotheist	m a ɪ s ə ʊ θ iː ɪ s t
jet	d͡ʒ ɛ t
comfort	k ʌ m f ɚ t
beantown	b i n t a ʊ n
jot	d͡ʒ ɑ t
green	ɡ ɹ i n
monotreme	m ɒ n ə t ɹ iː m
latecomer	l e ɪ t k ʌ m ɚ
prenuptual	p ɹ i n ʌ p t͡ʃ w ə ɫ
immitigable	ɪ m ɪ t ɪ ɡ ə b ə l
skoosh	s k u ʃ
whally	w ɔː l ɪ
trioecious	t r a ɪ iː ʃ ɪ ə s
towkay	t a ʊ k e ɪ
abstinently	æ b s t ə n n̩ t l i
kakemono	k ɑ k e ɪ m o ʊ n o ʊ
teletsunami	t ɛ l ə t s u n ɑː m i
meek	m i k
aznavour	ɑː z n ə v ʊ ɚ
fink	f ɪ ŋ k
scye	s a ɪ
advertiser	æ d v ɚ t a ɪ z ɚ
praziquantel	p ɹ æ z ɪ k w æ n t ɛ l
mascle	m æ s k ə l
banzai	b æ n z a ɪ
paganism	p e ɪ ɡ ə n ɪ z m̩
hounded	h a ʊ n d ɪ d
suva	s uː v ə
bulked	b ʌ l k t
connascence	k ə n æ s ə n s
ashplant	æ ʃ p l æ n t
vertiginous	v ɜː ɹ t ɪ d͡ʒ ɪ n ə s
voltage	v o ʊ l t ɪ d͡ʒ
burundi	b ʊ ɹ ʊ n d i
anathema	ə n æ θ ə m ə
sages	s e ɪ d͡ʒ ɪ z
sinew	s ɪ n j u
unbosom	ʌ n b ʊ z ə m
anniversary	æ n ə v ɝ s ə ɹ i
vacationship	v ə k e ɪ ʃ ə n ʃ ɪ p
aberdeen	æ b ɚ d i n
nomenclature	n o ʊ m ə n k l e ɪ t͡ʃ ɚ
amma	ʌ m ə
particularity	p ə ɹ t ɪ k j ə l ɛ ɹ ə t i
glandular	ɡ l æ n d͡ʒ ə l ɚ
slow	s l o ʊ
gift	ɡ ɪ f t
folger	f o ʊ l d͡ʒ ə r
tyranny	t ɪ ɹ ə n i
bewelter	b ɪ w ɛ l t ɚ
amphora	æ m f ə ɹ ə
foist	f ɔ ɪ s t
sika	s iː k ə
damned	d æ m d
richard	ɹ ɪ t͡ʃ ɚ d
miniature	m ɪ n i ə t͡ʃ ə ɹ
attendment	ə t ɛ n d m ə n t
pastel	p æ s t ɛ l
morpheus	m ɔ ɹ f j u s
disgust	d ɪ s k ʌ s t
chute	ʃ j uː t
commeasure	k ə m ɛ ʒ ə ɹ
rorty	ɹ ɔː t i
ampere	æ m p ɪ ə r
poisings	p ɔ ɪ z ɪ ŋ z
furl	f ɝ l
leady	l ɛ d i
spatter	s p æ t ɚ
misère	m iː z ɛ ə ɹ
bathylimnetic	b æ θ i l ɪ m n ɛ t ɪ k
infiltrate	ɪ n f ə l t ɹ e ɪ t
standfield	s t æ n d f iː l d
prosiopetic	p ɹ ɑ s i o ʊ p ɛ t ɪ k
homeless	h o ʊ m l ə s
cisgender	s ɪ s d͡ʒ ɛ n d ɚ
microbial	m a ɪ k ɹ o ʊ b i ə l
joe	d͡ʒ o ʊ
glorify	ɡ l ɔ ɹ ɪ f a ɪ
gouges	ɡ a ʊ d͡ʒ ə z
hivemind	h a ɪ v m a ɪ n d
prosodies	p ɹ ɑ s ə d i z
blunderbuss	b l ʌ n d ɚ b ʌ s
indolency	ɪ n d ə l ə n s i
single	s ɪ ŋ ɡ ə l
vocally	v o ʊ k ə l i
sloane	s l o ʊ n
lop	l o ʊ p
quixotry	k w ɪ k s ə t ɹ i
husks	h ʌ s k s
soupçon	s uː p s ɒ n
teak	t iː k
firth	f ɝ θ
leigh	l iː
khartoum	k ɑː ɹ t uː m
rating	ɹ e ɪ t ɪ ŋ
remediate	ɹ ə m iː d i e ɪ t
fob	f ɒ b
tentative	t ɛ n t ə t ɪ v
illusory	ɪ l uː s ə ɹ i
finishings	f ɪ n ɪ ʃ ɪ ŋ z
oxibendazole	ɒ k s ɪ b ɛ n d ə z ə ʊ l
cumming	k ʌ m ɪ ŋ
problem	p ɹ ɑ b l ə m
azygous	e ɪ z a ɪ ɡ ə s
groundbreaking	ɡ ɹ a ʊ n d b ɹ e ɪ k ɪ ŋ
punishing	p ʌ n ɪ ʃ ɪ ŋ
heterodont	h ɛ t ə ɹ ə d ɑ n t
willard	w ɪ l ə ɹ d
kenspeckle	k ɛ n s p ɛ k ə l
fazzolet	f æ z ə l ɛ t
bib	b ɪ b
oneironaut	o ʊ n a ɪ ɹ o ʊ n ɔ t
wuss	w ʊ s
janken	d͡ʒ ɒ ŋ k ɛ n
escitalopram	ɛ s ə t æ l ə p ɹ æ m
tog	t ɑ ɡ
sue	s uː
peril	p ɛ ɹ ɪ l
finangle	f ɪ n æ ŋ ɡ ə l
instance	ɪ n s t ə n s
grog	ɡ ɹ ɑ ɡ
parka	p ɑ ɹ k ə
chewy	t͡ʃ uː i
crowings	k ɹ o ʊ ɪ ŋ z
borscht	b ɔ ɹ ʃ t
lpwan	ɛ l p iː w æ n
newfangled	n u f æ ŋ ɡ ə l d
decision	d ɪ s ɪ ʒ ə n
moguled	m o ʊ ɡ ə l d
halfness	h æ f n ə s
chance	t͡ʃ æ n s
recover	ɹ i k ʌ v ɚ
childbed	t͡ʃ a ɪ l d b ɛ d
knits	n ɪ t s
miltefosine	m ɪ l t ɛ f ə s i n
dove	d o ʊ v
abelam	ə b ə l ə m
han	h e ɪ n
ratio	ɹ e ɪ ʃ i o ʊ
pulpit	p ʊ l p ɪ t
enslave	ɪ n s l e ɪ v
endmost	ɛ n d m o ʊ s t
eyeglass	a ɪ ɡ l æ s
kilroy	k ɪ l ɹ ɔ ɪ
diock	d a ɪ ɑ k
zeus	z u s
medalist	m ɛ d ə l ɪ s t
nouned	n a ʊ n d
fart	f ɑ ɹ t
percival	p ɜː ɹ s ɪ v ə l
landover	l æ n d o ʊ v ə ɹ
gazump	ɡ ə z ʌ m p
oreo	ɔ ɹ i o ʊ
polygynandry	p ɑ l i d͡ʒ ɪ n æ n d ɹ i
andromache	æ n d ɹ ɒ m ə k i
breitschwanz	b ɹ a ɪ t͡ʃ v ɑː n t s
manhood	m æ n h ʊ d
commotion	k ə m o ʊ ʃ ə n
muggins	m ʌ ɡ ɪ n z
zoomies	z uː m i z
conative	k o ʊ n ə t ɪ v
floor	f l o ɹ
otolaryngologist	o ʊ t o ʊ l ɛ ɚ ɪ ŋ ɡ ɑ l ə d͡ʒ ɪ s t
monoecious	m ə n iː ʃ ə s
mags	m æ ɡ z
fusee	f j uː z i
fuzed	f j uː z d
dormouse	d ɔ ɹ m a ʊ s
dehull	d i h ʌ l
donjon	d ɒ n d͡ʒ ə n
colon	k o ʊ l o ʊ n
reduction	ɹ ɪ d ʌ k ʃ ə n
haskell	h æ s k ə l
serac	s ɛ ɹ æ k
wench	w ɛ n t͡ʃ
sapodilla	s æ p ə d ɪ l ə
halal	h ə l ɑː l
canakin	k æ n ə k ɪ n
bass	b e ɪ s
argillaceous	ɑː d͡ʒ ɪ l e ɪ ʃ ə s
redie	ɹ iː d a ɪ
phocian	f ə ʊ s i ə n
prima	p ɹ iː m ə
chromatic	k ɹ o ʊ m æ t ɪ k
norepinephrine	n ɔː ɹ ɛ p ɪ n ɛ f ɹ ɪ n
sansha	s ɑ n ʃ ɑː
backbone	b æ k b o ʊ n
granary	ɡ ɹ e ɪ n ə ɹ i
haematology	h i m ə t ɑ l ə d͡ʒ i
supercollider	s u p ɚ k ə l a ɪ d ɚ
gsoc	d͡ʒ iː s ɑ k
this's	ð ɪ s ɪ z
mineralogize	m ɪ n ə ɹ æ l ə d͡ʒ a ɪ z
sever	s ɛ v ɚ
misfortune	m ɪ s f ɔ ɹ t͡ʃ ə n
plethora	p l ɛ θ ə ɹ ə
nruling	n ɹ uː l ɪ ŋ
clippers	k l ɪ p ɚ z
radioactive	ɹ e ɪ d i o ʊ æ k t ɪ v
hexacosichoron	h ɛ k s ə ɪ k o ʊ s ɪ k o ʊ ɹ ɔ n
blacker	b l æ k ɚ
trifles	t ɹ a ɪ̯ f l̩ z
octavation	ɒ k t e ɪ v e ɪ ʃ ə n
tends	t ɛ n d z
psora	s ɔː ɹ ə
donnean	d ʌ n i ə n
background	b æ k ɡ ɹ a ʊ n d
stun	s t ʌ n
titles	t a ɪ t l̩ z
fibularis	f ɪ b j ə l ɛ ɹ ɪ s
breathy	b ɹ ɛ θ i
filet	f ɪ l e ɪ
brotastic	b ɹ ə ʊ t æ s t ɪ k
accordionist	ə k ɔ ɹ d i ə n ə s t
distorted	d ɪ s t ɔ ɹ t ɪ d
megapenny	m ɛ ɡ ə p ɛ n i
ragù	ɹ æ ɡ u
commander	k ə m æ n d ɚ
miscarry	m ɪ s k æ ɹ i
gustable	ɡ ʌ s t ə b ə l
belts	b ɛ l t s
fengqiu	f ʌ ŋ t͡ʃ j o ʊ
spinsterishness	s p ɪ n s t ə ɹ ɪ ʃ n ə s
i'm	a ɪ m
winkers	w ɪ ŋ k ɚ z
abandoning	ə b æ n d ə n ɪ ŋ
multifurcate	m ʌ l t i f ɝ k e ɪ t
embiggen	ɛ m b ɪ ɡ ə n
packs	p æ k s
debug	d iː b ʌ ɡ
stealing	s t iː l ɪ ŋ
andersen	æ n d ə ɹ s ə n
cameron	k æ m ə ɹ ə n
theories	θ iː ə ɹ i z
uralic	j ʊ ə ɹ æ l ɪ k
babm	b ɔ ɑː b ɔ m u
staccato	s t ə k ɑː t o ʊ
oganesson	o ʊ ɡ ə n ɛ s ɒ n
undeserving	ʌ n d ɪ z ɝ v ɪ ŋ
immerse	ɪ m ɝ s
eschatology	ɛ s k ə t ɔ l ə d͡ʒ i
preposterous	p ɹ ə p ɑ s t ə ɹ ə s
haecceitistic	h iː k s iː ə t ɪ s t i k
arhat	ɑː h æ t
production	p ɹ ə d ʌ k ʃ ə n
spectral	s p ɛ k t ɹ ə ɫ
hope	h o ʊ p
sleekly	s l iː k l i
seeking	s iː k ɪ ŋ
glazes	ɡ l e ɪ z ɪ z
arachnophobia	æ ɹ æ k n ə f ə ʊ b ɪ ə
belarusian	b ɛ l ə ɹ uː s i ə n
culminate	k ʌ l m ə n e ɪ t
crumple	k ɹ ʌ m p ə l
gerrit	ɡ ɛ ɹ ɪ t
boymoder	b ɔ ɪ m o ʊ d ɚ
scrofula	s k ɹ ɔ f j ə l ə
nize	n a ɪ z
abkari	ɑ b k ɑ ɹ i
stress	s t ɹ ɛ s
pyrrha	p ɪ r ə
mealer	m iː l ə ɹ
deliberately	d ə l ɪ b ə ɹ ə t l i
todd	t ɑ d
functional	f ʌ ŋ k t͡ʃ n ə l
confidant	k ɑ n f ɪ d ɑ n t
lingala	l ɪ ŋ ɡ ɑː l ə
cheese	t͡ʃ i z
strophe	s t r o ʊ f i
papa	p ɑː p ə
swire	s w a ɪ ə
croggle	k ɹ ɒ ɡ ə l
gleams	ɡ l iː m z
yreka	w a ɪ r iː k ə
spiracle	s p ɪ ɹ ə k ə l
climbed	k l a ɪ m d
schatz	ʃ æ t s
haunt	h æ n t
divinization	d ɪ v ɪ n a ɪ z e ɪ ʃ ə n
abandoner	ə b æ n d ə n ɚ
pitchfork	p ɪ t͡ʃ f ɔ ɹ k
provision	p ɹ ə v ɪ ʒ ə n
swadeshi	s w ə d ɛ ʃ i
podiatry	p ə d a ɪ ə t ɹ i
drover	d ɹ o ʊ v ə ɹ
chickies	t͡ʃ ɪ k i z
banker	b æ ŋ k ɚ
chieftain	t͡ʃ iː f t ə n
newel	n j u ə l
nagual	n ə ɡ w ɑː l
avaunce	ə v ɑː n s
jiggle	d͡ʒ ɪ ɡ ə l
stereoscopic	s t ɛ r i ə s k ɑː p ɪ k
report	ɹ ɪ p ɔ ɹ t
sulfolipid	s ʌ l f ə l ɪ p ə d
inchoative	ɪ n k o ʊ ə t ɪ v
viscacha	v ɪ s k ɑ t͡ʃ ə
considerative	k ɑ n s ɪ d ə ɹ e ɪ t ɪ v
asonant	e ɪ̯ s o ʊ̯ n ə n t
helve	h ɛ l v
deets	d iː t s
tigger	t ɪ ɡ ɚ
fleck	f l ɛ k
dickon	d ɪ k ə n
jth	d͡ʒ e ɪ θ
oversevere	ə ʊ v ə s ɪ v ɪ ɹ
putz	p ʊ t s
peeving	p iː v ɪ ŋ
hydraulics	h a ɪ d ɹ ɔː l ɪ k s
scarifier	s k æ ɹ ɪ f a ɪ ə ɹ
tiggerish	t ɪ ɡ ə ɹ ɪ ʃ
cissy	s ɪ s i
decock	d i k ɔ k
awesometastic	ɔ s m̩ t æ s t ɪ k
betted	b ɛ t ə d
pudge	p ʌ d͡ʒ
wain	w e ɪ n
slack	s l æ k
cumbric	k ʌ m b ɹ ɪ k
mogwai	m ɒ ɡ w a ɪ
gingerism	d͡ʒ ɪ n d͡ʒ ɚ ɪ z m̩
uric	j ʊ ɹ ɪ k
cannon	k æ n ə n
insects	ɪ n s ɛ k t s
cletus	k l iː t ə s
parterre	p ɑː ɹ t ɛ ɚ
rules	ɹ u l z
paralipomenon	p æ ɹ ə l ɪ p ɒ m ɪ n ɒ n
lakh	l æ k
occultation	ɑ k ə l t e ɪ ʃ ə n
marmoset	m ɑ ɹ m ə s ə t
pastis	p æ s t iː s
cunning	k ʌ n ɪ ŋ
abbotcy	æ b ə t s i
nsutite	ə n s uː t a ɪ t
suave	s w e ɪ v
absentment	ə b s ɛ n t m ə n t
tunnel	t ʌ n ə l
hume	h j uː m
conclude	k ə n k l uː d
glastonbury	ɡ l æ s t ə n b ɹ i
alsatian	æ l s e ɪ ʃ ə n
interrupted	ɪ n t ə ɹ ʌ p t ɪ d
acetochlor	ə s iː t ə ʊ k l ɔː ɹ
vada	v ɑː d ə
besmirch	b ɪ s m ɝː t͡ʃ
theophilus	θ iː ɒ f ɪ l ə s
percolator	p ɝ k ə l e ɪ t ɚ
petit	p ə t i
orchid	ɔ ɹ k ɪ d
bacchant	b æ k ə n t
piezoelectricity	p i e ɪ z ə ʊ ɪ l ɛ k t r ɪ s ɪ t i
connecting	k ə n ɛ k t ɪ ŋ
trip	t ɹ ɪ p
cuddly	k ʌ d l i
executrix	ɪ ɡ z ɛ k j ə t ɹ ɪ k s
pulsate	p ʌ l s e ɪ t
exteriorized	ɛ k s t ɪ ɹ i ə ɹ a ɪ z d
adherence	ə d h ɪ ɹ ə n s
cleverness	k l ɛ v ɚ n ə s
canaigre	k ə n a ɪ ɡ r i
vaguened	v e ɪ ɡ ə n d
dentro	d ɛ n t ɹ o ʊ
reterritorialization	ɹ iː t ɛ ɹ ɪ t ɔː ɹ i ə l a ɪ z e ɪ ʃ ə n
cohesive	k o ʊ h iː s ɪ v
umich	j u m ɪ ʃ
wheedle	w iː d ə l
neist	n iː s t
dorp	d ɔː ɹ p
parthenon	p ɑː ɹ θ ə n ɑː n
kuchen	k u k ə n
vag	v æ d͡ʒ
outlet	a ʊ t l ɛ t
expletive	ɛ k s p l ə t ɪ v
stainer	s t e ɪ n ɚ
waspish	w ɑ s p ɪ ʃ
banneret	b æ n ə ɹ e t
vilazodone	v ɪ l æ z ə d ə ʊ n
oxter	ɒ k s t ə ɹ
commandeer	k ɒ m ə n d ɪ ə ɹ
defamate	d ɛ f ə m e ɪ t
maftir	m ɑː f t iː ɹ
fails	f e ɪ l z
châteaux	ʃ æː t o ʊ z
olive	ɑ l ɪ v
regulator	ɹ ɛ ɡ j u l e ɪ t ɚ
tough	t ʌ f
evans	ɛ v ə n z
overran	o ʊ v ɚ ɹ a n
meadery	m i d ə ɹ i
trailer	t ɹ e ɪ l ɚ
rizzuto	ɹ ɪ t s uː t ə ʊ
crab	k ɹ æ b
rhyparography	ɹ ɪ p ə ɹ ɑ ɡ ɹ ə f i
chomp	t͡ʃ ɑ m p
bull	b ʊ l
referee	ɹ ɛ f ə ɹ iː
caliber	k æ l ə b ɚ
encierro	ɛ n s i ɛ ɹ o ʊ
xeriscape	z ɛ ɹ ə s k e ɪ p
namur	n ə m ʊ ə ɹ
cogniscient	k ɒ ɡ n ɪ ʃ ə n t
beechmast	b i t͡ʃ m æ s t
dominical	d ə m ɪ n ə k ə l
a'n't	æ n t
information	ɪ n f ɚ m e ɪ ʃ ə n
humvee	h ʌ m v iː
aniseed	æ n ɪ s i d
bassoon	b ə s u n
deserve	d ɪ z ɝ v
euth	j u θ
trees	t ɹ iː z
abroad	ə b ɹ ɔ d
speciesism	s p iː s iː z ɪ z ə m
weary	w ɪ ə ɹ i
jacuzzi	d͡ʒ ə k u z i
matronymic	m æ t ɹ ə n ɪ m ɪ k
kilton	k ɪ l t ə n
excandescence	ɛ k s k æ n d ɛ s ə n s
timur	t ɪ m ʊ ə ɹ
supplying	s ə p l a ɪ ɪ ŋ
reran	ɹ iː ɹ æ n
obsign	ə b s a ɪ n
confit	k ɒ n f iː
fluorate	f l o ɹ e ɪ t
neolithic	n i o ʊ l ɪ θ ɪ k
condescending	k ɑ n d ə s ɛ n d ɪ ŋ
infringement	ɪ n f ɹ ɪ n d͡ʒ m ə n t
polytheism	p ɒ l ɪ θ iː ɪ z ə m
atrocity	ə t ɹ ɒ s ɪ t i
woggle	w ɒ ɡ ə l
harmful	h ɑ ɹ m f l̩
i'dn't've	a ɪ d ə n t ə v
renegade	ɹ ɛ n ɪ ɡ e ɪ d
shunga	ʃ ʊ ŋ ə
bloomed	b l uː m d
attractant	ə t ɹ æ k t ə n t
halifax	h æ l ɪ f æ k s
exultation	ɛ ɡ z ʌ l t e ɪ ʃ ə n
upfront	ʌ p f ɹ ʌ n t
rutch	ɹ ʊ t͡ʃ
orenda	o ʊ ɹ ɛ n d ə
legislature	l ɛ d͡ʒ ɪ s l e ɪ t͡ʃ ɚ
slovenian	s l ə v iː n i ə n
analgesias	æ n ə l d͡ʒ iː z ɪ ə z
dace	d e ɪ s
incisiveness	ɪ n s a ɪ s ə v n ə s
leman	l iː m ə n
downloading	d a ʊ n l o ʊ d ɪ ŋ
towering	t a ʊ ə ɹ ɪ ŋ
provident	p ɹ ɒ v ɪ d ə n t
achieved	ə t͡ʃ iː v d
encyclopediae	ɪ n s a ɪ k l ə p iː d i a ɪ
intricate	ɪ n t ɹ ɪ k e ɪ t
sanctimonious	s æ ŋ k t ə m o ʊ n i ə s
cloning	k l o ʊ n ɪ ŋ
sully	s ʌ l i
related	ɹ ɪ l e ɪ t ɪ d
jumpered	d͡ʒ ʌ m p ɚ d
rerefief	ɹ ɪ ə ɹ f iː f
cried	k ɹ a ɪ d
sharebait	ʃ ɛ ɹ b e ɪ t
finely	f a ɪ n l i
scious	s a ɪ ə s
greeks	ɡ ɹ iː k s
thanksgiving	θ æ ŋ k s ɡ ɪ v ɪ ŋ
understander	ə n d ɚ s t æ n d ɚ
minxishly	m ɪ ŋ k s ɪ ʃ l i
satisfaction	s æ t ɪ s f æ k ʃ ə n
hadder	h æ d ə ɹ
regionally	ɹ iː d͡ʒ n ə l i
hexings	h ɛ k s ɪ ŋ z
camomile	k æ m ə m a ɪ l
jpeg'd	d͡ʒ e ɪ p ɛ ɡ d
bears	b ɛ ɹ z
culverin	k ʌ l v ə ɹ ɪ n
superhabitable	s u p ɚ h æ b ɪ t ə b l̩
pasch	p æ s k
bundestag	b ʊ n d ə s t ɑː ɡ
earwitness	ɪ ɹ w ɪ t n ə s
urged	ɝ d͡ʒ d
unsex	ʌ n s ɛ k s
anemia	ə n i m i ə
aroint	ə ɹ ɔ ɪ n t
reminisce	ɹ ɛ m ə n ɪ s
brine	b ɹ a ɪ n
luckily	l ʌ k ə l i
url	j u ɑ ɹ ɛ l
promiscuous	p ɹ ə m ɪ s k j u ə s
silsden	s ɪ l z d ə n
opal	o ʊ p ə l
foolscap	f uː l s k æ p
frontales	f ɹ ʌ n t e ɪ l i z
ink	i ŋ k
atrophy	æ t ɹ ə f i
dropped	d ɹ ɑ p t
try	t ɹ a ɪ
weazen	w iː z ə n
dentate	d ɛ n t e ɪ t
remeid	ɹ i m i d
reclamation	ɹ ɛ k l ə m e ɪ ʃ n̩
quefrency	k w i f ɹ ə n s i
kenora	k ə n ɔː r ə
malm	m ɑː l m
denmark	d ɛ n m ɑ ɹ k
innage	ɪ n ə d͡ʒ
hebbville	h ɛ b v ɪ l
abelmosk	e ɪ b l m ɑ s k
existed	ɪ ɡ z ɪ s t ɪ d
nirvana	n ɚ v æ n ə
uniformal	j uː n ɪ f ɔː ɹ m ə l
oaten	ə ʊ t ə n
imply	ɪ m p l a ɪ
bale	b e ɪ̯ l
prestigious	p ɹ ɛ s t i d͡ʒ ə s
salary	s æ l ɚ i
frontonasal	f ɹ ʌ n t o ʊ n e ɪ z ə l
planetary	p l æ n ə t ɛ r i
maniac	m e ɪ n i æ k
amylin	æ m ə l ɪ n
emigre	ɛ m ɪ ɡ ɹ e ɪ
estonia	ɛ s t o ʊ n i ə
accretion	ə k ɹ i ʃ ə n
cephalopod	s ɛ f a l a p ɑ d
also	ɑ l s o ʊ
hanky	h æ ŋ k i
dreaded	d ɹ ɛ d ə d
debunk	d iː b ʌ ŋ k
linsheng	l ɪ n ʃ ɛ ŋ
baggage	b æ ɡ ɪ d͡ʒ
clock	k l ɑ k
stiver	s t a ɪ v ə
ebbed	ɛ b d
treasure	t ɹ ɛ ʒ ɚ
artificial	ɑː ɹ t ə f ɪ ʃ ə l
hasta	h æ s t ə
forgot	f ɚ ɡ ɑ t
sowl	s a ʊ l
straitjacketing	s t ɹ e ɪ t d͡ʒ æ k ɪ t ɪ ŋ
pubs	p ʌ b z
promises	p ɹ ɑ m ɪ s ɪ z
lazarus	l æ z ə ɹ ə s
shinola	ʃ ɪ n o ʊ l ə
tyrant	t a ɪ ɹ ə n t
mown	m o ʊ n
gaunt	ɡ ɔː n t
raging	ɹ e ɪ d͡ʒ ɪ ŋ
garden	ɡ ɑ ɹ d ə n
cloverleaf	k l o ʊ v ɚ l iː f
ingushetia	ɪ ŋ ɡ ʊ ʃ ɛ t i ə
macaulay	m ə k ɔː l i
release	ɹ iː l iː s
quintillion	k w ɪ n t ɪ l j ə n
antarctic	æ n t ɑ ɹ k t ɪ k
emery	ɛ m ə ɹ i
countings	k a ʊ n t ɪ ŋ z
factice	f æ k t ɪ s
nimble	n ɪ m b l̩
paced	p e ɪ s t
nodulus	n ɑ d͡ʒ ə l ə s
spic	s p ɪ k
beggings	b ɛ ɡ ɪ ŋ z
spittoon	s p ɪ t uː n
cast	k æ s t
lepid	l ɛ p ɪ d
rigging	ɹ ɪ ɡ ɪ ŋ
militiate	m ɪ l ɪ ʃ i e ɪ t
descent	d i s ɛ n t
attrit	ə t ɹ ɪ t
zooplankton	z o ʊ ə p l æ ŋ k t ə n
daw	d ɔː
pentad	p ɛ n t æ d
wylie	w a ɪ l i
interpose	ɪ n t ɚ p o ʊ z
gazelle	ɡ ə z ɛ l
recite	ɹ ɪ s a ɪ t
ockendon	o k ɪ n d ə n
glyptology	ɡ l ɪ p t ɒ l ə d͡ʒ i
copier	k ɑ p i ɚ
rovibrational	ɹ ə ʊ v a ɪ b ɹ e ɪ ʃ ə n ə l
beatlesque	b iː t ə l ɛ s k
incus	ɪ ŋ k ə s
asweve	ə s w iː v
correspondence	k ɒ ɹ ɪ s p ɒ n d ə n s
emerod	ɛ m ə ɹ ə d
hitched	h ɪ t͡ʃ t
juniper	d͡ʒ u n ɪ p ɚ
pungy	p ʌ ŋ i
arrogate	æ ɹ ə ɡ e ɪ t
austin	ɔ s t ɪ n
blacktop	b l æ k t ɒ p
pastings	p e ɪ s t ɪ ŋ z
crimp	k ɹ ɪ m p
umbrage	ʌ m b ɹ ɪ d͡ʒ
wren	ɹ ɛ n
pushpin	p ʊ ʃ p ɪ n
wrests	ɹ ɛ s t s
vierkleur	f ɪ ɹ k l ɜ ɹ
bereft	b ə ɹ ɛ f t
bouctouche	b ʌ k t uː ʃ
winetrough	w a ɪ n t ɹ ɔ f
ultrapure	ʌ l t ɹ ə p j ɔ ɹ
rounder	ɹ a ʊ n d ə ɹ
ketogenesis	k iː t ə ʊ d͡ʒ ɛ n ɪ s ɪ s
peabody	p i b ɑ d i
mesophyll	m iː s ə ʊ f ɪ l
stutter	s t ʌ t ɚ
commissions	k ə m ɪ ʃ ə n z
pahari	p ə h ɑː ɹ i
oniomaniac	ə ʊ n i ə ʊ m e ɪ n i æ k
secs	s ɛ k s
yiff	j ɪ f
navvy	n æ v i
flang	f l æ ŋ
yage	j ɑː h e ɪ
epaulement	e ɪ p o ʊ l m ɑ n t
jeepney	d͡ʒ iː p n i
brethren	b ɹ ɛ ð ɹ ə n
kasundi	k ə s ʊ n d i
dilf	d ɪ l f
haor	h ɑː ɒ ɹ
acclaims	ə k l e ɪ m z
problemo	p ɹ ɑ b l e ɪ̯ m o ʊ̯
inclusionary	ɪ n k l uː ʒ ə n ɛ ɹ i
putid	p j uː t ɪ d
self	s ɛ l f
fleeing	f l iː ɪ ŋ
calumny	k æ l ə m n i
duality	d j uː æ l ɪ t i
cosmopolite	k ɑ z m ɑ p ə l a ɪ t
insecure	ɪ n s ə k j ɔ ɹ
navaratna	n ɑ v ɑ ɹ ɑ t n ɑ
hydrocele	h a ɪ d ɹ ə s iː l
undertook	ʌ n d ə ɹ t ʊ k
argent	ɑ ɹ d͡ʒ ə n t
mattie	m æ t i
hiragana	h ɪ ɹ ə ɡ æ n ə
lever	l iː v ɚ
orchard	ɔ ɹ t͡ʃ ɚ d
stare	s t ɛ ɚ
grimly	ɡ ɹ ɪ m l i
filatory	f ɪ l ə t ɔ ɹ i
soup	s u p
accident	æ k s ə d ə n t
tatar	t æ t ɑː ɹ
trichrome	t ɹ a ɪ k ɹ ə ʊ m
windowsill	w ɪ n d o ʊ s ɪ l
polypantheism	p ɒ l i p æ n θ i ɪ z ə m
branch	b ɹ æ n t͡ʃ
amazingly	ə m e ɪ z ɪ ŋ l i
chickie	t͡ʃ ɪ k i
salazar	s æ l ə z ɑ ɹ
invent	ɪ n v ɛ n t
arenas	ə ɹ iː n ə z
carb	k ɑ ɹ b
metharbital	m ə θ ɑ ɹ b ə t ɔ l
honoree	ɑ n ɚ i
pound	p a ʊ n d
jammy	d͡ʒ æ m i
bunyip	b ʌ n j ɪ p
pouldron	p o ʊ l d ɹ ə n
pros	p ɹ o ʊ z
categories	k æ t ə ɡ ɔ ɹ i z
arriving	ə ɹ a ɪ v ɪ ŋ
xoloitzcuintli	ʃ o ʊ l o ʊ ɪ t s k w ɪ n t l i
vali	v ɑː l ɪː
toxicant	t ɒ k s ɪ k ə n t
effected	ɪ f ɛ k t ɪ d
pecuniary	p ə k j u n i ɛ ɹ i
adaptable	ə d æ p t ə b ə l
abaptiston	æ b æ p t ɪ s t ɑ n
apraxia	ə p ɹ æ k s ɪ ə
backness	b æ k n ɪ s
basutoland	b ə s u t ə ʊ l æ n d
leicester	l ɛ s t ɚ
conurbation	k ɑ n ɚ b e ɪ ʃ ə n
militarily	m ɪ l ɪ t ɛ ɹ ə l i
remission	ɹ ə m ɪ ʃ ə n
sickle	s ɪ k l̩
gummings	ɡ ʌ m ɪ ŋ z
recourse	ɹ iː k ɔ ɹ s
guillemet	ɡ i j ə m e ɪ
accusatory	ə k j u z ə t ɔ ɹ i
scrotum	s k ɹ o ʊ t ə m
prototype	p ɹ o ʊ t ə t a ɪ p
diamagnetic	d a ɪ ə m æ ɡ n ɛ t ɪ k
mountainous	m a ʊ n t ə n ə s
what	w ɑ t
pail	p e ɪ l
dietetician	d a ɪ ə t ɪ t ɪ ʃ ə n
johannes	d ʒ ə ʊ h æ n ɪ s
medicaster	m ɛ d ə k æ s t ɚ
pistol	p ɪ s t ə l
dawkins	d ɔː k ɪ n z
scold	s k o ʊ l d
roseate	ɹ o ʊ z i ə t
snares	s n e ɚ z
pressed	p ɹ ɛ s t
petite	p ə t iː t
unaccountable	ʌ n ə k a ʊ n t ə b l̩
manner	m æ n ɚ
sprite	s p ɹ a ɪ t
emanate	ɛ m ə n e ɪ t
detrital	d i t ɹ a ɪ t ə l
equalize	i k w ə l a ɪ z
walkthrough	w ɔː k θ ɹ uː
ululate	j uː l j u l e ɪ t
inalienable	ɪ n e ɪ l i ə n ə b ə l
ferryl	f ɛ ɹ ə l
treyf	t ɹ e ɪ f
trihexyphenidyl	t ɹ a ɪ h ɛ k s ɪ f ɛ n ɪ d ɪ l
pasilla	p ə s iː j ə
antrum	æ n t ɹ ə m
globus	ɡ l ə ʊ b ə s
resinify	ɹ ɛ z ɪ n ə f a ɪ
handiwork	h æ n d i w ɝ k
flagstaff	f l æ ɡ s t æ f
waiver	w e ɪ v ɚ
abortionist	ə b ɔ ɹ ʃ ə n ɪ s t
ablepharous	æ b l ɜ f ə ɹ ʌ s
departed	d ɪ p ɑ ɹ t ɪ d
wabamun	w ɑː b ə m ə n
rowlock	ɹ ɑ l ə k
skeezy	s k iː z i
paraparaumu	p a ɹ ə p a ɹ ə uː m uː
reports	ɹ ɪ p ɔ ɹ t s
sapient	s e ɪ p i ə n t
cerebel	s ɛ ɹ ə b ə l
holds	h o ʊ l d z
hatter	h æ t ə ɹ
billy	b ɪ l i
horrible	h ɒ ɹ ɪ b ə l
stygian	s t ɪ d͡ʒ i ə n
pericardium	p ɛ ɹ ɪ k ɑː ɹ d i ə m
verse	v ɝ s
marginalness	m ɑ ɹ d͡ʒ ə n ə ɫ n ə s
naggy	n æ ɡ iː
technicality	t ɛ k n ɪ k æ l ɪ t i
wodgil	w ɑ d͡ʒ ɪ l
hypocretin	h a ɪ p o ʊ k ɹ iː t ə n
blin	b l ɪ n
hermaphrodite	h ɝ m æ f ɹ ə d a ɪ t
volga	v o ʊ l ɡ ə
quinquagenary	k w ɪ ŋ k w æ d͡ʒ ə n ɛ ɹ i
siglum	s ɪ ɡ l ə m
dictate	d ɪ k t e ɪ t
deidentify	d iː a ɪ d ɛ n t ɪ f a ɪ
stardom	s t ɑ ɹ d ə m
equation	ɪ k w e ɪ ʃ ə n
honest	ɑ n ɪ s t
alphas	æ ɫ f ə z
thole	θ o ʊ l
gimlet	ɡ ɪ m l ə t
ableism	e ɪ b ə l ɪ z m̩
dawlish	d ɔː l ɪ ʃ
trientine	t ɹ a ɪ ɛ n t iː n
byssine	b ɪ s iː n
unergatives	ʌ n ɜː ɹ ɡ ə t ɪ v z
cheaping	t͡ʃ iː p ɪ ŋ
ostensive	ɒ s t ɛ n s ɪ v
tignish	t ɪ ɡ n ɪ ʃ
katharometer	k æ θ ə ɹ ɒ m i t ə ɹ
brunch	b ɹ ʌ n t͡ʃ
scimitar	s ɪ m ɪ t ɑː ɹ
recognition	ɹ ɛ k ə ɡ n ɪ ʃ ə n
nivolumab	n ɪ v ɒ l j ʊ m æ b
legally	l iː ɡ ə l i
linearity	l ɪ n i æ ɹ ə t i
bumptious	b ʌ m p ʃ ə s
twinge	t w ɪ n d͡ʒ
imprudence	ɪ m p ɹ uː d n̩ s
carny	k ɑː ɹ n i
acrolect	æ k ɹ ə l ɛ k t
immoved	ɪ m uː v d
ante	æ n t i
confronted	k ə n f ɹ ʌ n t ɪ d
pactless	p æ k t l ə s
amain	ə m e ɪ n
gerontic	d͡ʒ ɛ ɹ ɑː n t ɪ k
semicentenary	s ɛ m a ɪ s ɛ n t ə n ɛ r i
avian	e ɪ v i ə n
subjacency	s ə b d͡ʒ e ɪ s ə n s i
festivus	f ɛ s t ɪ v ə s
arousal	ə ɹ a ʊ z ə l
dinkum	d ɪ ŋ k ə m
fumed	f j uː m d
cupe	k j u p i
crust	k ɹ ʌ s t
feastware	f iː s t w ɛ ə ɹ
rigs	ɹ ɪ ɡ z
adhocratically	æ d h ə k ɹ æ d ɪ k ə l i
patten	p æ t ə n
disulfiram	d a ɪ s ʌ l f ə ɹ æ m
farrier	f ɛ ɹ i ɚ
our	a ʊ ɚ
granger	ɡ ɹ e ɪ n d͡ʒ ə ɹ
lingual	l ɪ ŋ ɡ j u ə l
paprika	p æ p ɹ iː k ə
desmond	d ɛ z m ə n d
bedmas	b ɛ d m æ s
ain'tcha	e ɪ n t͡ʃ ə
whisk	h w ɪ s k
litterateur	l ɪ t ə ɹ ə t ʊ ɚ
abjurer	æ b d͡ʒ ʊ ɹ ɚ
custodian	k ə s t o ʊ d i ə n
fran	f ɹ æ n
component	k ʌ m p o ʊ n ə n t
governed	ɡ ə v ɚ n d
valeria	v ə l ɪ ə ɹ i ə
stigmatize	s t ɪ ɡ m ə t a ɪ z
wert	w ɝ t
faiths	f e ɪ θ s
churchical	t͡ʃ ɝ t͡ʃ ɪ k ə l
syllabary	s ɪ l æ b ə ɹ i
ctab	s iː t æ b
theo	θ i o ʊ
formalist	f ɔ ɹ m l̩ ɪ s t
panicky	p æ n ɪ k i
ackee	æ k iː
cribbings	k ɹ ɪ b ɪ ŋ z
audrey	ɔː d ɹ i
blackfoot	b l æ k f ʊ t
smuthound	s m ʌ t h a ʊ n d
plaice	p l e ɪ s
aisle	a ɪ̯ l
lixiviate	l ɪ k s ɪ v i e ɪ t
somewhile	s ʌ m w a ɪ l
tract	t ɹ æ k t
albanian	æ l b e ɪ n i ə n
wireman	w a ɪ ə ɹ m æ n
whichsoever	w ɪ t͡ʃ s o ʊ ɛ v ɚ
crewed	k ɹ uː d
sartorius	s ɑː ɹ t ɔː ɹ i ə s
seattle	s i æ t l̩
owler	a ʊ l ɚ
depressant	d ɪ p ɹ ɛ s ə n t
brits	b ɹ ɪ t s
vegeburger	v ɛ d͡ʒ iː b ɜː ɹ ɡ ə ɹ
theogony	θ ɪ ɑː ɡ ə n ɪ
xenia	z iː n i ə
cruft	k ɹ ʌ f t
rejoicing	ɹ ɪ d͡ʒ o ɪ s ɪ ŋ
hydrogenous	h a ɪ d ɹ ɑ d͡ʒ ə n ə s
claps	k l æ p s
tag	t æ ɡ
acalculia	e ɪ k æ l k j uː l i ə
catamite	k æ t ə m a ɪ t
cueing	k j uː ɪ ŋ
suzerain	s j u z ə ɹ e ɪ̯ n
scoop	s k uː p
apheresis	æ f ə ɹ i s ɪ s
ground	ɡ ɹ a ʊ n d
smiling	s m a ɪ l ɪ ŋ
denotation	d iː n o ʊ t e ɪ ʃ ə n
unmerited	ʌ n m ɛ ɹ ɪ t ɪ d
disinherit	d ɪ s ɪ n h ɛ ɹ ɪ t
picul	p ɪ k ə l
ancle	æ ŋ k ə l
forestal	f ɔ ɚ ɹ ə s t ə l
after	æ f t ɚ
steady	s t ɛ d i
sympiezometer	s ɪ m p i ɪ z ɒ m ɪ t ə
determinant	d ɪ t ɝ m ɪ n ə n t
frontlet	f ɹ ʌ n t l ə t
tuff	t ʌ f
mull	m ʌ l
pleas	p l iː z
aphorism	æ f ə ɹ ɪ z ə m
feiseanna	f ɛ ʃ ə n ə
serum	s ɪ ɹ ə m
woken	w o ʊ k ə n
snug	s n ʌ ɡ
trucks	t ɹ ʌ k s
pushful	p ʊ ʃ f ʊ l
agnostic	æ ɡ n ɑ s t ɪ k
superinstantaneous	s uː p ɚ ɪ n s t ə n t e ɪ n i ə s
hornotine	h ɔː ɹ n ə t a ɪ n
ternary	t ɝ n ə ɹ i
celtomania	k ɛ l t o ʊ m e ɪ n i ə
purdah	p ɝ d ə
dalteparin	d ɔ l t ɛ p ə ɹ ɪ n
milf	m ɪ l f
glyceride	ɡ l ɪ s ə ɹ a ɪ d
tombal	t uː m b ə l
niobe	n a ɪ o ʊ b i
puzzled	p ʌ z l̩ d
copyist	k ɑ p i ɪ s t
bavaroy	b æ v ə ɹ ɔ ɪ
nest	n ɛ s t
abkar	ɑ b k ɑ ɹ
rupert	ɹ u p ɚ t
belladonna	b ɛ l ə d ɑ n ə
roc	ɹ ɒ k
scrab	s k ɹ æ b
bookstave	b ʊ k s t ɪ v
mezereon	m ə z ɪ ə r i ə n
adage	æ d ɪ d͡ʒ
cuts	k ʌ t s
femalia	f iː m e ɪ l i ə
leaching	l iː t͡ʃ ɪ ŋ
acetylcholine	ə s i t ə l k o ʊ l i n
teller	t ɛ l ə ɹ
lavandin	l æ v ə n d ɪ n
aedeagus	i d i e ɪ ɡ ə s
beemer	b i m ɚ
stood	s t ʊ d
mishmash	m ɪ ʃ m æ ʃ
freshes	f ɹ ɛ ʃ ɪ z
americanness	ə m ɛ ɹ ə k ə n ə s
tomato	t ə m e ɪ t o ʊ
antecedent	æ n t ɪ s iː d ə n t
containment	k ə n t e ɪ n m ə n t
cacoethics	k a k ə ʊ ɛ θ ɪ k s
huffaz	h ʊ f ɑː z
boiler	b ɔ ɪ l ɚ
veny	v ɛ n i
termini	t ɝ m ə n a ɪ
reneg	ɹ ɪ n e ɪ ɡ
atrichic	e ɪ t ɹ ɪ k ɪ k
fanti	f æ n t i
quittor	k w ɪ t ɚ
fucus	f j uː k ə s
gravamen	ɡ ɹ æ v ə m ɛ n
ignifluous	ɪ ɡ n ɪ f l u ə s
complains	k ə m p l e ɪ n z
irenic	a ɪ ɹ i n ɪ k
croupier	k ɹ u p i e ɪ
aknee	ə n iː
richness	ɹ ɪ t͡ʃ n ə s
dissemination	d ɪ s ɛ m ɪ n e ɪ ʃ ə n
fascial	f e ɪ ʃ ə l
sirenomelia	s a ɪ ɹ ə n o ʊ m i l i ə
web	w ɛ b
crosier	k ɹ o ʊ ʒ ɚ
brad	b ɹ æ d
yep	j ɛ p
launch	l ɔ n t͡ʃ
panay	p ə n a ɪ
roué	ɹ uː e ɪ
flooding	f l ʌ d ɪ ŋ
foofaraw	f u f ə ɹ ɔ
adulate	æ d͡ʒ ə l e ɪ t
nonunion	n ɒ n j uː n i ə n
artifice	ɑː ɹ t ɪ f ɪ s
israelite	ɪ z ɹ e ɪ ə l a ɪ t
janine	d͡ʒ ə n iː n
dissension	d ɪ s ɛ n ʃ ə n
pistole	p ɪ s t o ʊ l
slutsk	s l ʊ t s k
flexure	f l ɛ k s j ʊ ə ɹ
foreholding	f ɔ ɹ h o ʊ l d ɪ ŋ
rejoin	ɹ iː d͡ʒ ɔ ɪ n
hermitty	h ɜː ɹ m ɪ t i
papyrus	p ə p a ɪ ɹ ə s
squeteague	s k w iː t iː ɡ
loppet	l o ʊ p ɛ t
spangel	s p e ɪ n d͡ʒ ə l
ciliolate	s ɪ l i ə l ə t
globin	ɡ l ə ʊ b ɪ n
toughie	t ʌ f i
romsey	ɹ ɒ m z i
sherbrooke	ʃ ɝ b ɹ ʊ k
cousin	k ʌ z ə n
asceticist	ə s ɛ t ə s ɪ s t
impetuous	i m p ɛ t͡ʃ u ə s
pizzazz	p ɪ z æ z
shitty	ʃ ɪ t i
poise	p ɔ ɪ z
theanthropist	θ iː æ n θ ɹ ə p ɪ s t
patrols	p ə t ɹ o ʊ l z
dorothy	d ɔ ɹ ə θ i
popina	p ɒ p a ɪ n ə
nasus	n e ɪ s ə s
cringing	k ɹ ɪ n d͡ʒ ɪ ŋ
illness	ɪ l n ə s
kumara	k uː m ə ɹ ə
batdom	b æ t d ə m
coaxes	k ə ʊ k s ɪ z
dorty	d ɔ ɹ t i
omad	o ʊ̯ m æ d
greatsword	ɡ ɹ e ɪ t s ɔ ɹ d
injuria	ɪ n d ʒ ʊ ə ɹ i ə
beliven	b ə l ɪ v ə n
outsourcing	a ʊ t s ɔː ɹ s ɪ ŋ
echard	ɛ k ɑː ɹ d
morbihan	m ɔː ɹ b i ə n
uncial	ʌ n s i ə l
caused	k ɔ z d
epicaricacy	ɛ p ɪ k æ ɹ ɪ k ə s i
kendell	k ɛ n d ə l
tteokbokki	t ɒ k b ə ʊ k i
hallucinogen	h ə l uː s ɪ n ə d͡ʒ e n
sesquipedalian	s ɛ s k w ɪ p ɪ d e ɪ l ɪ ə n
goety	ɡ o ʊ ɪ t i
maraca	m ə ɹ æ k ə
jointed	d͡ʒ ɔ ɪ n t ɪ d
compass	k ʌ m p ə s
uotsuri	uː o ʊ t s ʊ ə ɹ i
wainwright	w e ɪ n ɹ a ɪ t
truculent	t ɹ ʌ k j ʊ l ə n t
gushes	ɡ ʌ ʃ ɪ z
britannia	b ɹ ɪ t æ n ɪ ə
such	s ʌ t͡ʃ
disney	d ɪ z n i
declaring	d ɪ k l ɛ ɹ ɪ ŋ
abound	ə b a ʊ n d
thoughtlessly	θ ɔ t l ɪ s l i
subpoena	s ə p iː n ə
walnut	w ɑ l n ə t
cuajo	k w a h o
faciliatory	f ə s ɪ l i ə t o ɹ i
sievert	s iː v ɚ t
wrang	ɹ æ ŋ
ablush	ə b l ʌ ʃ
spread	s p ɹ ɛ d
xoanon	z o ʊ ə n ɑ n
blood	b l ʌ d
misled	m ɪ s l ɛ d
arun	ɑː ɹ ʊ n
juridicial	d͡ʒ ʊ ɹ ɪ d ɪ ʃ ə l
care	k ɛ ə ɹ
foulsome	f a ʊ l s ə m
freeminer	f ɹ iː m a ɪ n ə
clade	k l e ɪ d
dipstick	d ɪ p s t ɪ k
demagogue	d ɛ m ə ɡ ɑ ɡ
amicide	æ m ɪ s a ɪ d
shitkicker	ʃ ɪ t k ɪ k ə ɹ
elytron	ɛ l ɪ t ɹ ɒ n
noosed	n uː s t
script	s k ɹ ɪ p t
piano	p i æ n o ʊ
stabilization	s t e ɪ b ə l a ɪ z e ɪ ʃ ə n
automatons	ɑ t ɑ m ə t ɑ n z
dastardly	d æ s t ɚ d l i
bellburns	b ɛ l b ɝ n z
anglo	æ ŋ ɡ l o ʊ
aureus	ɔː ɹ ɪ ə s
gungy	ɡ ʌ n d͡ʒ iː
kirkheaton	k ə r k h iː t ə n
herring	h ɛ ɹ ɪ ŋ
exchanged	ɛ k s t͡ʃ e ɪ n d͡ʒ d
gibbet	d͡ʒ ɪ b ɪ t
balboa	b æ l b ə ʊ ə
maya	m a ɪ ə
couchee	k uː ʃ e ɪ
ocher	o ʊ k ɚ
pavis	p ɑ v ɪ s
venality	v ɪ n æ l ɪ t i
implements	ɪ m p l ə m ə n t s
osborne	ɒ z b ɔː ɹ n
authorized	ɔ θ ə ɹ a ɪ z d
encounter	ɪ n k a ʊ n t ɚ
odorless	ə ʊ d ə l ə s
saule	s ɔː l
monoousian	m ɑ n o ʊ u z i ə n
seized	s iː z d
outlier	a ʊ t l a ɪ ə ɹ
haryana	h ɑː ɹ ɪ j ɑː n ə
eightieth	e ɪ t i ə θ
throat	θ ɹ o ʊ t
palingeneses	p æ l ɪ n d͡ʒ ɛ n ə s i z
populace	p ɑ p j ə l ə s
daemon	d e ɪ m ə n
upsoar	ʌ p s ɔː ɹ
appear	ə p ɪ ɹ
lino	l a ɪ n ə ʊ
enclave	ɑ n k l e ɪ v
dicky	d ɪ k i
picador	p ɪ k ə d ɔː ɹ
retribution	ɹ ɛ t ɹ ɪ b j u ʃ ə n
subliterate	s ʌ b l ɪ t ə ɹ ə t
mesquite	m ɛ s k iː t
macroeconomic	m æ k ɹ o ʊ ɛ k ə n ɑː m ɪ k
thermometer	θ ɚ m ɑ m ɪ t ɚ
tsaric	z ɑ ɹ ɪ k
yerkish	j ɜː r k ɪ ʃ
outlook	a ʊ t l ʊ k
vick	v ɪ k
minigun	m ɪ n i ɡ ʌ n
westrip	w ɛ s t ɹ ɪ p
tabby	t æ b i
subterranean	s ʌ b t ə ɹ e ɪ n i ə n
hates	h e ɪ t s
culty	k ʌ l t i
rusto	ɹ ʌ s t o ʊ
gaslight	ɡ æ s l a ɪ t
matitudinal	m æ t ə t j u d ə n l̩
shivering	ʃ ɪ v ə ɹ ɪ ŋ
jarrah	d͡ʒ æ ɹ ə
discussing	d ɪ s k ʌ s ɪ ŋ
telepathy	t ə l ɛ p ə θ i
ended	ɛ n d ɪ d
spatialism	s p e ɪ ʃ ə l ɪ z ə m
wreathe	ɹ iː ð
cooties	k uː t i z
celtic	k ɛ l t ɪ k
spell	s p ɛ l
cosmopolis	k ɒ z m ɒ p ɒ l ɪ s
bashlyk	b æ ʃ l ɪ k
menhaden	m ɛ n h e ɪ d ə n
dilucidation	d ɪ l j uː s ɪ d e ɪ ʃ ə n
rösti	ɹ ɔ s t i
dieretic	d a ɪ ə ɹ ɛ t ɪ k
euphrates	j uː f ɹ e ɪ t iː z
crawshay	k ɹ ɔː ʃ e ɪ
pasadena	p æ s ə d iː n ə
ceremonial	s ɛ ɹ ɪ m o ʊ n i ə l
thorough	θ ɜ ɹ o ʊ
reanimate	ɹ i æ n ə m e ɪ t
laisse	l e ɪ s
badassery	b æ d æ s ə ɹ i
vint	v ɪ n t
alicorns	æ l ɪ k ɔ ɹ n z
poking	p o ʊ k ɪ ŋ
geophyte	d͡ʒ i o ʊ f a ɪ t
nosel	n ə ʊ z ə l
weekend	w i k ɛ n d
macaroni	m æ k ə ɹ o ʊ n i
whitey	w a ɪ t i
observed	ə b z ɝ v d
complement	k ɑ m p l ə m ə n t
copperfield	k ɑ p ɚ f iː l d
debit	d ɛ b ɪ t
picturesquely	p ɪ k t͡ʃ ə ɹ ɛ s k l i
dictionary	d ɪ k ʃ ə n ɛ ɹ i
gyle	ɡ a ɪ l
dally	d æ l i
macropsy	m æ k ɹ ɒ p s i
pizza	p iː t s ə
kittitas	k ɪ d ɪ t æ s
fuckings	f ʌ k ɪ ŋ z
alabama	æ l ə b æ m ə
that	ð æ t
dunam	d ʊ n ə m
pegloticase	p ə ɡ l ɑ t ə k e ɪ s
apt	æ p t
polylactide	p ɒ l i l æ k t a ɪ d
abscondence	æ b s k ɑ n d n̩ s
colony	k ɑ l ə n i
belly	b ɛ l i
fusospirochetal	f j uː z ə ʊ s p a ɪ ɹ ə ʊ k iː t ə l
billet	b ɪ l ɪ t
