देवनागरी	d̪eʋnɑɡɑri
दोमट	d̪omʌʈ
अणु	ʌɳu
राजाराम	rɑd͡ʒɑrɑm
जोरो	d͡ʒoro
धर्ता	d̪ʱʌrt̪ɑ
कलैया	kʌlɑijɑ
बान्की	bɑŋki
अदलबदल	ʌd̪lʌbʌd̪l
चस्क	t͡ʃʌsk
पोर्ट	poʈ
अरुन्धती	ʌruɳd̪ʱʌt̪i
बुकी	buki
बुढिया	bud̪ʱijɑ
फट्कार्	pʰʌʈkɑr
इन्डिया	in̪d̪ijɑ
बक्	bʌk
मापन	mɑpʌn
कुक्रुक्क	kukrukuk
चिन्	t͡ʃin
आहृत	ɑhrit̪
बढुवा	bʌd̪ʱʌʋɑ
कोप्चि	kopʈ͡ʃi
लुटपुट	luʈpʌʈ
छयहत्तर	t͡ʃʌjʌhʌʈʈʌr
लोकराज	lokɑrɑd͡ʒ
चिरस्मरणीय	t͡ʃirʌsmʌrɑɳij
चौटा	t͡ʃɔʈɑ
जतासुकै	d͡ʒʌt̪ɑsukɑi
महानिर्वाचन	mʌhɑnirʋɑt͡ʃʌn
जिब्रो	d͡ʒibro
काइदा	kɑid̪ɑ
खरीसाउँलो	kʰʌrisɑulo
मकमक	mʌkmʌk
उझिन्ड्याउ	ujʰin̪d̪jɑu
एसी	esi
बाईस	bɑis
झ्याली	d͡ʒʰjɑli
प्रदर्शनकारी	prʌd̪ʌrʃʌn̪kɑri
दस्तखत	d̪ʌst̪ʌkʰʌt̪
पक्षी	pʌkʃi
जनसाधारण	d͡ʒʌn̪ʌsɑd̪ʱɑrʌɳ
कठपाइले	kʌʈʰpɑile
हलचल	ɦʌlt͡ʃʌl
प्रतिदिन	prʌt̪id̪in
नेप्टि	nepʈi
बग्रेन	bʌɡren
खाग्सी	kʰɑɡsi
धातु	d̪ʱɑt̪u
आश्रम	ɑʃrʌm
बेसुर	b e s u r
उवासंघ	u v a: s ŋ ɦ
संसाधन	s ə n s a: d̪ ʱ ə n
अनुलोम	ə n u l o: m
रिवाज	r i v a: d͡z
गर्भे	ɡ ə r bʱ e:
गोत्र	ɡ o: t̪ r
सतह	s ə t̪ ə ʱ
घ्न	ɡʱ n
विवश	v i v ə ʃ
पाण्डव	p a: ɳ ɖ ə v
गुड्ड	ɡ u ɖ: ɖ
उच्च	u t͡ʃ: t͡ʃ
सानोठिमी	s a: n o ʈʰ i m i:
महामाया	m ə ʱ a: m a: j a:
सरिशृप	s ə r i ʃ r̩ p
आदर्शवादी	ɑ: d̪ ə r ʃ v a: d̪ i:
काव्यचेतना	k a: v j ə t͡ʃ e t̪ ə n a:
छेका	t͡ʃʰ e k a:
एक्कासि	e k: a: s i
लिपि	l i p i
ठेलाइ	ʈʰ e l a: i
भित्ति	bʱ i t̪: t̪ i
पितित्त	p i t̪ i t̪: t̪
#टकटक्याहा	ʈ ə k ʈ ə k j a: ʱ a:
अश्रुत	ə ʃ r u t̪
कलाकौशल	k ə l a: k au ʃ ə l
प्रशंसा	p r ə ʃ ə n s a:
पीडा	p i: ɖ a:
कुरकुर	k u r ə k u r
ला	l a:
सरदार	s ə r d̪ a: r
आच्छन्न	ɑ: t͡ʃʰ ə n ə n
चटपटे	t͡ʃ ə ʈ p ə ʈ e:
छुरबुर	t͡ʃʰ u r ə b u r
बियाउ	b i j a: u
मेख	m e kʰ
जम्बु	d͡z ə m b u
कडकड	k ə ɖ ə k ə ɖ
अवलुञ्चित	ə v ə l u ɲ t͡ʃ i t̪
बग्रेन	b ə ɡ r e: n
झेली	d͡zʱ e: l i:
चर्	t͡ʃ ə r
छरीदार	t͡ʃʰ ə r i: d̪ a: r
चिम्टे	t͡ʃ i m ʈ e:
सिकुटी	s i k u ʈ i:
ह्रास	ʱ r a: s
पटेर	p ə ʈ e r
बुढिया	b u ɖʱ i j a:
झ्याम्म	d͡zʱ j a: m: m
आर्वर	ɑːrʋər
चिरन्तन	t͡ʃirəntən
पल्टन	pəlʈən
लुँदो	lʊ̃do
गुँडुलि	ɡʊ̃ɖuli
जाँते	d͡ʒɑ̃ːte
दुर्व्यवहार	durʋjəʋəɦɑːr
राजाराम	rɑːd͡ʒɑːrɑːm
झूटो	d͡ʒʱuːʈo
तुरी	turi
कामोद्दीपक	kɑːmodːiːpək
फुर्ती	pʰurti
घृणास्पद	ɡʱr̩ɳɑːspəd
बहस	bəɦəs
धतुलाउ	dʱətulɑːu
ज्वालामुखी	d͡ʒʋɑːlɑːmukʰi
आडिलो	ɑːɖilo
थपड	tʰəpəɖ
थुप्रो	tʰupro
झेल	d͡ʒʱel
पागल	pɑːɡəl
बोको	boʈo
जुत्ता	d͡ʒuttɑː
माउ	mɑːu
असबल्ले	əsəbəlle
बेगल	beɡəl
होड	ɦoɖ
माओ	mɑːo
जर्कट	d͡ʒərʈəʈ
रामेश्वर	rɑːmeʃʋər
ढलिमली	ɖʱəliməli
आधुनिक	ɑːdʱunik
ट्रेडिङ	ʈreɖiŋ
जौ	d͡ʒau
वायरलेस	ʋɑːjərəles
गुहार	ɡuhɑːr
पद	pəd
भक्खर	bʱəkʰər
मुस्लिम	musəlim
पहिरो	pəɦiro
पाकेट	pɑːkeʈ
रुपा	rupɑː
पेन्टिङ	pent̪iŋ
ड्वाङ्ग	ɖʋɑːŋɡ
रूहु	ruhu
जुम्ल्याहा	d͡ʒumljɑːhɑː
पूर्ण	purn
परिवार	pəriʋɑːr
भूउपग्रह	bʱuːupəɡrəɦ
सानोठिमी	sɑːnoʈʰimi
त्यता	t̪ j ʌ t̪ ä
जिबुल्ले	d͡ʒ i b u l l e
मानमर्यादा	m ä n ʌ m ʌ r j ä d̪ ä
अपसारी	ʌ p s ä r i
गोल्छा	ɡ o l t͡ʃʰ ä
गुणहीन	ɡ u ɳ ʌ i n
भ्यार्र	bʱ j ä r r
वाक्यविश्लेषण	b ä k j ʌ b i ʃ l e ʃ ʌ n
मिसोट	m i s o ʈ
काठ	k ä ʈʰ
वृद्धभत्ता	b ɾ i d̪ʱ ʌ bʱ ʌ t̪ t̪ ä
उपसमिति	u p ʌ s ʌ m i t̪ i
चुक्कि	t͡ʃ u k k i
महासन्धि	m ʌ ɦ ä s ʌ n d̪ʱ i
मिलाप	m i l ä p
जिब्रो	d͡ʒ i b r o
युगौँ	j u ɡ̞ ʌ̃
ब्यबहार	b j ʌ b ʌ ɦ ä r
आला	ä l ä
थच्कार्	ʈʰ ʌ t͡ʃ k ä r
बोध	b o d̪ʱ
झञ्झावर्णन	d͡zʱ ʌ̃ d͡zʱ ä b ʌ r n ʌ n
अतिक्रमण	ʌ t̪ i k r ʌ m ʌ n
पुग्	p u ɡ
ठक्रक्क	ʈʰ ʌ k r ʌ k k
तरखर	t̪ ʌ r ʌ kʰ ʌ r
प्रवाह	p r ʌ b ä ɦ
प्रशंसा	p r ʌ ʃ ã s ä
चिरस्मरणीय	t͡ʃ i r ʌ s m ʌ r ʌ n i j
झट्याक	d͡zʱ ʌ ʈ j ä k
मद्यपान	m ʌ d̪ j ʌ p ä n
करकाप	k ʌ r ʌ k ä p
कढी	k ʌ ɖ i
रल्लि	r ʌ l l i
बल्ड्याङ्ङ	b ʌ l ɖ j ä ŋ ŋ
कन्दने	k ʌ n d̪ ʌ n e
पिरिक्क	p i r i k k
ऊ	u
इकार	i k ä r
जलन	d͡ʒ ʌ l ʌ n
उसिसनिसिस	u s i s ʌ n i s i s
भुक्लुक्क	bʱ u k l u k k
कच्चो	k ʌ t͡ʃ t͡ʃ o
घैले	ɡʱ ä i l e
वेषभूषा	b e ʃ ʌ bʱ u ʃ ä
व्यतिरेक	b j ʌ t̪ i r e k
ठकठकी	ʈʰ ʌ k ʈʰ ʌ k i
उत्तरदायित्त्व	u t̪ t̪ ʌ r d̪ ä j i t̪ t̪ b
लम्चि	l ʌ m t͡ʃ i
टेबल	ʈ e b ʌ l
वायुमण्डल	v ɑː j u m ʌ n ɖ ʌ l
एकजीउ	e k ʌ d͡ʒ iː u
भर्र	bʱ ʌ r r
जत्ति	d͡ʒ ʌ t t i
सन्तानब्बे	s ʌ n t ɑː n ʌ b b e
झूर	d͡ʒ ʰ uː r
लौरी	l ɔː r iː
बिलो	b i l o
जुरे	d͡ʒ u r e
पुछार	p u t͡ʃ ɑː r
खिचखिच	kʰ i t͡ʃ kʰ i t͡ʃ
अधिवक्ता	ʌ dʱ i v ʌ k t ɑː
चिरबिरे	t͡ʃ i r ʌ b i r e
खुँडे	kʰ ʌ̃ ɖ e
जहाजी	d͡ʒ ʌ ɦ ɑː d͡ʒ iː
वरपर	v ʌ r p ʌ r
लर्याङतर्याङ	l ʌ r j ɑː ŋ t ʌ r j ɑː ŋ
भाँडाकुँडा	bʱ ɑ̃ ɖ ɑː k ʌ̃ ɖ ɑː
आफन्तजन	ɑː f ʌ n t ʌ d͡ʒ ʌ n
काव्यचेतना	k ɑː v j ʌ t͡ʃ e t ʌ n ɑː
उन्मादपन	u n m ɑː d p ʌ n
धोखा	dʱ o kʰ ɑː
अन्तर्त्वचा	ʌ n t ʌ r t v ʌ t͡ʃ ɑː
गतिमान	ɡ ʌ t i m ɑː n
जन्ड	d͡ʒ ʌ n ɖ
सपेटो	s ʌ p e t o
बखान्	b ʌ kʰ ɑː n
सम्झौतापत्र	s ʌ m d͡ʒ ɔː t ɑː p ʌ t r
छकाउ	t͡ʃʰ ʌ k ɑː u
गोठालो	ɡ o tʰ ɑː l o
घोरतर	ɡʱ o r ʌ t ʌ r
भन्सार	bʱ ʌ n s ɑː r
छुमछुम	t͡ʃʰ u m t͡ʃʰ u m
आमन्त्रित	ɑː m ʌ n t r i t
थ्वाप्प	tʰ w ɑː p p
ओकल्	o k ʌ l
वरणी	v ʌ r ʌ n iː
कत्थक	k ʌ tʰ tʰ ʌ k
कलनाद	k ʌ l ʌ n ɑː d
लसपस	l ʌ s ʌ p ʌ s
क्यापिटल	k j ɑː p i t ʌ l
सदा	s ʌ d ɑː
विनोदकुमार	v i n o d ʌ k u m ɑː r
चिम्रे	t͡ʃ i m r e
गव्य	ɡ ʌ v j ʌ
टोप्रो	ʈ o p r o
खटिरा	kʰ ʌ ʈ i r ɑː
घत्रक्क	ɡʱ ʌ t r ʌ k k
अवतीर्ण	ʌ v ʌ t iː r ɳ
यन्त्र	j ʌ n t r
हरिभक्त	ɦəɾibʱəkt̪
जर्कट	d͡ʒəɾkʈ
चाट्	t͡ʃɑːʈ
अडियल	əɖijəl
योजना	jɔd͡ʒənɑː
सहटाउ	səɦʈɑːu
परिपाटी	pəɾipɑːʈiː
गज	ɡəd͡ʒ
लडाइँ	ləɖɑːĩ
थेग्रि	ʈʰeɡɾi
धारणा	dʱɑːɾənɑː
छूती	t͡ʃʰuːtiː
समयाङ्कन	səməjɑːŋkən
घुइँकि	ɡʱuĩki
घराना	ɡʱəɾɑːnɑː
आशंसित	ɑːʃə̃sit
मनुज	mənud͡ʒ
घ्न	ɡʱnə
राइजिङ	rɑːid͡ʒiŋ
शब्दकोष	ʃəbdəkoʃ
दीप्‍ति	diːpti
सजीव	səd͡ʒiːv
सतिसाल	sətisɑːl
कल्पक	kəlpək
कोको	kɔkɔ
द्वित्व	dʋitʋə
लक्ष्मी	ləkʂmiː
उडालु	uɖɑːlu
जेठानी	d͡ʒeʈʰɑːniː
तौली	tɔliː
च्यापु	t͡ʃjɑːpu
चौगुना	t͡ʃɔɡunɑː
भित्ता	bʱittɑː
डगमग	ɖəɡməɡ
खोल	kʰɔl
खोल्सी	kʰɔlsiː
सुइय्य	suijːə
सङ्गीन	səŋgiːn
श्री	ʃriː
रुपरेखा	rupərekʰɑː
बुकुरा	bukurɑː
पहिरन	pəɦirən
सुक्	suk
लता	lətɑː
जबरजस्ती	d͡ʒəbərd͡ʒəstiː
प्रान्त	prɑːnt̪ə
तीक्ष्णता	tiːkʂɳət̪ɑː
रामनारायण	rɑːmənɑːrɑːjəɳ
कुर्कुच्चा	kurkut͡ʃt͡ʃɑː
छात्रछात्रा	t͡ʃɑːtrət͡ʃɑːtrɑː
कठोरपन	kʌʈʰoɾpʌn
घेरा	ɡʱeɾʌ
चुरुक्क	t͡ʃuɾukk
नमज्जा	nʌmʤʌ
सुकसुक	sukʌsuk
गिजोल्	ɡiʤol
तालिम	tɑːlim
अलख	ʌlʌkh
अरक्षित	ʌɾʌkʂit
मुख	mukʰ
कृतक	kɾitʌk
वाक्यविश्लेषण	vɑːkjʌviʃleʂʌn
विश्वशान्ति	viʃvʌʃɑːnti
राजनेता	rɑːʤʌnet̪ɑː
कोठा	kot̪ʰɑː
दृष्टान्त	dɾiʂt̪ɑːnt
पृष्ठसाइज	pɾiʂt̪ʰsɑːid͡z
ताण्डव	tɑːɳɖʌv
बदनाम	bʌdʌnɑːm
धर्ता	dʱʌrt̪ɑː
थ्वाप्प	t̪ʰvɑːpp
वसन्तपञ्चमी	vʌsʌntʌpʌɲt͡ʃmiː
छडछड	t͡ʃʌɖt͡ʃʌɖ
कात्	kɑːt
वाहन	vɑːhʌn
उत्पादी	ut̪pɑːdiː
फतरि	pʰʌt̪ʌri
लत्ताकपडा	lʌt̪t̪ɑːkʌpʌɖɑː
अविवेक	ʌvivek
बबरमहल	bʌbʌrmʌhʌl
गिर्खा	ɡirkʰɑː
गार्डेन	ɡɑːɾɖen
अथाह	ʌt̪ʰɑːh
लेनिनवाद	leninvɑːd
जगण	ʤʌɡʌɳ
मनाङ	mʌnɑːŋ
फ्यासफ्यास	pʰjɑːspʰjɑːs
हृदय	hridʌj
सुइरो	suiro
बिरानो	birɑːno
साग्रह	sɑːgrʌh
छूताछूत	t͡ʃʰuːt̪ɑːt͡ʃʰuːt
हिमगिरि	himʌgiri
लर्याङतर्याङ	lʌrjɑːŋt̪ʌrjɑːŋ
आदर्शवादी	ɑːdʌrʃvɑːdiː
भ्वाँङ्ग	bʱvɑːŋɡ
चीनी	t͡ʃiːniː
समस्तर	sʌmʌst̪ʌr
हिमचुली	himʌt͡ʃuliː
चवालीसौं	t͡ʃʌvɑːlisɔ̃
अभिशाप	ʌ bʱ i ʃ ɑː p
छलक्क	t͡ʃʰ ʌ l ʌ k̚ k
अवच्छिन्न	ʌ b ʌ t͡ʃʰ i nː
हतपती	ɦ ʌ t̪ ʌ p ʌ t̪ i
कम्ती	k ʌ m t̪ i
जीन	d͡ʒ iː n
वरणी	b ʌ r ʌ n iː
ओकल्	o k ʌ l
इनेगिने	i n e ɡ i n e
पघार्	p ʌ ɡʱ ɑː r
अहिंस्रक	ʌ ɦ ĩ s r ʌ k
कर्कि	k ʌ r k i
गणतन्त्रीय	ɡ ʌ n ʌ t̪ ʌ n t̪ r iː j
छिटपुट	t͡ʃʰ i t̪ ʌ p ʊ t̪
कुञ्‍ज	k u ɲ d͡ʒ
माइक्रोप्रोसेसर	m ɑː i k r o p r o s e s ʌ r
उबडखाबड	u b ʌ d̪ kʰ ɑː b ʌ d̪
रगत	r ʌ ɡ ʌ t̪
चन्द्रिका	t͡ʃ ʌ n d̪ r i k ɑː
प्रकृतिप्रेम	p r ʌ k r i t̪ i p r e m
अन्यथा	ʌ n j ʌ t̪ʰ ɑː
थर्क	t̪ʰ ʌ r k
समादर	s ʌ m ɑː d̪ ʌ r
कर्णपट	k ʌ r n ʌ p ʌ t̪
कल्याण	k ʌ l j ɑː n
टुप्पो	t̪ u p p o
भतभती	bʱ ʌ t̪ ʌ bʱ ʌ t̪ i
सारङ्ग	s ɑː r ʌ ŋ ɡ
कस्कुटो	k ʌ s k u t̪ o
ठेस्सि	t̪ʰ e s s i
एक्युपङ्चर	e k j u p ʌ ŋ t͡ʃ ʌ r
हत्तपत्त	ɦ ʌ t̪ t̪ ʌ p ʌ t̪ t̪
झिन्नि	d͡ʒʱ i nː i
चर्	t͡ʃ ʌ r
चुक	t͡ʃ u k
वहि	b ʌ ɦ i
कोप्रि	k o p r i
आत्मपरक	ɑː t̪ m ʌ p ʌ r ʌ k
पृष्ठसाइज	p r i ʃ t̪ʰ s ɑː i d͡ʒ
अधिकारवाला	ʌ d̪ʱ i k ɑː r b ɑː l ɑː
एकजाति	e k d͡ʒ ɑː t̪ i
क्रमाङ्कन	k r ʌ m ɑː ŋ k ʌ n
टलल्ल	t̪ ʌ l ʌ l
सुक्	s u k
अपरेटर	ʌ p ʌ r e t̪ ʌ r
बित्थै	b i t̪ t̪ʰ ɑː i
निश्‍चय	n i ʃ t͡ʃ ʌ j
देवेन्द्र	d̪ e b e n d̪ r ʌ
अवधि	ʌ b ʌ d̪ʱ i
सट्याकसुटुक	s ʌ t̪ j ɑː k ʌ s u t̪ u k

    लेखपढ	l e kʰ p ʌ d̪
नेमकिपा	n e m ʌ k i p ä
गुपचुप	ɡ u p ʌ t͡ʃ u p
रोटी	r o ʈ i
करङ	k ʌ r ʌ ŋ
सिल	s i l
लडे	l ʌ d̪ e
जापान	d͡ʒ ä p ä n
जलजलाउँदो	d͡ʒ ʌ l d͡ʒ ʌ l ä u̯ n d o
कोच्	k o t͡ʃ
टपरे	ʈ ʌ p ʌ r e
मुल्कि	m u l k i
अक्षरात्मक	ʌ kʃ ʌ r ä t̪ m ʌ k
सृजनशीलता	s ɾ i d͡ʒ ʌ n ʃ i l ʌ t̪ ä
पाँडे	p ä̃ d̪ e
परिपक्वता	p ʌ r i p ʌ k w ʌ t̪ ä
उच्छेदन	u t͡ʃʰ e d ʌ n
उत्पीडन	u t̪ p i d̪ ʌ n
मिलन	m i l ʌ n
लिपि	l i p i
अरस	ʌ r ʌ s
अहह	ʌ ɦ ʌ ɦ
जटे	d͡ʒ ʌ ʈ e
शुद्धाशुद्धि	ʃ u d̪ʱ ä ʃ u d̪ʱ i
उहुँ	u ɦ ũ
निखार	n i kʰ ä r
पुतौरो	p u t̪ ʌ u̯ r o
खलिकपुर	kʰ ʌ l i k ʌ p u r
पार्षद	p ä r ʃ ʌ d̪
अबोधव्यक्ति	ʌ b o d̪ʱ ʌ b j ʌ k t̪ i
होमाइ	ɦ o m ä i
अफलाइन	ʌ pʰ l ä i n
जिरिङ्ग	d͡ʒ i r i ŋ ɡ
तीर्थयात्रा	t̪ i r ʈʰ j ä t̪ r ä
एक्काईस	e k̚ k ä i s
तमोर	t̪ ʌ m o r
चन्द्रशेखर	t͡ʃ ʌ n d̪ r ʌ ʃ e kʰ ʌ r
सेनानी	s e n ä n i
खोजी	kʰ o d͡ʒ i
द्यौता	d̪ j ʌ u̯ t̪ ä
तुलसीपुर	t̪ u l ʌ s i p u r
बिगौती	b i ɡ̞ ʌ u̯ t̪ i
आत्मघाती	ä t̪ m ʌ ɡʱ ä t̪ i
नपुङ्सक	n ʌ p u ŋ s ʌ k
महत्ता	m ʌ ɦ ʌ t̪ t̪ ä
अपस्मार	ʌ p ʌ s m ä r
आम्खोरा	ä m kʰ o r ä
लेखनी	l e kʰ ʌ n i
मङ्गलाचरण	m ʌ ŋ ɡ ʌ l ä t͡ʃ ʌ r ʌ n
कठोरपन	k ʌ ʈʰ o r p ʌ n
गलकट्टा	ɡ ʌ l k ʌ ʈ ʈ ä
डाइनी	ɖ ä i n i
नीम	n iː m
क्रान्तिवादी	k r ä n ʈ i ʋ ä ɖ i
असुरक्षा	ʌ s u r ʌ k ʃ ä
दन्तशूल	ɖ ʌ n ʈ ʌ ʃ uː l
आदेशक	ä ɖ e ʃ ʌ k
धानबाली	ɖʱ ä n ʌ b ä l i
उछिल्ल्याहा	u t͡ʃ i l l j ä ɦ ä
उपहास	u p ʌ ɦ ä s
जम्क	d͡ʒ ʌ m k
लत्र्याँस्स	l ʌ t̪ r j ä̃ s s
गँजडी	ɡ ä̃ d͡ʒ ɖ i
भ्यार्र	bʱ j ä r r
कुँडुलि	k ũ̯ ɖ u l i
प्रसार	p r ʌ s ä r
अकड	ʌ k ʌ ɖ
ह्वाप्प	ɦ ʋ ä p p
ओभाउ	o bʱ ä u
तोड	ʈ o ɖ
खाका	kʰ ä k ä
कुर्ता	k u r ʈ ä
रौतहट	r ʌ u t̪ ʌ ɦ ʈ
फुल्चोकी	pʰ u l t͡ʃ o k i
दासत्व	ɖ ä s ʌ t̪ ʋ
खोइरो	kʰ o i r o
खोसेल्टि	kʰ o s e l ʈ i
सम	s ʌ m
टुप्पो	ʈ u p p o
दुर्दशा	ɖ u r ɖ ʌ ʃ ä
चुकअमिलो	t͡ʃ u k ʌ m i l o
सहृयार्	s ʌ ɦ r j ä r
पुछार	p u t͡ʃ ä r
औपपत्तिक	ʌ u p ʌ p ʌ ʈ ʈ i k
विशृङ्खलता	ʋ i ʃ r ŋ kʰ l ʌ t̪ ä
सोलि	s o l i
अन्दोलन	ʌ n ɖ o l ʌ n
अक्रम	ʌ k r ʌ m
फुत्रुक्क	pʰ u ʈ r u k k
सप्को	s ʌ p k o
टेक	ʈ e k
अह्राउ	ʌ ɦ r ä u
हुप	ɦ u p
एक्कासि	e k k ä s i
स्वाइँस्वाइँती	s ʋ ä ĩ s ʋ ä ĩ t̪ i
बौद्धिकता	b ʌ u ɖ ɖʱ i k ʌ t̪ ä
डट	ɖ ʌ ʈ
इञ्जिनियर	i ŋ d͡ʒ i n i ʌ r
मतभेद	m ʌ t̪ ʌ bʱ e ɖ
अन्तरी	ʌ n ʈ ʌ r i
घण्टी	ɡʱʌɳʈi
मट्टै	mʌʈʈai
स्याहार	sjahaɾ
डुँडाउ	ɖʌ̃ɖau
कमिलो	kamilo
सदा	sada
ज्यामी	d͡ʒjam̚i
अगम्य	aɡamja
जिउ	d͡ʒiu
लिपि	lipi
बोध	bodʱ
आँक	ãk
अपजस	apd͡ʒas
शशक्तिकरण	ʃaʃaktikaran
अल्बानीया	albanija
सँगेल्	sãɡel
एम्बुलेन्स	embulens
सिप्किनु	sipkinu
ताण्डव	tandaʋ
सिलेट	silet
तड्प	tʌɖp
वक्र	ʋakɾ
चुड्का	t͡ʃʌɖka
अनुक्रमण	anukraman
छामछुम	t͡ʃhamt͡ʃhum
चीनी	t͡ʃini
खतम	kʰatam
तलेजु	taleʤu
सिलौटो	silauʈo
टोकाइ	ʈokai
मध्यस्थता	madhjastʰata
सइस	sais
अभिराम	abhiram
खर्लप्प	kʰarlapː
लाजवती	lad͡ʒʋati
साग्रह	sagrah
कोलम्बो	kolambo
ताउलो	taulo
अन्तर्विकास	antarʋikas
पलाउ	palau
दपेटाइ	dapetai
मध्यनजर	madhjanad͡ʒar
परख	parakh
संयम	sanjam
कुञ्‍ज	kʊɲd͡ʒ
गबुल्लो	gabullo
पानीजहाज	paːniːd͡ʒahaːd͡ʒ
उल्टाइ	ulʈai
आलोक	alok
खिस्सा	kʰissa

    सुविस्ता	s u v i s t̪ ä
माउ	m ä u
कार्यव्यापार	k ä r j ʌ v j ä p ä r
भरोसा	bʱ ʌ r o s ä
चण्ड	t͡s ʌ ɳ ɖ
जन्ड	d͡ʒ ʌ n ɖ
एकोतार	e k o t ä r
उगाउ	u ɡ ä u
साकेवा	s ä k e v ä
स्क्यान	s k j ä n
उपक्षेत्रीय	u p ʌ kʃ e t̪ r i j ä
पितित्त	p i t̪ i t̪ t̪
कुस्तुर	k u s t̪ u r
बालक	b ä l ʌ k
सिकुटी	s i k u ʈ i
ब्लुमफिल्ड	b l u m ʌ pʰ i l ɖ
शेखर	ʃ e kʰ ʌ r
कोलाहल	k o l ä ɦ ʌ l
फलैँचा	pʰ ʌ l ä̃ t͡s ä
रामपुर	r ä m p u r
सम्भ्रम	s ʌ m bʱ r ʌ m
दपेटाइ	d ʌ p e ʈ ä i
तिम्रो	t̪ i m r o
ओल्छि	o l t͡sʰ i
जाँते	d͡ʒ ä̃ t̪ e
लोग्ने	l o ɡ̞ n e
सतराज	s ʌ t̪ ʌ r ä d͡ʒ
प्रभा	p r ʌ bʱ ä
तिर्सना	t̪ i r s ʌ n ä
सन्जे	s ʌ n d͡ʒ e
कृतक	k ɾ i t̪ ʌ k
गुरगुरी	ɡ u r ɡ u r i
गथासो	ɡ ʌ t̪ʰ ä s o
अभिनव	ʌ bʱ i n ʌ v
सनातन	s ʌ n ä t̪ ʌ n
खिलाफ	kʰ i l ä ʌ pʰ
पटेर	p ʌ ʈ e r
नाक	n ä k
चल	t͡s ʌ l
लठैत	l ʌ ʈʰ ä i t̪
उपास्य	u p ä s j ä
पाण्डव	p ä ɳ ɖ ʌ v
बिल्टो	b i l ʈ o
रसिद	r ʌ s i d
दर्शनशास्त्र	d ʌ r ʃ ʌ n ʃ ä s t̪ r
धुरी	dʱ u r i
टपटप	ʈ ʌ p ʈ ʌ p
पास	p ä s
झुल्कि	d͡zʱ u l k i
जहडी	d͡ʒ ʌ ɦ ʌ d i
आरोप्य	ɑːɾopjə
सङ्गति	səŋɡəti
हिसाबकिताब	hisɑːbkitɑːb
लिखु	likʰu
झुरुमुरु	d͡ʒʰuɾumuɾu
नब्बे	nəbbe
डीएनए	ɖiːenə
दण्डसजाय	dəɳɖəsəd͡ʒɑːj
अश्रान्त	əʃɾɑːnt
उल्लु	ullu
चिरस्मरणीय	t͡ʃirəsməɾəɳijə
खर्लप्प	kʰəɾləppə
याँ	jɑː̃
बिसौनी	bisəuni
वास्तुविद	vɑːstuvəd
उद्‌भासी	udbʱɑːsi
बढिया	bəɖʱijɑː
जिउनी	d͡ʒiuni
खटाखट	kʰəʈɑːkʰəʈ
डल्लेँठो	ɖəllẽʈʰo
आमाछोरी	ɑːmɑːt͡ʃʰori
ब्यानर	bjɑːnəɾ
उघाउ	uɡʱɑːu
वस्तु	vəstu
छिपछिप	t͡ʃʰipət͡ʃʰip
उद्‌भावित	udbʱɑːvit
प्रवाह	pɾəvɑːh
पुत्र	putɾə
छुरो	t͡ʃʰuro
धोका	dʰokɑː
तरफ	təɾəf
भाडा	bʱɑːɖɑː
चौसट्ठी	t͡ʃəusəʈʰi
उचित	ut͡ʃit
खुँडे	kʰũɖe
कृतक	kɾitək
गम्भीरता	ɡəmbʱiːɾətɑː
चोरऔंले	t͡ʃorəũle
ह्वासह्वास	hvɑːsəhvɑːs
अविवेक	əvəvek
प्रेमकथा	pɾeməkətʰɑː
फाल	fɑːl
उम्दा	umdɑː
तन	tən
कारीगर	kɑːɾigəɾ
निस्कासन	niskɑːsən
अनिन्द्य	ənindjə
जिल्लाराम	d͡ʒillɑːɾɑːm
जयस्थिति	d͡ʒəjəstʰiti
चर्यामचुरुम	t͡ʃərjɑːmət͡ʃuɾum
खौवा	kʰaʊʋa
फ्रेमसेट	pʰɾeːmset̪
देवीप्रसाद	d̪eʋiːpɾasaːd̪
बेहोर्	bɛhoɾ
खाँज	kʰãːd͡ʒ
बत्ती	bʌt̪t̪iː
सन्दुक	sʌnd̪ʊk
कनसुत्ली	kʌnʌsʊt̪liː
बोटे	boʊʈe
सम्भोग	sʌmbʰoɡ
मङ्गलाचरण	mʌŋɡʌlaːt͡ʃʌɾʌn
वृहस्पतिवार	ʋɾ̩ɦʌspʌt̪iʋaːɾ
द्विज	d̪ʋid͡ʒ
उपमान	ʊpʌmaːn
रामकुमारी	ɾaːmʌkʊmaːɾiː
निप्ट	nipʈ
डिनर	ɖinʌɾ
आरोपक	aːɾoːpʌk
अविवेक	ʌʋiʋeːk
सावा	saːʋaː
र्‍याल	ɾjaːl
कर्णफूल	kʌɾɳʌpʰuːl
निजीक्षेत्र	nid͡ʒiːkʃet̪ɾ
कमलनाभ	kʌmʌlnaːbʰ
परिच्छेद	pʌɾit͡ʃʰed̪
क्रिकेट	kɾiket̪
अभिवन्दनीय	ʌbʰiʋʌnd̪ʌniːjʌ
एकत्र	ekʌt̪ɾ
दहिलो	d̪ʌɦilo
हाइटी	ɦaːit̪iː
उद्‌गार	ʊd̪ɡaːɾ
राजबन्दी	ɾaːd͡ʒbʌnd̪iː
ससीम	sʌsiːm
दमार	d̪ʌmaːɾ
डिपोट	ɖipoʊʈ
पुच्छर	pʊt͡ʃʰʌɾ
जटित	d͡ʒʌʈit̪
मई	maːi
आलस्य	aːlʌsjʌ
कलाकारिता	kʌlaːkaːɾit̪aː
प्राविधिक	pɾaːʋid̪ʰik
गफ	ɡʌpʰ
मेसिन	meːsin
पुरुष	pʊɾʊʃ
कस्कुटो	kʌskʊʈo
बित्थै	bit̪ʰaːi
छपछप	t͡ʃʌpʌt͡ʃʌp
पटटट	pʌʈʌʈʌʈ
बुरुण्डी	bʊɾʊɳɖiː
गिरावट	ɡiɾaːʋʌʈ

    अत्रि	ʌ t̪ r i
मायादेवी	m ä j ä d̪ e b i
किर्नु	k i r n u
देवेन्द्र	d̪ e b e n̪ d̪ r ʌ
राजश्व	r ä d͡ʒ ʃ ʋ ʌ
लेखपढ	l e kʰ ʌ p ʌ ɖʱ
आउरे	ä ʌ u r e
चम्के	t͡ʃ ʌ m k e
अनुच्चार्य	ʌ n u t͡ʃ t͡ʃ ä r j ʌ
कपोत	k ʌ p o t̪
खोइरो	kʰ o i r o
मेसिन	m e s i n
छोप	t͡ʃʰ o p
साङ्लो	s ä ŋ l o
उँधो	u ŋ d̪ʱ o
अडभङ्ग्याहा	ʌ ɖʱ ʌ ŋ g j ä ɦ ä
उपलब्धता	u p ʌ l ʌ b d̪ʱ ʌ t̪ ä
अकलगुम	ʌ k ʌ l ʌ g u m
जटित	d͡ʒ ʌ t̪ i t̪
कौवाली	k ʌ u ʋ ä l i
नङ्ग्याउ	n ʌ ŋ g j ä u
खन	kʰ ʌ n
टेस्ट	ʈ e s ʈ
बिसौनी	b i s ʌ u n i
दातृसंस्था	d̪ ä t̪ r s ʌ n s t̪ʰ ä
माइक्रोप्रोसेसर	m ä i k r o p r o s e s ʌ r
हुँदो	ɦ u ŋ d̪ o
च्यापु	t͡ʃ j ä p u
निधार	n i d̪ʱ ä r
फगटो	pʰ ʌ g ʌ ʈ o
पिरपिर	p i r p i r
खराखर	kʰ ʌ r ä kʰ ʌ r
पोखरी	p o kʰ ʌ r i
मुलुक	m u l u k
चरित्रप्रधान	t͡ʃ ʌ r i t̪ r ʌ p r ʌ d̪ʱ ä n
फुलिस्केप	pʰ u l i s k e p
चाणक्य	t͡ʃ ä n̪ ʌ k j ʌ
फुट	pʰ u ʈ
अछापे	ʌ t͡ʃʰ ä p e
पहिचान्	p ʌ ɦ i t͡ʃ ä n
बनेपा	b ʌ n e p ä
प्रमाणपत्र	p r ʌ m ä n̪ ʌ p ʌ t̪ r ʌ
तरक्की	t̪ ʌ r k k i
उम्र	u m r ʌ
नब्बे	n ʌ b b e
जफत	d͡ʒ ʌ pʰ ʌ t̪
मुख्यालय	m u kʰ j ä l ä j ʌ
दापा	d̪ ä p ä
फारु	pʰ ä r u
आगा	ä ʌ g ä
काती	k ɑː t iː
प्रोत्साहन	p ɾ oː t s ɑː h ʌ n
कनकर्नु	k ʌ n ʌ k ʌ ɾ n uː
जत्ति	ʤ ʌ t t iː
हल्ट	h ʌ l ʈ
वीर	ʋ iː ɾ
धर्ता	dʱ ʌ ɾ t ɑː
टेण्डर	ʈ eː ɳ ʈ ʌ ɾ
ढ्याम्म	ɖʱ j ɑː m m
ल्वापल्वापती	l ʋ ɑː p l ʋ ɑː p ʌ t iː
इट	iː ʈ
गगन	ɡ ʌ ɡ ʌ n
वृत्त	ʋ ɾ ɪ t t
जप्	ʤ ʌ p
पिठ्युँ	p iː ʈʰ j ũ
प्रावधान	p ɾ ɑː ʋ ʌ dʱ ɑː n
अङ्गीकृत	ʌ ŋ ɡ iː k ɾ ɪ t
तुरी	t uː ɾ iː
कूटस्थ	k uː ʈ ʌ s tʰ
मनोविज्ञान	m ʌ n oː ʋ iː ʤ ɲ ɑː n
गबुल्लो	ɡ ʌ b uː l l oː
लाजवती	l ɑː ʤ ʌ ʋ ʌ t iː
लुटि	l uː ʈ iː
फस्क	pʰ ʌ s k
खुकुलो	kʰ uː k uː l oː
अकुलाउ	ʌ k uː l ɑː uː
खस्क	kʰ ʌ s k
ओइरि	oː iː ɾ iː
हुस्सु	h uː s s uː
अपहरणकारी	ʌ p ʌ h ʌ ɾ ʌ ɳ k ɑː ɾ iː
अधीन	ʌ dʱ iː n
उल्था	uː l tʰ ɑː
मुख	m uː kʰ
इस्लामावाद	iː s l ɑː m ɑː ʋ ɑː d
खान्की	kʰ ɑː n k iː
ईसाइ	iː s ɑː iː
ऐन	ʌ iː n
आम्खोरा	ɑː m kʰ oː ɾ ɑː
अनुलोम	ʌ n uː l oː m
चालामाला	t͡ʃ ɑː l ɑː m ɑː l ɑː
अमलबाज	ʌ m ʌ l b ɑː ʤ
हुत्त	h uː t t
नरसंहार	n ʌ ɾ s ʌ̃ h ɑː ɾ
घनटाउके	ɡʱ ʌ n ʈ ɑː uː k eː
त्रिवेणी	t ɾ iː ʋ eː ɳ iː
साइनो	s ɑː iː n oː
परापूर्व	p ʌ ɾ ɑː p uː ɾ ʋ
लफन्धर	l ʌ pʰ ʌ n dʱ ʌ ɾ
रूहु	ɾ uː h uː
खाद्यपदार्थ	kʰ ɑː d j ʌ p ʌ d ɑː ɾ tʰ
घाँस	ɡʱ ä̃ s
शोधपत्र	ʃ o d̪ʱ pʌ t̪ r
ऐँचाताना	ɛ̃ t͡ʃ ä t̪ ä n ä
जिक्री	d͡ʒ i k r i
लोति	l o t̪ i
उपास्य	u p ä s j ʌ
कुशलता	k u ʃ ʌ l t̪ ä
अपरूप	ʌ p ʌ r u p
ओदान	o d ä n
एकस्व	e k ʌ s w
घुँगुर्कि	ɡʱ ũ ɡ u r k i
साँढी	s ä̃ ɖʱ i
वारुणयन्त्र	w ä r u ɳ j ʌ n t̪ r
लत्ताकपडा	l ʌ t̪ t̪ ä k ʌ p ɖ ä
सारथि	s ä r ʌ t̪ʱ i
चौरस	t͡ʃ ɔ r ʌ s
तार्	t̪ ä r
घोलुवा	ɡʱ o l u w ä
पम्फा	p ʌ m pʰ ä
अन्तरविरोध	ʌ n t̪ ʌ r w i r o d̪ʱ
बेकाम	b e k ä m
धादिङ	d̪ʱ ä d̪ i ŋ
छलक्क	t͡ʃʰ ʌ l ʌ k̚ k̚
मार्फत	m ä r pʰ ʌ t̪
प्लेकार्ड	p l e k ä r d̪
ल्वात्त	l w ä t̪ t̪
ढिलो	ɖʱ i l o
आदर्शवादी	ä d̪ ʌ r ʃ w ä d̪ i
तन्नेरी	t̪ ʌ n n e r i
कार्बन	k ä r b ʌ n
नरसंहार	n ʌ r ʌ s ʌ̃ ɦ ä r
कराई	k ʌ r ä i
निदाल	n i d ä l
पटि	p ʌ t̪ i
गजधम्म	ɡ ʌ d͡ʒ ʌ d̪ʱ ʌ m
सन्तानब्बे	s ʌ n t̪ ä n ʌ b b e
सन्तति	s ʌ n t̪ ʌ t̪ i
हलेदो	ɦ ʌ l e d̪ o
एकगेडे	e k ʌ ɡ e ɖ e
कढी	k ʌ ɖʱ i
मोज	m o d͡ʒ
फिसिक्क	pʰ i s i k̚ k̚
सङ्ग्रह	s ʌ ŋ ɡ r ʌ ɦ
उपक्षेत्रीय	u p ʌ kʃ e t̪ r i j ʌ
मालिङ्गो	m ä l i ŋ ɡ o
कोटे	k o t̪ e
हडबडी	ɦ ʌ ɖ ʌ b ʌ d̪ i
मात्रृभाषा	m ä t̪ r u bʱ ä ʃ ä
रे	r e
नेशनल	n e ʃ ʌ n ʌ l
जनतन्त्र	ʤ ʌ n ʌ t̪ ʌ n t̪ r
पोत्	p o t̪
हलुवाबेत	ɦ ʌ l u w ä b e t̪
जङ्गम	ʤ ʌ ŋ ɡ ʌ m
त्रियाकलाप	t̪ r i j ä k ʌ l ä p
अपहरणकारी	ʌ p ʌ ɦ ʌ r ʌ n k ä r i
झेल्	ʤ e l
पाकेट	p ä k e t̪
यता	j ʌ t̪ ä
खुलुल्ल	kʰ u l u l l
नपुङ्सक	n ʌ p u ŋ s ʌ k
डाँडाकाँडा	ɖ ä̃ ɖ ä k ä̃ ɖ ä
सृजनशीलता	s r ʌ ʤ ʌ n ʃ i l ʌ t̪ ä
दस्तखत	d ʌ s t̪ ʌ kʰ ʌ t̪
विश्वबैँक	b i ʃ w ʌ b ä̃ k
कुचुर्कि	k u t͡ʃ u r k i
उन्	u n
सिधिया	s i ɖʱ i j ä
प्रति	p r ʌ t̪ i
घृणास्पद	ɡʱ r ʌ ɳ ä s p ʌ d
तलेजु	t̪ ʌ l e ʤ u
तीस	t̪ i s
गोल्छा	ɡ o l t͡ʃʰ ä
दापा	d ä p ä
महासेनानी	m ʌ ɦ ä s e n ä n i
व्यन्जन	b j ʌ n ʤ ʌ n
उल्था	u l t̪ʰ ä
ढक	ɖʱ ʌ k
वाग्दान	b ä ɡ̞ d ä n
आख्यायक	ä kʰ j ä j ʌ k
दवाब	d ʌ w ä b
कलाकारिता	k ʌ l ä k ä r i t̪ ä
थ्वाप्प	t̪ʰ w ä p p
दोमट	d o m ʌ t̪
आल्मारी	ä l m ä r i
खिपुवा	kʰ i p u w ä
रातारात	r ä t̪ ä r ä t̪
रसायन	r ʌ s ä j ʌ n
अन्यथा	ʌ n j ʌ t̪ʰ ä
मार्फत	m ä r pʰ ʌ t̪
दामल१	d ä m ʌ l 1
गमनीय	ɡ ʌ m ʌ n i j
ढाँड	ɖʱ ä̃ ɖ
गृहस्थ	ɡ r ʌ ɦ ʌ s t̪ʰ
समाचारदाता	s ʌ m ä t͡ʃ ä r d ä t̪ ä
देखादेख	d e kʰ ä d e kʰ
चिन्ताकुल	t͡ʃ i n t̪ ä k u l
लेखक	l e kʰ ʌ k
अदलबदल	ʌ d ʌ l b ʌ d ʌ l
किस्मती	k i s m ʌ t̪ i
हकदार	ɦʌkd̪ɑːr
कोदो	kodo
वस्तुत:	vʌstut
झुत्रेझाम्रे	d͡zʱutrɛd͡zʱɑːmrɛ
दर्पण	d̪ʌrpʌɳ
बेमज्जा	bɛmʌd͡zʱʌ
अनित्य	ʌnitjʌ
रुगरुगी	rugrugɪ
प्रजा	prʌd͡zʱɑː
लेखक	lɛkhʌk
रोकाया	rokɑːjʌ
इच्छापत्र	icchɑːpʌtr
समरजङ्ग	sʌmʌrjʌŋg
उम्त्याहा	umtjɑːhɑː
जैरे	d͡zʱɑːirɛ
चलन	t͡ʃʌlʌn
देवालय	d̪ɛvɑːlʌj
जेल	d͡zʱɛl
क्यालेन्डर	kjɑːlɛnd̪ʌr
अभिज्ञान	ʌbʱid͡zʱɲɑːn
हरेस	ɦʌrɛs
आधुनिक	ɑːd̪ʱunik
आविष्कारक	ɑːviʃkɑːrʌk
सहज	sʌɦʌd͡zʱ
किरणपुञ्ज	kirʌɳpuɲd͡zʱ
घण्टी	ɡʱʌɳʈiː
अनुगृहीत	ʌnugriːɦiːt
लुगा	lugɑː
टेबल	ʈɛbʌl
गदा	gʌd̪ɑː
बासिन्दा	bɑːsind̪ɑː
बनेल	bʌnɛl
घुँक्क	ɡʱʌ̃kk
साढु	sɑːd̪ʱu
राष्ट्रबैँक	rɑːʃʈrʌbɑ̃k
भरमग्दुर	bʱʌrmʌgd̪ur
छुल्क	t͡ʃʰulk
फुटबल	fuʈbʌl
एकेक	ɛkɛk
लाजवती	lɑːd͡zʱʌtiː
पालनपोषण	pɑːlʌnpɔːʂʌɳ
ढकमक्क	ɖʌkmʌkk
सारांश	sɑːrɑːnʃ
केटाकेटी	kɛʈɑːkɛʈiː
कुटुम्ब	kuʈumb
सुदूरपश्चिमाञ्चल	sud̪uːrpʌʃt͡ʃimɑːɲt͡ʃʌl
उल्लेखनीय	ullɛkhʌniːjʌ
ज्यादै	d͡zʱjɑːd̪ɑːi
संसाधन	sʌ̃sɑːd̪ʱʌn
दनुवार	d̪ʌnuvɑːr
खलनायक	kʰʌlʌnɑːjʌk
रोजगार	rɔːd͡ʒgɑːr
कुच्चे	kʊt͡ʃt͡ʃe
ढाक्रे	ɖʱɑːkre
अंशदान	ʌ̃ʃdɑːn
कमेन्ट	kʌment
अपेक्षणीय	ʌpekʃʌɳiːjʌ
कन्	kʌn
मान्धाता	mɑːndʱɑːtʌ
चौतारिलो	t͡ʃɔːtɑːrilɔː
सुइँकुच्चा	sʊĩkʊt͡ʃt͡ʃɑː
खौलि	kʰɔːli
जटित	d͡ʒʌʈit
गुठी	gʊʈʰiː
जङ्‍घा	d͡ʒʌŋɡʱɑː
डबल	ɖʌbʌl
चर्क	t͡ʃʌrk
सुरुआत	sʊruɑːt
लुँदो	lʊ̃dɔː
चेप्	t͡ʃep
अप्रेशन	ʌpreʃʌn
कथा	kʌtʰɑː
छपन	t͡ʃʰʌpʌn
क्रमबद्ध	krmʌbʌdʱ
बेइमानी	beɪmɑːniː
विपक्षी	bipʌkʃiː
तीव्रता	tiːbrtɑː
रघुवीर	rʌɡʱʊbiːr
सिनेमा	sineːmɑː
सेनानी	senɑːniː
हडबडी	ɦʌɖbʌɖiː
औदुम्बर	ɔːdʊmbʌr
ऊढ	uːɖʱ
कलाकारिता	kʌlɑːkɑːritʌ
अपस्मार	ʌpsmɑːr
आस्वादक	ɑːswɑːdʌk
शुक्र	ʃʊkr
कप्तान	kʌptɑːn
निम्की	nimkiː
पराल	pʌrɑːl
जबरजस्ती	d͡ʒʌbrd͡ʒʌstiː
विषाद	biʃɑːd
उल्लसित	ʊllʌsit
जगर्सेठ	d͡ʒʌɡʌrsetʰ
पुतली	pʊtʌliː
च्यान्टो	t͡ʃjɑːnʈɔː
सिँगारु	sĩɡɑːru
साध्या	sɑːdʱjɑː
अश्रान्त	ʌʃrɑːnt
उपद्र्याहा	ʊpdʌrjɑːhɑː
कहीं	k ʌ h ĩ
छ्‌वात्लाङ्ङ	t͡ʃʰ w ɑ t̪ l ɑ ŋ ŋ
सबथोक	s ʌ b ʌ t̪ʰ o k
त्रिहत्तर	t̪ r i h ʌ t̪ t̪ ʌ r
ट्रेडिङ	ʈ r e d i ŋ
आङ्ग्ल	ɑ ŋ ɡ l
समाह्‍वान	s ʌ m ɑ h w ɑ n
रिसोर्ट	r i s o r ʈ
सुमित्रा	s u m i t̪ r ɑ
मस्यौदा	m ʌ s j ɔ u d ɑ
एकतन्त्रवादी	e k ʌ t̪ ʌ n t̪ r ʌ b ɑ d i
सुट्ट	s u ʈ ʈ
सजीव	s ʌ d͡ʒ i b
हर	h ʌ r
सितमणि	s i t̪ ʌ m ʌ ɳ i
खोजी	kʰ o d͡ʒ i
गनगनाहट	ɡ ʌ n ɡ ʌ n ɑ h ʈ
फुकुन्डो	pʰ u k u n ɖ o
छप्प	t͡ʃʰ ʌ p p
ज्ञापयिता	d͡ʒ ɲ ɑ p ʌ j i t̪ ɑ
चेप्	t͡ʃ e p
ठूली	ʈʰ u l i
प्रभात	p r ʌ bʱ ɑ t̪
सम्मेलन	s ʌ m m e l ʌ n
सम्झौतापत्र	s ʌ m d͡ʒʱ ɔ u t̪ ɑ p ʌ t̪ r
आयुर्वेदीय	ɑ j u r b e d i j
धारणा	dʱ ɑ r ʌ n ɑ
डगमग	ɖ ʌ ɡ m ʌ ɡ
कर्कट	k ʌ r k ʌ ʈ
उपास्य	u p ɑ s j
पद	p ʌ d
बहिष्कार	b ʌ h i ʂ k ɑ r
डोलाउ	ɖ o l ɑ u
मन्जन	m ʌ n d͡ʒ ʌ n
प्रसिद्धि	p r ʌ s i dʱ i
सवारी	s ʌ b ɑ r i
झुर्र	d͡ʒʱ u r r
टाई	ʈ ɑ i
चेहरा	t͡ʃ e h ʌ r ɑ
जिप्टो	d͡ʒ i p ʈ o
सेक्स	s e k s
भूउपग्रह	bʱ u u p ʌ ɡ r ʌ h
बेहुली	b e h u l i
सत्तारुढ	s ʌ t̪ t̪ ɑ r u ɖʱ
ऊर्ध्वगामी	u r dʱ b ʌ ɡ ɑ m i
पछितो	p ʌ t͡ʃʰ i t̪ o
ठूलाबडा	ʈʰ u l ɑ b ʌ ɖ ɑ
पचपची	p ʌ t͡ʃ p ʌ t͡ʃ i
निकासी	n i k ɑ s i
टेबल	ʈ e b ʌ l
सिँगार	s i ŋ ɡ a r
लिपपोत	l i p ə p o t
उपमान	u p m a n
उर्लिंदो	u r l i n d o
खोप्रो	kʰ o p r o
हाँक्	ɦ ã k
बत्ती	b ə t t i
महिष	m ə ɦ i ʂ
क्लीब	k l i b
उच्च	u t͡ʃ t͡ʃ
ताल्चा	t a l t͡ʃ a
शहर	ʃ ə ɦ ə r
फेट्	pʰ e t
करणीय	k ə r ə n i j ə
कर्‌याम्म	k ə r j a m m
लोकप्रियता	l o k ə p r i j ə t a
राजकुल	r a d͡ʒ k u l
ठमेल	ʈʰ ə m e l
हरफ	ɦ ə r ə pʰ
कुच्चि	k u t͡ʃ t͡ʃ i
सेरा	s e r a
वाक्यविश्लेषण	v a k j ə v i ʃ l e ʂ ə n
भविष्यवाणी	b ə v i ʂ j ə v a n i
कोबी	k o b i
मूल	m u l
आराम	a r a m
बिजुवा	b i d͡ʒ u v a
तरफ	t ə r ə pʰ
आक्षेपक	a k ʂ e p ə k
अनौठोपन	a n o ʈʰ o p ə n
मीठो	m i ʈʰ o
ऊँचो	ũ t͡ʃ o
दुख्	d u kʰ
वीरेन्द्रनगर	v i r e n d r ə n ə ɡ ə r
लाथ्रो	l a ʈʰ r o
खोसेल्	kʰ o s e l
गोजी	ɡ o d͡ʒ i
भगवान	b ə ɡ ə v a n
पाछ्	p a t͡ʃʰ
मुगलान	m u ɡ ə l a n
अमौलिक	a m o l i k
भक्खर	b ə kʰ ə r
अडाउ	a ɖ a u
निजीक्षेत्र	n i d͡ʒ i k ʂ e t r
यान	j a n
किम्बु	k i m b u
हगनगौँडी	ɦ ə ɡ ə n ə ɡ ã ɖ i
वृत्तान्त	v r i t t a n t
टुङ्‍ना	ʈ u ŋ n a
गणेशपुर	ɡ ə n e ʃ ə p u r
फकिर	phakir
सुअवसर	suʌvasar
वनस्पतिशास्त्र	vanaspatiʃastr
आरोप्य	aropj
नक्साल	naksal
नेवार	nevar
नैकाप	naikap
जेतेमेते	jetemete
हाइकु	haiku
हिचकिचाउ	hicakicau
मिल्नु	milnu
पुरेत	puret
दामल१	damal1
पुछार	pucar
बाहु	bahu
भाषण	bhaʃan
बढुवा	baduva
दिशाकुञ्जी	diʃakunji
अहिंस्रक	ahinsrak
छुताहा	cutaha
खरो	kharo
छ्याट्ट	cyatt
डाइनी	daini
वीरगति	virgati
म्याउँ	mjau
बोतो	boto
ब्रह्मा	brahma
गँगरि	gangari
सियाँल	sijal
नेमकिपा	nemkipa
सन्चालन	sancalan
हर्सा	harsa
सिधेनुन	sidenun
गम्भीरता	gambhirata
वनदेवी	vanadevi
रसिद	rasid
जिल	jil
कामधेनु	kamadhenu
अफिम	afim
मध्यनजर	madhjanajar
सोध्	sodh
एकसट्ठी	ekasatthi
चैत्र	citra
एकेक	ekek
अराउ	arau
पृथकता	prithakata
छोप	chop
महाराणा	maharana
अन्तर्ध्वंस	antardhvans
मेधा	medha
वृत्त	v ɾ ɪ t t
घर्ती	ɡʱ ɾ t i
झट्टपट्ट	d͡zʱ ʌ t t ʌ p ʌ t t
आइडल	ɑː i d l
उदाराशय	u d ɑː r ɑː ʃ ʌ j
क्याल्सीयम	k j ɑː l s iː j ʌ m
घडघडे	ɡʱ ʌ d ɡʱ ʌ d e
निदाल	n i d ɑː l
कपासे	k ʌ p ɑː s e
बुकुरा	b u k u r ɑː
छात्रछात्रा	t͡ʃʰ ɑː t r t͡ʃʰ ɑː t r ɑː
चित्रमाला	t͡ʃ i t r m ɑː l ɑː
ड्वाङ्ग्राङ्ङ	ɖʋ ɑː ŋ ɡ r ɑː ŋ ŋ
आनन्दित	ɑː n ʌ n d i t
हिस्सादार	ɦ i s s ɑː d ɑː r
भाकभुक	bʱ ɑː k bʱ u k
अञ्चल	ʌ ɲ t͡ʃ ʌ l
पिताजी	p i t ɑː d͡ʒ iː
भुज	bʱ u d͡ʒ
आदिवासी	ɑː d i v ɑː s iː
निम्की	n i m k iː
च्याँख्ला	t͡ʃ j ɑː ŋ kʰ l ɑː
खाका	kʰ ɑː k ɑː
विकराल	v i k ʌ r ɑː l
एकराते	e k ʌ r ɑː t e
पार्षद	p ɑː r ʃ ʌ d
डवल	ɖ ʌ v ʌ l
आशिष	ɑː ʃ i ʃ
दापा	d ɑː p ɑː
गहते	ɡ ʌ ɦ ʌ t e
जिल्ला	d͡ʒ i l l ɑː
सङ्गीन	s ʌ ŋ g iː n
टेस्ट	ʈ e s ʈ
ओल्ट	o l ʈ
जाँते	d͡ʒ ɑː ŋ t e
आयासकर	ɑː j ɑː s ʌ k ʌ r
दमार	d ʌ m ɑː r
रुप	r u p
कोपिला	k o p i l ɑː
उच्छिन्न	u t͡ʃʰ i n n
भ्रष्टाचार	bʱ r ʌ ʃ ʈ ɑː t͡ʃ ɑː r
अनुन्नत	ʌ n u n n ʌ t
ताली	t ɑː l iː
रोप्	r o p
सिधार्	s i dʱ ɑː r
सानदार	s ɑː n ʌ d ɑː r
झलझल	d͡zʱ ʌ l d͡zʱ ʌ l
अन्भ	ʌ n bʱ
पुलुपुलु	p u l u p u l u
अठहत्तर	ʌ ʈʰ ʌ ɦ ʌ t t ʌ r

    कैदखाना	k aɪ d ə kʰ aː n aː
हर्कबहादुर	h ə r k ə b ə h aː d u r
भारा	bʱ aː r aː
बटुको	b ə ʈ u k o
खारि	kʰ aː r i
ओसि	o s i
ठकठकी	ʈʰ ə k ʈʰ ə k iː
गुणहीन	g u ɳ ə h iː n
लम्मि	l ə m m i
बालाजु	b aː l aː ʤ u
चमचम	t͡ʃ ə m t͡ʃ ə m
कागुनु	k aː g u n u
ज्याम्तो	ʤ j aː m t o
एकत्र	e k ə t r
सालसुल	s aː l s u l
पम्फा	p ə m pʰ aː
अल्पमत	ə l p ə m ə t
मरमरम्मत	m ə r m ə r m ə t
ह्याउ	h j aː u
अङ्खोरा	ə ŋ kʰ o r aː
आँच	aː ɳ t͡ʃ
बोर्डर	b o r ɖ ə r
न्यातपोल	n j aː t ə p o l
कोर्याककोर्याक	k o r j aː k k o r j aː k
अश्रान्त	ə ʃ r aː n t
अतुलनीय	ə t u l n iː j
ज्यास्ता	ʤ j aː s t aː
म्याट्रिक्स	m j aː ʈ r i k s
क्लीब	k l iː b
राजनीति	r aː ʤ n iː t i
दुख्	d u kʰ
कायस्थ	k aː j ə s tʰ
उदीयमान	u d iː j m aː n
आपत	aː p ə t
चुभुर्कि	t͡ʃ u bʱ u r k i
डब्बा	ɖ ə b b aː
हाँगो	h aː ŋ g o
कनकर्नु	k ə n ə k ə r n u
थाम्	tʰ aː m
महतो	m ə h ə t o
अठबा	ə ʈʰ b aː
विशेषण	v i ʃ eː ʂ ə ɳ
टाटा	ʈ aː ʈ aː
जागा	ʤ aː g aː
अनृतवादी	ə n r ɪ t ə v aː d iː
कखौतो	k ə kʰ oʊ t o
वाहवाह	v aː h v aː h
जुनाफ	ʤ u n aː f
क्यापिटल	k j aː p i t ə l
र्‍याल	r j aː l
झाडी	ʤʱɑːɖiː
सप्लाइ	sʌplɑːi
डेरी	ɖeːriː
धूवाँ	ɖʱuːʋɑ̃ː
खोर्‍याउ	kʰoːrjɑːu
बर्मा	bʌrmɑː
भारा	bʱɑːrɑː
खकाल्	kʰʌkɑːl
मसौदा	mʌsɔːdɑː
देखावटी	ɖeːkʰɑːʋʌʈiː
अनुशासित	ʌnʊʃɑːsɪt
एकाह	eːkɑːh
मनसाय	mʌnʌsɑːj
झ्याप्प	ʤʱjɑːpp
कमर्स	kʌmʌrs
अन्तर्त्वचा	ʌntʌrtʋʌtʃɑː
अलौकिक	ʌlɔːkɪk
जाग्राम	ʤɑːgrɑːm
कटाहा	kʌʈɑːhɑː
हिर्काइ	hɪrkɑːi
नागार्जुन	nɑːgɑːrʤʊn
चुरुक्क	tʃʊrʊkk
छलक्क	tʃʰʌlkk
सिँङार	sĩŋɑːr
टक्‍कर	ʈʌkkʌr
डाँड्	ɖɑ̃ːɖ
समाजसेवा	sʌmɑːʤseːʋɑː
फ्वाँक्क	phʋɑ̃ːkk
खराब	kʰʌrɑːb
झिँगटो	ʤʱĩgʌʈoː
पेटिका	pʰeːʈɪkɑː
रुपी	rʊpiː
फतरि	phʌtʌri
धनञ्जय	ɖʱʌnʌɲʤʌj
हलेदो	hʌleːdoː
छलछलती	tʃʰʌltʃʰʌltiː
तौलसमूह	tɔːlsʌmuːh
अर्बुद	ʌrbʊd
नेवार	neːʋɑːr
होमियोपेथी	hoːmijoːpeːtʰiː
घ्न	ɡʱn
सरदार	sʌrdɑːr
ह्वालालाला	hʋɑːlɑːlɑːlɑː
रुक्मिणी	rʊkmɪɳiː
पजेरो	pʌʤeːroː
डिट्ठा	ɖiːʈʰɑː
पट्याउ	pʌʈjɑːu
प्रार्थना	prɑːrʈʰnɑː
कम्ती	kʌmtiː
एकतन्त्रवादी	eːkʌtʌnʈrʋɑːdiː
उच्छेदन	u t͡ʃʰ e d̪ ʌ n
खन्चुरो	kʰ ʌ n t͡ʃ u r o
पिरीपिरी	p i r i p i r i
हाल्लहुल्ल	ɦ ä l l ʌ ɦ u l l ʌ
बढ्	b ʌ d̪ʱ
उत्केन्द्र	u t̪ k e n d̪ r ʌ
विनोदकुमार	b i n o d̪ ʌ k u m ä r
भाक्	bʱ ä k
गुरुपाक	ɡ u r u p ä k
जङ्गे	d͡z ʌ ŋ ɡ e
वैरभाव	b a i r ʌ bʱ ä b
सहज	s ʌ ɦ ʌ d͡z
सम्भोग	s ʌ m bʱ o ɡ
भोजपुर	bʱ o d͡z ʌ p u r
रामपुर	r ä m ʌ p u r
छिरबिरे	t͡ʃʰ i r ʌ b i r e
बुर्की	b u r k i
अर्थसिद्धि	ʌ r t̪ʰ ʌ s i d̪ʱ i
इटा	i ʈ ä
परिवहन	p ʌ r i b ʌ ɦ ʌ n
छिनुवा	t͡ʃʰ i n u b ä
बीजाणु	b i d͡z ä ɳ u
खोइरो	kʰ o i r o
समस्या	s ʌ m ʌ s j ä
कत्थक	k ʌ t̪ʰ ʌ k
विजयोत्सव	b i d͡z ʌ j o t̪ s ʌ b
क्रन्दन	k r ʌ n d̪ ʌ n
मतपत्र	m ʌ t̪ ʌ p ʌ t̪ r ʌ
विचलन	b i t͡ʃ ʌ l ʌ n
उपराष्ट्रपति	u p ʌ r ä s̠ t̪ r ʌ p ʌ t̪ i
परपरि	p ʌ r ʌ p ʌ r i
कस्तो	k ʌ s t̪ o
साफा	s ä f ä
कोदो	k o d̪ o
गुहार	ɡ u ɦ ä r
ओल्छि	o l t͡ʃʰ i
पाउडर	p ä u̯ d̪ ʌ r
तोबा	t̪ o b ä
अनपाम्मे	ʌ n ʌ p ä m m e
कज्याउ	k ʌ d͡z j ä u
डल्लेँठो	ɖ ʌ l l ẽ ʈʰ o
चपेटा	t͡ʃ ʌ p e ʈ ä
जडाउ	d͡z ʌ ɖ ä u
सर्वनाम	s ʌ r b ʌ n ä m
भ्वाँक	bʱ ʋ ä̃ k
पिता	p i t̪ ä
विशेषण	b i ʃ e s̠ ʌ n
टेक्	ʈ e k
जेता	d͡z e t̪ ä
चाट्	t͡ʃ ä ʈ
अवतीर्ण	ʌ ʋ ʌ t̪ i r ɳ
सुलसुल	s u l s u l
लोहनी	l o ɦ n i
बटुको	b ʌ ʈ u k o
न्यातपोल	n j ä t̪ p o l
बत्तीस	b ʌ t̪ t̪ i s
झेली	d͡zʱ e l i
ड्रामा	ɖ r ä m ä
संयोजन	s ʌ̃ j o d͡z ʌ n
कन्धनी	k ʌ n̪ d̪ʱ n i
इमारत	i m ä r ʌ t̪
अदलबदल	ʌ d̪ l b ʌ d̪ l
घनश्याम	ɡʱ ʌ n̪ ʃ j ä m
सेवक	s e ʋ ʌ k
उलामाला	u l ä m ä l ä
बैसठ्ठी	b ä i s ʌ t̪ʰ i
सारुप्य	s ä r u p j
मोटरसाइकल	m o ʈ ʌ r s ä i k ʌ l
अन्तर्विरोध	ʌ n̪ t̪ ʌ r ʋ i r o d̪ʱ
पहुँचकुञ्जी	p ʌ ɦ ũ̯ t͡ʃ k u ɲ d͡z i
तमाखु	t̪ ʌ m ä kʰ u
कुटुम्ब	k u ʈ u m b
विखण्डन	ʋ i kʰ ʌ n̪ ɖ ʌ n
रानीे	r ä n i e
चेहरा	t͡ʃ e ɦ ʌ r ä
लोकगाथा	l o k ʌ ɡ ä t̪ʰ ä
चयनशील	t͡ʃ ʌ j ʌ n ʃ i l
गर्माउ	ɡ ʌ r m ä u
किफाएति	k i pʰ ä e t̪ i
यगण	j ʌ ɡ ʌ ɳ
बनेपा	b ʌ n e p ä
कार्यदल	k ä r j ʌ d̪ ʌ l
शौरसेन	ʃ a u r ʌ s e n
उत्प्रेक्षक	u t̪ p r e k ʃ ʌ k
बिहिबार	b i ɦ i b ä r
अच्छिन्न	ʌ t͡ʃʰ i n̪ n
सुर्क	s u r ʌ k
वाक्यगठन	ʋ ä k j ʌ ɡ ʌ t̪ʰ ʌ n
सतिसाल	s ʌ t̪ i s ä l
झङ्कारित	d͡zʱ ʌ ŋ k ä r i t̪
स्वर्ग	s ʋ ʌ r ɡ
बित्थै	b i t̪ʰ t̪ʰ ä i
रुपा	r u p ä
पुस	p u s
उच्छन्न	u t͡ʃʰ ʌ n̪ n
क्रमबद्ध	k r ʌ m b ʌ d̪ʱ
अजङ	ʌ d͡z ʌ ŋ
तत्पश्चात्	t̪ ʌ t̪ p ʌ ʃ t̪ ä t̪
अपरिणामी	ʌ p ʌ r i ɳ ä m i
लेखपढ	l e kʰ p ʌ ɖ
आलस्य	ɑːləsʌ
आङ्गारिक	ɑːŋɡɑːrik
एकगेडे	ekəɡeɖe
धानबाली	ɖʌːnəbɑːliː
ढिम्री	ɖʰimriː
चौटा	t͡ʃɔːʈɑː
यता	jətɑː
छ्याप	t͡ʃʰjɑːp
ब्वाइज	bʋɑːid͡z
अनुन्मुक्त	ənunmukt
जाम्‍बवान	jɑːmbʋɑːn
आनाकानी	ɑːnɑːkɑːniː
दुनो	duno
पार्टी	pɑːrʈiː
पुस	pus
बेकाम	beːkɑːm
आनीबानी	ɑːniːbɑːniː
धर्ता	ɖʰərtɑː
झ्याप्प	d͡ʒʰjɑːpː
विनोदकुमार	ʋinodkumɑːr
डिपोट	ɖipoʈ
गिर्खा	ɡirkʰɑː
सङ्काय	səŋkɑːj
टोप्रो	ʈopro
करकरे	kərəkəre
फुल्लाउ	phullɑːu
रुक्मिणी	rʊkmɪɳiː
पक्राउ	pəkrɑːu
अवाञ्छनीय	əʋɑːɲt͡ʃʰəniːj
निपर्सि	nipərsi
उत्तरदाता	ʊttərdɑːtɑː
अठहत्तर	əʈʰəʈʰər
मुख्यालय	mʊkʰjɑːləj
रुझ्	rʊd͡ʒʰ
लेस्	leːs
चयनशील	t͡ʃəjənʃiːl
गर्भे	ɡərbʰe
सट्क	səʈk
कण	kəɳ
कोको	koko
गूढ	ɡuːɖʰ
पक्कु	pəkːu
मटक्क	məʈkː
बेहुली	beːhuliː
भरोसा	bʰərosɑː
कुक्रुक्क	kʊkrʊkː
मरिच	mərit͡ʃ
जब	jəb
लोति	loti
फलाक्	phlɑːk

    अफलाइन	ʌ pʰ l ɑː i n
असन्तोकी	ʌ s ʌ n t̪ oː k iː
अँठ्याउ	ʌ̃ ʈʰ j ɑː u
ग्रन्थ	ɡ r ʌ n t̪ʰ
जुरे	d͡ʒ u r eː
अगणनीय	ʌ ɡ ʌ ɳ ʌ n iː j ʌ
टुप्पो	ʈ u p p oː
फुस्रो	pʰ u s r oː
बढुवा	b ʌ ɖʱ u w ʌː
हामी	ɦ ɑː m iː
धर्सो	d̪ʱ ʌ r s oː
चटक	t͡ʃ ʌ ʈ ʌ k
करेट्	k ʌ r eː ʈ
बाहुनी	b ɑː ɦ u n iː
फुटबल	pʰ u ʈ b ʌ l
महासन्धि	m ʌ ɦ ɑː s ʌ n d̪ʱ i
छलित	t͡ʃʰ ʌ l i t̪
हिनामिना	ɦ i n ɑː m i n ɑː
छन्देइलो	t͡ʃʰ ʌ n d̪ eː i l oː
जोरो	d͡ʒ oː r oː
वज्राचार्य	w ʌ d͡ʒ r ɑː t͡ʃ ɑː r j ʌ
गहत	ɡ ʌ ɦ ʌ t̪
पुरिया	p u r iː j ʌː
अतृप्ति	ʌ t̪ r ʌ p t̪ i
चैत्र	t͡ʃ ɑː i t̪ r
छुरो	t͡ʃʰ u r oː
आभ्यन्तरिक	ɑː bʱ j ʌ n t̪ ʌ r i k
सुट्ट	s u ʈ ʈ
लिगलिगे	l i ɡ ʌ l i ɡ eː
चक्राङ्कित	t͡ʃ ʌ k r ɑː ŋ k i t̪
गुठी	ɡ u ʈʰ iː
पिरपिर	p i r ʌ p i r
साहा	s ɑː ɦ ʌː
वाञ्छना	w ɑː ɲ t͡ʃʰ ʌ n ʌː
औस्या	ʌ u s j ʌː
चट्याङ्ग	t͡ʃ ʌ ʈ j ɑː ŋ ɡ
लुटि	l u ʈ i
समेट्	s ʌ m eː ʈ
हिमगिरि	ɦ i m ʌ ɡ i r i
असफलता	ʌ s ʌ pʰ ʌ l ʌ t̪ ʌː
सिप्किनु	s i p k i n u
सङ्गठन	s ʌ ŋ ɡ ʌ ʈʰ ʌ n
सपेटो	s ʌ p eː ʈ oː
चोरऔंले	t͡ʃ oː r ʌ̃ u l eː
टुकटुकती	ʈ u k ʌ ʈ u k ʌ t̪ iː
कलङ्की	k ʌ l ʌ ŋ k iː
कुहिरे	k u ɦ i r eː
पाडी	p ɑː ɖ iː
असहन	ʌ s ʌ ɦ ʌ n
पृष्ठसाइज	p r ʌ ʂ ʈʰ s ɑː i d͡ʒ
ढक	ɖʱʌk
शहर	ʃʌɦʌr
कुरूप	kʊrʊp
ट्रस्ट	ʈrʌsʈ
जफत	ʤʌfʌt
बुर्की	bʊrkɪ
वाच्य	vɑːt͡ʃjʌ
निमित्त	nɪmɪtː
भावक	bʱɑːvʌk
जलुवा	ʤʌlʊvɑː
कप्तान	kʌptɑːn
एकजाति	ekʌʤɑːtɪ
युगौँ	jʊɡɔ̃
बछेडा-बछेडी	bʌt͡ʃʰeɖɑː-bʌt͡ʃʰeɖɪ
अभिव्यक्ति	ʌbʱɪvʌjʌktɪ
कुन	kʊn
टठिलो	ʈʌʈʰɪlo
चमचम	t͡ʃʌmt͡ʃʌm
कब्जियत	kʌbʒɪjʌt
चन्दने	t͡ʃʌndʌne
केर्	kʌr
वर्णपट	vʌrɳʌpʌʈ
टेस्ट	ʈesʈ
पिँढी	pɪ̃ɖɪ
हामी	ɦɑːmɪ
धारणा	ɖʱɑːrʌnɑː
कथञ्चित्	kʌtʰʌɲt͡ʃɪt
मौजुदा	mɔːʤʊdʌ
सड्क	sʌɖk
झन्क	ʤʌnk
ताउलो	tɑːʊlo
विवश	vɪvʌʃ
भड्खालो	bʱʌɖkʰɑːlo
भल्भ	bʱʌlbʱ
परिपाठ	pʌrɪpɑːʈʰ
नेमकिपा	nemʌkɪpɑː
अट्टालिका	ʌʈʈɑːlɪkɑː
नागेश	nɑːɡeʃ
बाण	bɑːɳ
गुत्थि	ɡʊtʰtʰɪ
फ्रेमसेट	pʰremset
ज्यान	ʤʌɑːn
पत्रकारिता	pʌtrʌkɑːrɪtɑː
थपक्क	tʰʌpkʌk
आँक	ɑ̃k
ढिस्को	ɖʱɪsko
होमाइ	ɦomɑːɪ
वसन्तपञ्चमी	vʌsʌntʌpʌɲt͡ʃmɪ
औलो	ɔːlo
बहत्तर	bʌɦʌttʌr
विभ्रम	v i bʱ r ʌ m
उपवक्ता	u pʌ v ʌ k t̪ ä
सर्जक	s ʌ r d͡ʒ ʌ k
अत्यास	ʌ t̪ j ä s
पसल	p ʌ s ʌ l
खैँच	kʰ ʌ̃ t͡ʃ
सेलफोन	s e l ʌ pʰ o n
समर	s ʌ m ʌ r
निलुम्बा	n i l u m b ä
धनुर्धर	dʱ ʌ n u r dʱ ʌ r
चलुवा	t͡ʃ ʌ l u w ä
बर्खा	b ʌ r kʰ ä
विराजमान	v i r ä d͡ʒ m ä n
तुलजा	t̪ u l d͡ʒ ä
भुत्ला	bʱ u t̪ l ä
समादर	s ʌ m ä d ʌ r
निराश	n i r ä ʃ
गिगाबाइट	ɡ i ɡ ä b ä i t̪
सुमर्	s u m ʌ r
उमार्	u m ä r
प्रेक्षा	p r e k ʃ ä
व्याख्याता	v j ä kʰ j ä t̪ ä
विवश	v i w ʌ ʃ
रकेट	r ʌ k e t̪
मन्त्रिपरिषद	m ʌ n t̪ r i p ʌ r i ʃ ʌ d
मिल्नु	m i l n u
विपक्षी	v i p ʌ k ʃ i
कोटे	k o t̪ e
सिन्धु	s i n dʱ u
दिलाउ	d i l ä u
अवहेलन	ʌ w ʌ ɦ e l ʌ n
अश्वशक्ति	ʌ ʃ w ʌ ʃ ʌ k t̪ i
सैलुङ	s ä i l u ŋ
म्लेच्‍छ	m l e t͡ʃ ʌ
तौलसमूह	t̪ ä u l s ʌ m u ɦ
चेप्	t͡ʃ e p
कट्टरपन्थी	k ʌ t̪ t̪ ʌ r p ʌ n t̪ʰ i
फ्रेमसेट	pʰ r e m s e t̪
घुलित	ɡʱ u l i t̪
कीर्तिशाली	k i r t̪ i ʃ ä l i
बिलौनी	b i l ä u n i
अङ्खोरा	ʌ ŋ kʰ o r ä
चर्चित	t͡ʃ ʌ r t͡ʃ i t̪
थुप्रो	t̪ʰ u p r o
निमठ्	n i m ʌ t̪ʰ
छ्‌वात्त	t͡ʃʰ w ä t̪ t̪
कालु	k ä l u
टेलिभिजन	t̪ e l i bʱ i d͡ʒ ʌ n
रेग्मी	r e ɡ m i
विरही	v i r ʌ ɦ i
अश्रान्त	ʌ ʃ r ɑː n t
घोप्	ɡʱ o p
क्यारेक्टर	k j ɑː r e k t ʌ r
खेप्	kʰ e p
धर्मशास्त्र	dʱ ʌ r m ʃ ɑː s t r
क्वाइँक्वाइँ	k w ɑː ĩ k w ɑː ĩ
तदपि	t ʌ d ʌ p i
सम्प्रति	s ʌ m p r ʌ t i
सपाट	s ʌ p ɑː t
उफर्पाफर	u pʰ ʌ r p ɑː pʰ ʌ r
तार्	t ɑː r
धरौटी	dʱ ʌ r ɔː t iː
इथर	i tʰ ʌ r
राष्ट्रबैँक	r ɑː ʃ t r ʌ b æ̃ k
निदाउ	n i d ɑː u
उदाराशय	u d ɑː r ɑː ʃ ʌ j
महिष	m ʌ ɦ i ʃ
प्रेमकथा	p r e m k ʌ tʰ ɑː
असहयोग	ʌ s ʌ ɦ j o ɡ
अभागी	ʌ bʱ ɑː ɡ iː
बिलौना	b i l ɔː n ɑː
उनान्नब्बे	u n ɑː n n ʌ b b e
बालाजु	b ɑː l ɑː d͡ʒ u
विधायक	b i dʱ ɑː j ʌ k
मालश्री	m ɑː l ʃ r iː
तुलजा	t u l d͡ʒ ɑː
ह्नेदिक	ɦ n e d i k
अविकल	ʌ b i k ʌ l
सुशीला	s u ʃ iː l ɑː
गिरफ्तार	ɡ i r pʰ t ɑː r
जोरो	d͡ʒ o r o
टपरे	t ʌ p ʌ r e
मर्का	m ʌ r k ɑː
सरी	s ʌ r iː
आत्मसम्मान	ɑː t m ʌ s ʌ m m ɑː n
गुरुपाक	ɡ u r u p ɑː k
आसत्ति	ɑː s ʌ t t i
लुटि	l u t i
गुल्ट	ɡ u l t
हायहाय	ɦ ɑː j ɦ ɑː j
पातो	p ɑː t o
बैङ्कक	b æ̃ ŋ k ʌ k
लीलाम	l iː l ɑː m
रुढी	r u dʱ iː
पराल	p ʌ r ɑː l
उतर्सि	u t ʌ r s i
वरदान	b ʌ r d ɑː n
छमछमिलो	t͡ʃʰ ʌ m t͡ʃʰ ʌ m i l o
चिरस्मरणीय	t͡ʃ i r ʌ s m ʌ r ʌ n iː j
गदा	ɡ ʌ d ɑː
कम्युनिस्ट	k ʌ m j u n i s ʈ
नागार्जुन	n ɑː g ɑː r d͡ʒ u n
घोक्	ɡʱ o k
मुसल	m u s ʌ l
स्वतन्त्र	s ʋ ʌ t ʌ n t̪ r
मुख्तियार	m u kʰ t̪ i j ɑː r
आदिष्ट	ɑː d̪ i ʂ ʈ
बुरुण्डी	b u r u ɳ ɖ iː
चुक्कि	t͡ʃ u k k i
अन्तर्विकास	ʌ n t̪ ʌ r ʋ i k ɑː s
फ्यासफ्यास	pʰ j ɑː s pʰ j ɑː s
मोजा	m o d͡ʒ ɑː
कास्की	k ɑː s k iː
झुर्र	d͡ʒʱ u r r
बिलायत	b i l ɑː j ʌ t̪
परापूर्व	p ʌ r ɑː p uː r ʋ
ऐँचाताना	ɑː ĩ t͡ʃ ɑː t̪ ɑː n ɑː
खर्ल्याङखुट्टी	kʰ ʌ r l j ɑː ŋ kʰ u ʈ ʈ iː
जीवनकाल	d͡ʒ iː ʋ ʌ n k ɑː l
ओट्	o ʈ
जितुवा	d͡ʒ i t̪ u ʋ ɑː
वर्णन	ʋ ʌ r ɳ ʌ n
तुइन	t̪ u i n
कान्तिमान्	k ɑː n t̪ i m ɑː n
गेरवशाली	ɡ e r ʋ ʌ ʂ ɑː l iː
दुर्व्यवहार	d̪ u r ʋ j ʌ ʋ ʌ ɦ ɑː r
धाई	d̪ʱ ɑː i
वेदान्त	ʋ e d̪ ɑː n t̪
लखन	l ʌ kʰ ʌ n
ड्वाङङ्वाङ	ɖ ʋ ɑː ŋ ɡ ʋ ɑː ŋ
तथा	t̪ ʌ t̪ʰ ɑː
अगणित	ʌ ɡ ʌ ɳ i t̪
खोर्‍याउ	kʰ o r j ɑː u
मनिटर	m ʌ n i ʈ ʌ r
बेथे	b e t̪ʰ e
डब्बा	ɖ ʌ b b ɑː
ठिङ्ग	ʈʰ i ŋ ɡ
कीटाणुनाशक	k iː ʈ ɑː ɳ u n ɑː ʂ ʌ k
डाकिनी	ɖ ɑː k i n iː
उल्टाइ	u l ʈ ɑː i
विद्यमान	ʋ i d̪ j ʌ m ɑː n
दुर्गादास	d̪ u r ɡ ɑː d̪ ɑː s
बाती	b ɑː t̪ i
कौवाली	k ɔː ʋ ɑː l iː
खुलुल्ल	kʰ u l u l l
एकुन्टा	e k u n ʈ ɑː
पाथी	p ɑː t̪ʰ i
मेरु	m e r u
लता	l ʌ t̪ ɑː
अविलय	ʌ ʋ i l ʌ j

    प्रोत्साहन	p ɾ o t̪ s ä ɦ ʌ n
कलाबत्तु	k ʌ l ä b ʌ t̪ t̪ u
दनदन	d̪ ʌ n ʌ d̪ ʌ n
सन्ठी	s ʌ n t̪ʰ i
शहर	ʃ ʌ ɦ ʌ r
वनसाङ्लो	b ʌ n ʌ s ä ŋ l o
पुछार	p u t͡ʃʰ ä ɾ
आश्रमवासी	ä ʃ ɾ ʌ m b ä s i
बान्की	b ä n k i
आत्मपरक	ä ʈ m ʌ p ʌ r ʌ k
सुलसुल	s u l ʌ s u l
अनत	ʌ n ʌ t̪
विष्फोट	b i ʂ pʰ o ʈ
कालोनीलो	k ä l o n i l o
असहयोग	ʌ s ʌ ɦ ʌ j o ɡ
आर्जे	ä r d͡ʒ e
झर्को	d͡zʱ ʌ r k o
सिलाबर	s i l ä b ʌ r
तागत	t̪ ä ɡ ʌ t̪
हर	ɦ ʌ r
आङ्ग्ल	ä ŋ ɡ l
अभिलक्षण	ʌ b ɦ i l ʌ kʃ ʌ n
नेट	n e ʈ
ठमेल	ʈʰ ʌ m e l
निशान	n i ʃ ä n
रापि	r ä p i
कपिल	k ʌ p i l
अजनबी	ʌ d͡ʒ ʌ n ʌ b i
गृष्म	ɡ ɾ i ʃ m
ज्ञ	d͡ʒ ʌ̃
सालनाल	s ä l n ä l
बिन्	b i n
थैली	t̪ʰ ä i l i
रेल्वे	r e l b e
उचाइ	u t͡ʃʰ ä i
जर्याक्क	d͡ʒ ʌ r j ä k k
झुर्र	d͡zʱ u r r
अनेकार्थी	ʌ n e k ä r t̪ʰ i
लमिलस्ट	l ʌ m i l ʌ s ʈ
विशृङ्खलता	b i ʃ ɾ i ŋ kʰ ʌ l ʌ t̪ ä
वज्राचार्य	b ʌ d͡ʒ r ä t͡ʃʰ ä r j
डिबडिब	ɖ i b ɖ i b
टाई	ʈ ä i
धनुर्धर	d̪ʱ ʌ n u r d̪ʱ ʌ r
एकस्व	e k ʌ s b
बौलाउ	b ä u l ä u
बीबीसी	b i b i s i
राधेश्याम	r ä d̪ʱ e ʃ j ä m
बैल	b ä i l
उन्नायक	u n n ä j ʌ k
माधव	mɑːdʱʌʋ
गायब	ɡɑːjʌb
भरोसा	bʱʌrosɑː
राडार	rɑːɖɑːr
कविहृदय	kʌʋihɾidʌj
घोप्	ɡʱoʊp
भरिभन्ड	bʱʌribʱʌnɖ
एकसट्ठीऔं	ekʌsʌʈʈʰiːɔ̃
बोली	boliː
प्रभा	prʌbʱɑː
अर्थदण्ड	ʌrtʰʌɖʌnɖ
प्रेमकथा	preːmkʌtʰɑː
उकाली	ukɑːliː
झटारो	d͡ʒʰʌʈɑːro
कायदा	kɑːjʌdʌ
जैले	d͡ʒaile
वाहवाह	wɑːhwɑːh
भलभल	bʱʌlbʱʌl
वस्तुत:	ʋʌstut
अनत	ʌnʌt
तिलहरी	tɪlʌhʌriː
पहिरन	pʌhirʌn
च्यापु	t͡ʃjɑːpu
भान्से	bʱɑːnse
उछिल्ल्याहा	uʧʰɪlljɑːhɑː
दिशाकुञ्जी	dɪʃɑːkʊɲd͡ʒiː
झटाझटी	d͡ʒʰʌʈɑːd͡ʒʰʌʈiː
पेड	ped
सुल्ल	sʊll
उधुम	udʰʊm
उन्मूलन	unmuːlʌn
डिनर	ɖɪnʌr
चौबर	t͡ʃɔːbʌr
उनान्नब्बे	unɑːnnʌbbe
नस	nʌs
लहना	lʌhʌnʌ
फकिर	pʰʌkɪr
धपेड्	dʰʌped
बैगुन	baɪgʊn
कर्तृक	kʌrtɾʊk
मधौरु	mʌdʱɔːru
हिउँचितुवा	hiːũʧɪtʊʋɑː
एत्तेरी	ettʌriː
घोटाला	ɡʱoʈɑːlɑː
आशाकारी	ɑːʃɑːkɑːriː
एकतन्त्रवादी	ekʌtʌnʈrʌʋɑːdiː
उन्मत्तलिङ्गी	unmʌttʌliŋgiː
बिजाइँ	bid͡ʒɑːĩ
जम्कि	d͡ʒʌmki
मनुज	mʌnʊd͡ʒ
हात-हालाहाल	ɦaːt̪ ɦaːlaːɦaːl
धादिङ	d̪ʱaːd̪iŋ
झिँगो	d͡zʱiŋɡo
छताछुल्ल	t͡sʰʌtaːt͡sʰʊlː
कार्यदल	kaːɾjad̪al
पोखरी	poːkʰaɾiː
टकराउ	ʈʌkʌɾaːʊ
घरबारी	ɡʱʌɾbaːɾiː
गिर्खा	ɡiɾkʰaː
खान्की	kʰaːŋkiː
टेक	ʈeːk
ललकार्	lʌlʌkaːɾ
सुरेन्द्र	sʊɾeːnd̪ɾʌ
आरिस	aːɾis
सञ्चालिका	saɲt͡sʰaːlikaː
खाम	kʰaːm
मार्फत	maːɾpʰʌt̪
छोटी	t͡sʰoːʈiː
थुतुनो	t̪ʰʊt̪ʊno
गोर्खाली	ɡoːɾkʰaːliː
असभ्यपन	ʌsʌbʱjʌpʌn
पिठ्युँ	pit̪ʰju
इमानदार	iːmaːndaːɾ
सामुन्ने	saːmʊnːe
श्यार्पा	ɕjaːɾpaː
खुसहाल	kʰʊsʌɦaːl
शङ्कु	ɕaŋkʊ
अचर	ʌt͡sʌɾ
उत्कर्षी	ʊt̪kʌɾʃiː
मिजासी	mid͡zjaːsiː
बढिया	bʌɖʱijaː
सन्ठी	sʌnt̪ʰiː
प्रालेख	pɾaːleːkʰ
लेस्	leːs
मासु	maːsʊ
लोकगाथा	loːkʌɡaːt̪ʰaː
अर्गला	ʌɾɡʌlaː
किताब	kit̪aːb
वास्तुविद	ʋaːst̪ʊʋid̪
तुर्लुङ	t̪ʊɾlʊŋ
विनोदकुमार	ʋinoːd̪ʌkʊmaːɾ
उज्ज्वलित	ʊd͡zʲʋʌlit̪
ऐयासी	aijaːsiː
लिखु	likʰʊ
शतश:	ɕʌt̪ʌɕ
रचनाकार	ɾʌt͡sʌnaːkaːɾ
दुर्दशा	d̪ʊɾd̪ʌɕaː
हुम्ला	ɦʊmlaː
सुइँकुच्चा	sʊiŋkʊt͡sʰaː
सिलाबर	silaːbʌɾ
विष	v i ʂ
क्षेत्री	k ʂ e t̪ r i
वाक्यरचना	v ɑː k j ə r ə t͡ʃ ə n ɑː
खाद्यपदार्थ	kʰ ɑː d j ə p ə d ɑː r t̪ʰ
पहिलो	p ə ɦ i l o
थपड	t̪ʰ ə p ə d̪
कलजिभ्रे	k ə l ə d͡ʒ i bʱ r e
बिहिबार	b i ɦ i b ɑː r
इस्लामावाद	i s l ɑː m ɑː v ɑː d
हिमनदी	ɦ i m ə n ə d iː
नेशनल	n e ʂ ə n ə l
खुलदुली	kʰ u l ə d u l i
अर्धजीवन	ə r dʱ ə d͡ʒ iː v ə n
विश्वबैँक	v i ʂ ʋ ə b ɑː i̯ ŋ k
गिद्धे	ɡ i d̪ʱ e
बगाल	b ə ɡ ɑː l
जरुर	d͡ʒ ə r u r
बेन्च	b e n t͡ʃ
चमकदार	t͡ʃ ə m ə k ə d ɑː r
बोको	b o k o
अक्षांश	ə k ʂ ɑː ̃ ʃ
गमनीय	ɡ ə m ə n i j ə
सिक्	s i k
फगटो	pʰ ə ɡ ə t̪ o
एक्काईस	e k k ɑː iː s
पोर्तगाल	p o r t̪ ə ɡ ɑː l
छुवाछुत	t͡ʃʰ u v ɑː t͡ʃʰ u t̪
झुल्कि	d͡ʒʱ u l k i
उद्‌बोधक	u d b o d̪ʱ ə k
तर्स	t̪ ə r s
झाङ	d͡ʒʱ ɑː ŋ
लुइँलुइँ	l u i̯ ŋ l u i̯ ŋ
कुँढ्	k ũ ɖʱ
अमङ्गलकारी	ə m ə ŋ ɡ ə l ə k ɑː r i
अर्घौतो	ə r ɡʱ ɔː t̪ o
एकेक	e k e k
आम्खोरा	ɑː m kʰ o r ɑː
भक्तिमान	bʱ ə k t̪ i m ɑː n
दुवाकोट	d u v ɑː k o t̪
पद	p ə d̪
तरखर	t̪ ə r ə kʰ ə r
वेदान्त	v e d ɑː n t̪
रेलिङ	r e l i ŋ
चुकुल	t͡ʃ u k u l
बल्ड्याङ्ङ	b ə l ɖ j ɑː ŋ ŋ
मिर्गौला	m i r ɡ ɔː l ɑː
उकास्	u k ɑː s
लडाक	l ə d ɑː k
कर्कि	k ə r k i
झ्यालखाना	d͡ʒʱ j ɑː l kʰ ɑː n ɑː
हाइकु	ɦaiku
पन्याइ	pɐnjɑi
घोरल	ɡʱɔɾɐl
अवहेलन	ɐʋɐɦeːlɐn
चतुस्सूत्री	t͡ʃɐt̪ussuːt̪ɾiː
छिरबिरे	t͡ʃɪɾbɪɾe
घेरा	ɡʱeɾɐ
प्रशंसापत्र	pɾɐʃɐ̃saːpɐt̪ɾ
मोचन	mot͡ʃɐn
पेय	pej
चुक	t͡ʃʊk
अधर	ɐd̪ʱɐɾ
विश्लेषण	ʋɪʃleːʃɐ̃
खपुवा	kʰɐpuʋaː
उँधो	ũd̪ʱo
लाम्पाटो	laːmpaːʈo
मतभेद	mɐt̪bʱed̪
ग्याँचे	ɡjãt͡ʃe
मुसलमान	mʊsɐlmaːn
उफर्पाफर	upʰɐɾpaːpʰɐɾ
बुधुना	bʊd̪ʱʊnaː
चुक्लीखोर	t͡ʃʊkliːkʰoɾ
लपेटो	lɐpeʈo
मञ्च	mɐɲt͡ʃ
सगण	sɐɡɐ̃
गुणहीन	ɡʊɳɦiːn
मयूर	mɐjuːɾ
मथल्	mɐt̪ʰl
पाउरोटी	paːʊɾoʈiː
विख्याति	ʋɪkʰjaːt̪i
अट्टालिका	ɐʈʈaːlikaː
सङ्ल	sɐŋl
चर्	t͡ʃɐɾ
सड्क	sɐɖk
नक्साल	nɐksaːl
डेटाबेस	ɖeːʈaːbes
कण	kɐɳ
उपज	upɐd͡ʒ
उचित	ut͡ʃɪt̪
किलोग्राम	kɪloɡɾaːm
जीवत्‌पतिका	d͡ʒiːʋɐt̪pɐt̪ikaː
कठपाइले	kɐʈʰpaːile
कागत	kaːɡɐt̪
यता	jɐt̪aː
सद्‌गुरु	sɐd̪ɡʊɾʊ
कलहप्रिय	kɐlɐɦpɾɪj
वक्र	ʋɐkɾ
चित्रमाला	t͡ʃɪt̪ɾmaːlaː
सिनेमा	sɪneːmaː
सुकुटे	sʊkuʈe
हे	ɦe
अक्षरात्मक	ʌkʃʌrɑːtmʌk
सदासर्वदा	sʌdɑːsʌrvʌdɑː
भक्तिमान	bʱʌktimɑːn
कर्णपट	kʌrɳʌpʌʈ
सुदूरपश्चिमाञ्चल	sud̪uːrʌpʌʃt͡ʃimɑːɲt͡ʃʌl
शोक	ʃoːk
रौतहट	rɔːtʌhʌʈ
अनुष्ठित	ʌnusʈʰit
झुरुमुरु	d͡ʒʰurumuru
आकस्मिक	ɑːkʌsmik
उबार्	ubɑːr
गित	git
सतराज	sʌtʌrɑːd͡ʒ
गुत्थि	gutʰtʰi
अपुत	ʌput
बिट	bit
सिम्टा	simʈʌ
हिचकिचाउ	ɦit͡ʃkikit͡ʃɑːu
छेदी	t͡ʃʰed̪i
चासोपर्दो	t͡ʃɑːsopʌrd̪o
थेग्	tʰeg
काँइयो	kɑːɲijo
बनारस	bʌnɑːrʌs
लपेटो	lʌpet̪o
आयुक्त	ɑːjukt
लक्ष	lʌkʃ
आधुनिक	ɑːd̪ʰunik
डुम्री	ɖumriː
पञ्चायत	pʌɲt͡ʃɑːjʌt
सत्कर्म	sʌtkʌrm
सराप्	sʌrɑːp
दङ्गा	d̪ʌŋgɑː
लडाक	lʌɖɑːk
छताछुल्ल	t͡ʃʰʌt̪ɑːt͡ʃʰull
दन्को	d̪ʌnko
लेखापरीक्षण	lekʰɑːpʌriːkʃʌn
गँगरि	gɑːŋgʌri
द्रब्यशाह	d̪rʌbjʌʃɑːɦ
कुस्ती	kustiː
अङ्गीकृत	ʌŋgikrit
अविदित	ʌvid̪it
खपटि	kʰʌpʌʈi
अपुङ्गी	ʌpuŋgi
भवन	bʱʌvʌn
अनुत्पादक	ʌnut̪pɑːd̪ʌk
खैराँत	kʰirɑːnt
बबरमहल	bʌbʌrmʌɦʌl
राह	rɑːɦ
बोरा	borɑː
द्वित्व	d̪ʋit̪ʋ
अक्वेरीअम	ʌkʋeɾiʌm
विद्यार्जन	ʋid̪jɑːɾd͡ʒʌn
सुरेन्द्र	suɾend̪ɾʌ
मौजेनी	mɔːd͡ʒeniː
आश्रमवासी	ɑːʃɾʌmʋɑːsiː
स्वाइँस्वाइँती	sʋɑːĩsʋɑːĩtiː
विश्रामालय	ʋiʃɾɑːmɑːlʌj
सिध्रा	sid̪ʱɾɑː
सिप्किनु	sipkinu
उध्र	uʈʰɾ
रिङ्	ɾiŋ
तिथि	t̪it̪ʰi
चेन्ज	t͡ʃend͡ʒ
वायुदेवता	ʋɑːjud̪eʋʌt̪ɑː
आदिवासी	ɑːd̪iʋɑːsiː
कुस्ती	kust̪iː
होल्डर	ɦoːlʈʰʌɾ
ढक्क	ʈʰʌkː
रुद्राक्ष	ɾud̪ɾɑːkʃ
मुर्छा	murʈʰʃɑː
कोबी	kobiː
गर्भपाती	ɡʌrbʱpɑːt̪iː
पुरा	purɑː
कट्टर	kʌʈʈʌɾ
लतलती	lʌt̪lʌt̪iː
जटे	d͡ʒʌʈe
झिम्रे	d͡ʒʱimɾe
सोलि	soːli
खप्की	kʰʌpkʰiː
कनकर्नु	kʌnʌkʌɾnu
खानपान	kʰɑːnʌpɑːn
औषधाश्रित	ɔːʂʌd̪ʱɑːʃɾit̪
मथुरा	mʌt̪ʰurɑː
अविचलित	ʌʋit͡ʃʌlit̪
अश्‌लील	ʌʃliːl
प्रसन्न	pɾʌsʌnː
वाच्य	ʋɑːt͡ʃjʌ
निदाउ	nid̪ɑːu
शिरीष	ʃiɾiːʃ
ठेक्‍का	ʈʰekːɑː
रुवाइ	ɾuʋɑːi
उपहारक	upʌɦɑːɾʌk
कन्	kʌn
अनूढा	ʌnuːʈʰɑː
मदिरा	mʌd̪iɾɑː
फुटबल	pʰuʈʰbʌl
अध्ययन	ʌd̪ʱjʌjʌn
जबरा	d͡ʒʌbʌɾɑː
पराग	pʌɾɑːɡ
घण्टी	ɡʱʌɳʈi
अत्यास	ʌt̪jɑːs
माहुर	mɑːɦʊr
कौशेय	kaʊʃeɪ
अमीरी	ʌmiːriː
क्रम	kʌrʌm
लत्ताकपडा	lʌt̪t̪ɑːkʌpʌɖʌ
चल	t͡ʃʌl
रेटाइ	reɪt̪ɑːi
भ्वाँङ्ग	bʱʋɑːŋɡ
चुच्चेनङ्ग्रा	t͡ʃʊt͡ʃt͡ʃeɪnʌŋɡrɑː
धोक्	dʱoːk
खोर्‍याउ	kʰoːrjɑːʊ
कल्पनीय	kʌlpʌniːjʌ
अभिवन्दनीय	ʌbʱiʋʌndʌniːjʌ
अल्पमत	ʌlpʌmʌt̪
दुर्दशा	dʊrdʌdʃɑː
आँच	ɑːnt͡ʃ
रुवाइ	rʊʋɑːi
उद्दण्ड	ʊddʌɳɖ
ज्वालामुखी	d͡ʒʋɑːlɑːmʊkʰiː
अघोषित	ʌɡʱoːʃit̪
अस्पष्टता	ʌspʌʂʈʌt̪ɑː
मुखारी	mʊkʰɑːriː
ठक्रक्क	ʈʰʌkrʌkː
कमर्स	kʌmʌrs
त्रासदी	t̪rɑːsʌdiː
पिनास	pinɑːs
लाग्	lɑːɡ
अतृप्ति	ʌt̪rʌpt̪i
#टकटक्याहा	ʈʌkʈʌkjɑːɦɑː
पटरी	pʌʈriː
कथञ्चित्	kʌt̪ʰʌɲt͡ʃit̪
पाँद्	pɑːnd
बराँठि	bʌrɑːʈʰi
अनुष्ठान	ʌnʊʂʈʰɑːn
पछ्याउ	pʌt͡ʃjɑːʊ
कोबी	kobiː
बुकी	bʊkiː
किड्नी	kid̪niː
बिट	bit̪
होमियोपेथी	ɦomiːjopeɪt̪ʰiː
पाकेट	pɑːkeɪʈ
ओलम्पिक	oːlʌmpik
छ्याप	t͡ʃʰjɑːp
उफर्पाफर	ʊpʰʌrpɑːpʰʌr
पट्ट	pʌʈʈ
झुपुक्क	d͡ʒʰʊpʊkː
कृतसङ्कल्प	krit̪sʌŋkʌlp
लोग्नेमानिस	loːɡneːmɑːnis
बखान्	b ʌ kʰ ɑː n
भिउँट	bʱ i ʌ̃ ʈ
उच्छल	u t͡ʃʰ ʌ l
धर्मशास्त्र	d̪ʱ ʌ r m ʃ ɑː s t̪ r
घराना	ɡʱ ʌ r ɑː n ɑː
वसन्ती	b ʌ s ʌ n t̪ iː
अयौन	ʌ j ɔː n
कलाकौशल	k ʌ l ɑː k ɔː ʃ ʌ l
बार्	b ɑː r
कुटे	k u ʈ e
क्यालेन्डर	k j ɑː l e n ɖ ʌ r
रत्नदास	r ʌ t̪ n ʌ d ɑː s
कार्बनडाइअक्साइड	k ɑː r b ʌ n ɖ ɑː i ʌ k s ɑː i ɖ
साइनो	s ɑː i n o
ढाँड	ɖʱ ɑ̃ ɖ
पक्कै	p ʌ k k ɑː i
लोकराज	l o k ʌ r ɑː d͡ʒ
अरगज्ज	ʌ r ʌ ɡ ʌ d͡ʒ d͡ʒ
घुस	ɡʱ u s
डेटाबेस	ɖ e ʈ ɑː b e s
अलग	ʌ l ʌ ɡ
छपछप	t͡ʃʰ ʌ p t͡ʃʰ ʌ p
हेरविचार	ɦ e r ʌ b i t͡ʃʰ ɑː r
गीतकार	ɡ iː t̪ k ɑː r
धनपति	d̪ʱ ʌ n p ʌ t̪ i
प्यालेष्टाइन	p j ɑː l e ʃ ʈ ɑː i n
उगाउ	u ɡ ɑː u
हार	ɦ ɑː r
दातृसंस्था	d ɑː t̪ r ʌ s ʌ̃ s t̪ʰ ɑː
गोरखनाथ	ɡ o r ʌ kʰ n ɑː t̪ʰ
झिल्स्याइँदो	d͡ʒʱ i l s j ɑː ĩ d o
आलोकनीय	ɑː l o k n iː j
चैं	t͡ʃʰ ɛ̃
तौलिया	t̪ ɔː l i j ɑː
उदारवाद	u d ɑː r b ɑː d
अफिम	ʌ f i m
मुड्की	m u ɖ k i
सामसुम	s ɑː m s u m
तन्नेरी	t̪ ʌ n n e r i
थुप्रो	t̪ʰ u p r o
लचकता	l ʌ t͡ʃʰ ʌ k t̪ ɑː
कुल्चीमिल्ची	k u l t͡ʃʰ iː m i l t͡ʃʰ i
माइक्रोप्रोसेसर	m ɑː i k r o p r o s e s ʌ r
निश्‍वास	n i ʃ w ɑː s
बिक्	b i k
थैली	t̪ʰ ɛː l i
भूतल	bʱ uː t̪ ʌ l
बाख्रापालन	b ɑː kʰ r ɑː p ɑː l ʌ n
डफ्फा	ɖ ʌ f f ɑː
काबिल	k ɑː b i l
अमला	ʌ m ʌ l ʌ
छन्	t͡sʰ ʌ n
क्लीब	k l i: b
खोसेल्	kʰ o s e l
कप्पु	k ʌ p: u
मुरुङमुरुङ	m u r u ŋ m u r u ŋ
झगडा	d͡zʱ ʌ ɡ ʌ d̪ ʌ
नागेश	n ɑ: ɡ e ʃ
मञ्जरी	m ʌ ɲ d͡ʒ ʌ r i:
लक्ष्मीप्रसाद	l ʌ kʃ m i: p r ʌ s ɑ: d
कत्रो	k ʌ t r o
चतुस्सूत्री	t͡sʰ ʌ t u s: u: t r i:
अरुन्धती	ʌ r u n dʱ ʌ t i:
टुलुग्क	ʈ u l u ɡ k
शुद्धाशुद्धि	ʃ u d: ʌ ʃ u d: i
फ्याक्स	pʰ j ɑ: k s
गन्दगी	ɡ ʌ n d ʌ ɡ i:
कृतक	k r ɪ t ʌ k
लँगौटी	l ʌ ŋ ɔ: ʈ i:
दयानिधान	d ʌ j ɑ: n i dʱ ɑ: n
घुन्न	ɡʱ u n: ʌ
धान्	dʱ ɑ: n
नाली	n ɑ: l i:
पार्टी	p ɑ: r ʈ i:
छाउपडी	t͡sʰ ɑ: u p ʌ d i:
चोक्रे	t͡sʰ o k r e
इख	i kʰ
घेरा	ɡʱ e r ʌ
हाक्कहुक्क	ɦ ɑ: k: ʌ ɦ u k: ʌ
कलङ्की	k ʌ l ʌ ŋ k i:
भुत्ला	bʱ u t l ʌ
वनचर	b ʌ n ʌ t͡sʰ ʌ r
कनचिरा	k ʌ n ʌ t͡sʰ i r ɑ:
जग्गाधनी	d͡ʒ ʌ ɡ: ɑ: dʱ ʌ n i:
ठनठन	ʈʰ ʌ n ʈʰ ʌ n
खन्याउ	kʰ ʌ n j ɑ: u
ब्राम्हण	b r ɑ: mʱ ʌ n
राक्षस	r ɑ: kʃ ʌ s
समाह्‍वान	s ʌ m ɑ: ʍ ɑ: n
खुकुलो	kʰ u k u l o
रसि	r ʌ s i
आयातमुण्ड	ɑ: j ɑ: t ʌ m u ɳ ʈ
बाती	b ɑ: t i:
बिल्टो	b i l ʈ o
कान्तिपुर	k ɑ: n t i p u r
भद्रा	bʱ ʌ d r ɑ:
माहुर	m ɑ: ɦ u r
लाथ्रो	l ɑ: ʈʰ r o
रहनसहन	r ʌ ɦ ʌ n s ʌ ɦ ʌ n
बार्	b ɑ: r
भोला	bʱ o l a
रहनसहन	r ʌ ɦ n ʌ s ʌ ɦ n
साध्या	s aː dʱ j aː
हृदय	ɦ ɾ ɪ d ʌ j
सैर	s aɪ r
देवालय	d e ʋ aː l ʌ j
नेट	n eː ʈ
ह्याउ	ɦ j aː u
घेराबन्दी	ɡʱ e r aː b ʌ n d iː
कण	k ʌ ɳ
अपरेटर	ʌ p ʌ r eː ʈ ʌ r
पदमबहादुर	p ʌ d ʌ m ʌ b ʌ ɦ aː d u r
अकलगुम	ʌ k ʌ l ɡ u m
कसरी	k ʌ s ʌ r iː
हरफ	ɦ ʌ r ʌ f
डाइथेन	ɖ aː i ʈʰ e n
बासिन्दा	b aː s i n d aː
शहर	ʃ ʌ ɦ ʌ r
सुइँकुच्चा	s u ĩ k u t͡ʃ t͡ʃ aː
रेलिङ	r eː l i ŋ
हलुवाबेत	ɦ ʌ l u ʋ aː b e t
बिगौती	b i ɡ aː u t iː
डाइनी	ɖ aː i n iː
असर	ʌ s ʌ r
अभिमत	ʌ b ɦ i m ʌ t
अनिच्छा	ʌ n i t͡ʃ t͡ʃ aː
चेप्टे	t͡ʃ e p ʈ eː
तिर्सना	t i r s n aː
इमारत	i m aː r ʌ t
ख्यात	kʰ j aː t
किर्नु	k i r n u
विबाह	ʋ i b aː ɦ
कल्याण	k ʌ l j aː ɳ
झाङ	d͡zʱ aː ŋ
सर्ट	s ʌ r ʈ
दहिलो	d ʌ ɦ i l o
आत्था	aː tʰ tʰ aː
आतङ्कवादी	aː t ʌ ŋ k ʌ ʋ aː d iː
नोकरशाह	n o k ʌ r ʃ aː ɦ
सिक्री	s i k r iː
नशा	n ʌ ʃ aː
गृहस्थ	ɡ ɾ ɪ ɦ s tʰ
गोल्याउ	ɡ o l j aː u
जर्फर	d͡z ʌ r f ʌ r
अयोगात्मक	ʌ j o ɡ aː t m ʌ k
ढुकढुकी	ɖʱ u k ɖʱ u k iː
विशालबजार	ʋ i ʃ aː l b ʌ d͡z aː r
दरखार	d ʌ r kʰ aː r
लुँदो	l ũ d o
नाजी	n aː d͡z iː
रुद्री	r u d r i
केबल	k e b ə l
डिट्ठा	ɖ i ʈʰ ɑ
जाडे	ʤ ɑː ɖ e
मोटक	m o ʈ k
कलाकौशल	k ə l ɑː k ɔ ʃ ə l
लठैत	l ʌ ʈʰ ɛ t
झट्टै	ʤʰ ʌ ʈ ʈ ɛ
खैराँत	kʰ ɛ r ɑː n t
आयुर्वेदीय	ɑː j u r v e d iː j
कार्यकक्ष	k ɑː r j ə k ə kʃ
काँइयो	k ɑː n i j o
महबुब	m ə h ə b u b
गर्भघाती	g ə r bʰ gʰ ɑː t iː
थपाइ	ʈʰ ə p ɑː i
भोजपुर	bʰ o ʤ ə p u r
सायुज्य	s ɑː j u ʤ j ə
ढिस्को	ɖʱ i s k o
ज्ञानवर्णीय	ʤ ɲ ɑː n ə v ə r ɳ iː j
आल्मारी	ɑː l m ɑː r iː
जगदम्बा	ʤ ə g ə d ə m b ɑː
अप्रेशन	ə p r e ʃ ə n
भूमण्डल	bʰ uː m ə n ɖ ə l
काषाय	k ɑː ʃ ɑː j
धान्	dʱ ɑː n
च्याँसे	tʃ j ɑː n s e
हाइसुख्ख	h ɑː i s u kʰ kʰ
इनामेल	i n ɑː m e l
घरपरिवार	gʰ ə r p ə r i v ɑː r
असबल्ले	ə s ə b ə l l e
बिगो	b i g o
घोलुवा	gʰ o l u v ɑː
जर्क	ʤ ə r k
अकथनिय	ə k ə ʈʰ ə n i j
आकाङ्क्षी	ɑː k ɑː ŋ k ʃ iː
अझ	ə ʤʰ
कोटिनाम	k o ʈ i n ɑː m
कप्ल्याककुप्लुक्क	k ə p l j ɑː k ə k u p l u k k
इच्छापत्र	i tʃʰ ɑː p ə t r
कोपर्	k o p ə r
सत्याल	s ə t j ɑː l
उन्नायक	u n n ɑː j ə k
झर्को	ʤʰ ə r k o
आपत्ति	ɑː p ə t t i
चहार	tʃ ə h ɑː r
गुणात्मक	g u ɳ ɑː t m ə k
थैली	ʈʰ ɛ l iː
प्राचीन	p r ɑː tʃ iː n
टुकटुकती	ʈ u k ʈ u k ə t iː
भड्खालो	bʰ ə ɖ kʰ ɑː l o
गतिमान	g ʌ t i m ɑː n
धिक्कार	d̪ʱ i kː ɑː r
उतार	u t ɑː r
लडाक	l ʌ d̪ ɑː k
पपअप	p ʌ p ʌ p
ताउली	t ɑː u l i
उडालु	u ɖ ɑː l u
इख	i kʰ
महिना	m ʌ ɦ i n ɑː
बैल	b ɑː i l
दुर्गादास	d̪ u r g ɑː d̪ ɑː s
गन्दगी	g ʌ n d̪ ʌ g i
अनरसा	ʌ n ʌ r ʌ s ɑː
ज्वलित	d͡ʒ w ʌ l i t̪
जलुवा	d͡ʒ ʌ l u w ɑː
सम्भ्रम	s ʌ m bʱ r ʌ m
तर्स	t ʌ r s
सुबानी	s u b ɑː n i
आन्दोलन	ɑː n d̪ o l ʌ n
वरदान	b ʌ r d̪ ɑː n
अङ्गुर	ʌ ŋ g u r
चैत्र	t͡ʃ ɑː i t̪ r
अशास्त्रीय	ʌ ʃ ɑː s t̪ r iː j ʌ
मेरु	m e r u
घेराबन्दी	ɡʱ e r ɑː b ʌ n d̪ i
लिसीपिसी	l i s iː p i s iː
ज्वान	d͡ʒ w ɑː n
चुक	t͡ʃ u k
आत्मपरक	ɑː t̪ m ʌ p ʌ r ʌ k
सत्कार	s ʌ t̪ k ɑː r
उखाड्	u kʰ ɑː d̪
निउँ	n i ũ
परिपक्वता	p ʌ r i p ʌ k w ʌ t̪ ɑː
लत्रि	l ʌ t̪ r i
लौत	l ɔː t̪
अधमरो	ʌ d̪ʱ m ʌ r o
गोब्र्याउ	g o b r j ɑː u
चिउँडो	t͡ʃ i ũ d̪ o
जर्क	d͡ʒ ʌ r k
प्रसिद्धि	p r ʌ s i d̪ʱ i
डफ्फा	ɖ ʌ f f ɑː
भक्खर	bʱ ʌ kː ʌ r
बिराज्	b i r ɑː d͡ʒ
निजीक्षेत्र	n i d͡ʒ iː kʃ e t̪ r
भगाङ्कुर	bʱ ʌ g ɑː ŋ k u r
क्वाइँक्वाइँ	k w ɑː ĩ k w ɑː ĩ
टाउको	ʈ ɑː u k o
पाना	p ɑː n ɑː
राह	r ɑː ɦ
बबरमहल	b ʌ b ʌ r m ʌ ɦ ʌ l
मथल्	mʌ t̪ʰ ʌ l
हन्न	ɦ ʌ nː
ढिस्को	ɖʱ i s k o
पेट्रोलपम्प	p e ʈ r o l p ʌ m p
रामनारायण	r ä m n ä r ä j ʌ n
कुञ्जी	k u ɲ d͡ʒ i
कावा	k ä w ä
आयातमुण्ड	ä j ä t̪ ʌ m u ɳ ɖ
छक्का	t͡ʃ ʌ kː ä
चर्म	t͡ʃ ʌ r m
शिष्टाचार	ʃ i ʂ ʈ ä t͡ʃ ä r
उपनिवेशवाद	u p ʌ n i w e ʃ w ä d
बजिर	b ʌ d͡ʒ i r
अनेकौं	ʌ n e k ʌ̃
पटटट	p ʌ ʈ ʌ ʈ ʌ ʈ
कपिलवस्तु	k ʌ p i l w ʌ s t̪ u
अपरिपक्वता	ʌ p ʌ r i p ʌ k w ʌ t̪ ä
उफ्र	u pʰ r
गोरुसिङ्गे	ɡ o r u s i ŋ ɡ e
आदर	ä d ʌ r
सगाउ	s ʌ ɡ ä u
सर्जक	s ʌ r d͡ʒ ʌ k
कोटेश्वर	k o ʈ e ʃ w ʌ r
छेकुवा	t͡ʃ e k u w ä
उत्तेजन	u t̪ t̪ e d͡ʒ ʌ n
आरक्षण	ä r ʌ kʃ ʌ n
कोक्ल्याँटो	k o k l j ä̃ ʈ o
अथक	ʌ t̪ʰ ʌ k
भँगडी	bʱ ʌ̃ ɡ ʌ d i
कवाज	k ʌ w ä d͡ʒ
लक्ष	l ʌ kʃ
क्वार्र	k w ä r r
प्रिन्ट	p r i n ʈ
मेध	m e dʱ
उप-मार्ग	u p m ä r ɡ
साहचर्य	s ä ɦ ʌ t͡ʃ ʌ r j
ससीम	s ʌ s i m
तुर्लुङ्ङ	t̪ u r l u ŋ ɡ
चौटा	t͡ʃ ʌ u ʈ ä
खोतल्	kʰ o t̪ ʌ l
पट्ट	p ʌ ʈ ʈ
उज्ज्वलित	u d͡ʒ d͡ʒ w ʌ l i t̪
अकाल	ʌ k ä l
गन्दा	ɡ ʌ n d ä
जाडे	d͡ʒ ä ɖ e
छिरबिरे	t͡ʃ i r b i r e
हिमस्खलन	ɦ i m s kʰ l ʌ n
धनुर्धर	dʱ ʌ n u r dʱ ʌ r
अट्टालिका	ʌ ʈ ʈ ä l i k ä
पार्षद	p ä r ʂ ʌ d

    समन्वय	s ʌ m ʌ n ʋ ʌ j
चोरऔंले	t͡ʃ o r ʌ̃ ũ l e
पछितो	p ʌ t͡ʃʰ i t̪ o
गतिहारा	ɡ ʌ t̪ i ɦ ä r ä
गँडोहो	ɡ ã ɖ o ɦ o
पहिरो	p ʌ ɦ i r o
उल्लसित	u l l ʌ s i t̪
शंसोधन	ʃ ã s o d̪ ɦ ʌ n
ड्युटी	ɖ j u t̪ i
वायरलेस	ʋ ä j ʌ r l e s
अलौटो	ʌ l aʊ t̪ o
खिपुवा	kʰ i p u ʋ ä
बिन्	b i n
जनवरी	d͡ʒ ʌ n ʌ ʋ ʌ r i
जगर्सेठ	d͡ʒ ʌ ɡ ʌ r s e ʈʰ
थापा	ʈʰ ä p ä
भगवान	bʱ ʌ ɡ ʋ ä n
थच्चि	ʈʰ ʌ t͡ʃ t͡ʃ i
सपेटो	s ʌ p e t̪ o
आलमारी	ä l m ä r i
जसरी	d͡ʒ ʌ s ʌ r i
पराग	p ʌ r ä ɡ
ज्वान	d͡ʒ ʋ ä n
पावरनाथ	p ä ʋ ʌ r n ä ʈʰ
पालनपोषण	p ä l ʌ n p o ʂ ʌ n
पगितो	p ʌ ɡ i t̪ o
पिरीपिरी	p i r i p i r i
पजेरो	p ʌ d͡ʒ e r o
उवासंघ	u ʋ ä s ã ɡʱ
पीपल	p i p ʌ l
सेवक	s e ʋ ʌ k
चस्क	t͡ʃ ʌ s k
कुच्चि	k u t͡ʃ t͡ʃ i
मध्यनजर	m ʌ d̪ʱ j ʌ n ʌ d͡ʒ ʌ r
दिनचर्या	d̪ i n ʌ t͡ʃ ʌ r j ä
परिवार	p ʌ r i ʋ ä r
कर्कशता	k ʌ r k ʌ ʂ ʌ t̪ ä
घुन्न	ɡʱ u n n
अविवेक	ʌ ʋ i ʋ e k
पुरुष	p u r u ʂ
बाहु	b ä ɦ u
खानदानी	kʰ ä n ʌ d̪ ä n i
ठहर्	ʈʰ ʌ ɦ ʌ r
मात्रृभाषा	m ä t̪ r ʌ bʱ ä ʂ ä
सनई	s ʌ n ä i
भद्रा	bʱ ʌ d̪ r ä
वीरेन्द्रनगर	ʋ i r e n d̪ r ʌ n ʌ ɡ ʌ r
बीबीसी	b i b i s i
अपुङ्गी	ʌ p u ŋ ɡ i
मुद्दा	m u d̪ d̪ ä
उडन्ता	u ɖ ʌ n t ʌ
सुकसुक	s u k s u k
छाउरो	t͡ʃʰ a u r o
खोस्	kʰ o s
फरासी	pʰ ʌ r a s i
अन्सारी	ʌ n s a r i
क्रम	k r ʌ m
कल्पनीय	k ʌ l p n i j ʌ
छिपछिप	t͡ʃʰ i p t͡ʃʰ i p
ढलिमली	ɖʱ ʌ l i m ʌ l i
आसन्नकाल	a s ʌ n n k a l
भाद्र	bʱ a d r
दर्शन	d ʌ r ʃ ʌ n
ज्ञ	d͡ʒ ʌ̃
थिच्	tʰ i t͡ʃ
पूर्ति	p u r t i
कर्तृक	k ʌ r t r k
चन्द्रमणि	t͡ʃ ʌ n d r m ʌ n i
निवृत्त	n i b r t t
पाण्डव	p a n d ʌ b
स्वाइँस्वाइँती	s b a i̯ s b a i̯ t i
शुक्र	ʃ u k r
क्विन्टल	k b i n t ʌ l
कराई	k ʌ r a i
जप्	d͡ʒ ʌ p
दयानिधान	d ʌ j a n i dʱ a n
दृष्टान्त	d r ʃ t a n t
छ्याप	t͡ʃʰ j a p
बोको	b o k o
कार्यशैली	k a r j ʃ a i l i
नाली	n a l i
अतिचारी	ʌ t i t͡ʃʰ a r i
ठ्यामठ्याम	tʰ j a m tʰ j a m
च्याँसे	t͡ʃ j ã s e
उच्चस्तरीय	u t͡ʃ t͡ʃ s t ʌ r i j ʌ
अनुसूचक	ʌ n u s u t͡ʃ ʌ k
लौरी	l a u r i
वर्डस्वर्थ	b ʌ r d s b ʌ r tʰ
शिरीष	ʃ i r i ʃ
द्वैपायन	d b a i p a j ʌ n
चड्कन	t͡ʃ ʌ d k ʌ n
छुवाछुत	t͡ʃʰ u b a t͡ʃʰ u t
कर्णफूल	k ʌ r n pʰ u l
भन्दा	bʱ ʌ n d a
अनुलोम	ʌ n u l o m
अयोगात्मक	ʌ j o ɡ a t m ʌ k
अगम्यता	ʌ ɡ ʌ m j ʌ t a
मनीषा	m ʌ n i ʃ a
अनुपराज	ʌ n u p ʌ r a d͡ʒ
सुविधा	s u b i dʱ a
हिमचुली	ɦ i m ʌ t͡ʃ u l i
धादिङ	d̪ʱ ä d i ŋ
स्याहार	s j ä ɦ ä r
रेटाइ	r e ʈ ä i
थाङ्‍ग्रो	ʈʰ ä ŋ ɡ r o
पाँडे	p ä̃ ɖ e
छुरबुर	t͡ʃʰ u r b u r
र्‌याखर्‌याख	r j ä kʰ r j ä kʰ
सराप्	s ʌ r ä p
अनुज	ʌ n u d͡z
उनी	u n i
फोसा	pʰ o s ä
रामेश्वर	r ä m e ʃ w ʌ r
अन्वर्थ	ʌ n w ʌ r ʈʰ
अनिता	ʌ n i t ä
छन्क	t͡ʃʰ ʌ n k
जङ्गब	d͡z ʌ ŋ ɡ ʌ b
झुट्ट	d͡zʱ u ʈ ʈ
एकतमास	e k ʌ t ʌ m ä s
क्लीब	k l i b
विश्रामालय	b i ʃ r ä m ä l ä j
अक्षांश	ʌ kʃ ä̃ ʃ
निजगढ	n i d͡z ʌ ɡ ʌ d̪ʱ
सलिल	s ʌ l i l
सम्मेलन	s ʌ m m e l ʌ n
बार्	b ä r
लगनशीलता	l ʌ ɡ ʌ n ʌ ʃ i l ʌ t ä
अरगज्ज	ʌ r ʌ ɡ ʌ d͡z d͡z
पहिलो	p ʌ ɦ i l o
विद्यावारिधि	b i d̪ j ä b ä r i d̪ʱ i
क्षति	kʃ ʌ t i
भन्सार	bʱ ʌ n s ä r
चन्द्रमुखी	t͡ʃ ʌ n d̪ r ʌ m u kʰ i
मौजेनी	m ʌ u̯ d͡z e n i
सिधेनुन	s i d̪ʱ e n u n
घिनलाग्दो	ɡʱ i n l ä ɡ d o
पाँज्	p ä̃ d͡z
सहसेनानी	s ʌ ɦ s e n ä n i
महासन्धि	m ʌ ɦ ä s ʌ n d̪ʱ i
कोक्ल्याँटो	k o k l j ä̃ ʈ o
अपरेटर	ʌ p ʌ r e ʈ ʌ r
दापा	d ä p ä
चट्याङ्ग	t͡ʃ ʌ ʈ j ä ŋ ɡ
कुँदुवा	k ũ̯ d u w ä
कवास	k ʌ w ä s
झुटो	d͡zʱ u ʈ o
घोप्ट्	ɡʱ o p ʈ
बत्तीस	b ʌ t t i s
जडौरी	d͡z ʌ ɖ ʌ u̯ r i
थच्कार्	ʈʰ ʌ t͡ʃ k ä r
वनकुसुम	v ʌ n ʌ k u s u m
बाकस	b ä k ʌ s
फलाक्	pʰ ʌ l ä k
लुटि	l u ʈ i
बर्मा	b ʌ r m ä
घटघटी	ɡʱ ʌ ʈ ɡʱ ʌ ʈ i
बेन्च	b e n t͡ʃ
आर्द्रक	ä r d r ʌ k
करामत	k ʌ r ä m ʌ t
इस्लामावाद	i s l ä m ä v ä d
घुलित	ɡʱ u l i t
खस्राङखुस्रुङ	kʰ ʌ s r ä ŋ kʰ u s r u ŋ
दीप्‍ति	d i p t i
उल्लेखनीय	u l l e kʰ ʌ n i j
उद्धारक	u d̪ʱ ä r ʌ k
झञ्झावर्णन	d͡zʱ ʌ̃ d͡zʱ ä v ʌ r n ʌ n
तड्प	t ʌ ɖ p
कठपाइले	k ʌ ʈʰ p ä i l e
निब्ट	n i b ʈ
अपहरणकारी	ʌ p ʌ ɦ ʌ r ʌ n k ä r i
उगाउ	u ɡ ä u
पुष्टकारी	p u ʂʈ k ä r i
रोगब्याधी	r o ɡ b j ä d̪ʱ i
हतास	ɦ ʌ t ä s
लठाङ्ग्रि	l ʌ ʈʰ ä ŋ ɡ r i
मान्धाता	m ä n̪ d̪ʱ ä t ä
हिसाबकिताब	ɦ i s ä b k i t ä b
लौत	l ʌ u t
वरदान	b ʌ r d ä n
केर्	k e r
क्षत	k ʂ ʈ
मालिनी	m ä l i n i
मजनु	m ʌ d͡z ʌ n u
कमेन्ट	k ʌ m e n ʈ
हल	ɦ ʌ l
कुचुर्कि	k u t͡ʃ u r k i
कविहृदय	k ʌ v i ɦ r ʌ d ʌ j
पाथी	p ä ʈʰ i
करङ	k ʌ r ʌ ŋ
जैरे	d͡z ä i r e
दौँतरी	d̪ ʌ̃ u t ʌ r i
जिस्क	d͡z i s k
सँगी	s ʌ̃ ɡ i
सह्यार्	s ʌ ɦ j ä r
फाँड	pʰ ä̃ ɖ
मुग्लिङ	m u ɡ l i ŋ
गदरी	ɡ ʌ d ʌ r i
उपयोगी	u p ʌ j o ɡ i
बिछ्यौना	b i t͡ʃʰ j ʌ u n ä
अयोगात्मक	ʌ j o ɡ ä t̪ m ʌ k
जुस	d͡ʒ u s
जतासुकै	d͡ʒ ʌ t̪ ä s u k ä i
अनुपकार	ʌ n u p ʌ k ä r
भाकभुक	bʱ ä k bʱ u k
सलिल	s ʌ l i l
पूँजीवाद	p ũ̯ d͡ʒ i w ä d̪
आँखीभुईँ	ä̃ kʰ i bʱ u ĩ
छुल्क	t͡sʰ u l k
समतल	s ʌ m ʌ t̪ ʌ l
चिन्ताकुल	t͡ʃ i n̪ t̪ ä k u l
सहटाउ	s ʌ ɦ ʌ t̪ ä u
सतबिउ	s ʌ t̪ ʌ b i u
हत्याकाण्ड	ɦ ʌ t̪ j ä k ä ɳ d̪
चौबर	t͡ʃ ʌ u b ʌ r
नरदेवी	n ʌ r ʌ d̪ e w i
ख्यातनामा	kʰ j ä t̪ ʌ n ä m ä
जिप्टो	d͡ʒ i p t̪ o
घर्षण	ɡʱ ʌ r ʂ ʌ ɳ
सुपरिवेक्षण	s u p ʌ r i w e k ʂ ʌ ɳ
चुनी	t͡ʃ u n i
भुटन	bʱ u t̪ ʌ n
सङ्गम	s ʌ ŋ ɡ ʌ m
तकदिर	t̪ ʌ k ʌ d̪ i r
आज	ä d͡ʒ
प्रेम	p r e m
क्याल्सीयम	k j ä l s i j ʌ m
घिनलाग्दो	ɡʱ i n ʌ l ä ɡ̞ d̪ o
अनुज	ʌ n u d͡ʒ
खाडी	kʰ ä d̪ i
उमेर	u m e r
अहल्या	ʌ ɦ ʌ l j ä
गबुल्लो	ɡ ʌ b u l l o
च्याप्टि	t͡ʃ j ä p t̪ i
भद्रा	bʱ ʌ d̪ r ä
चिच्चो	t͡ʃ i t͡ʃ t͡ʃ o
खपटे	kʰ ʌ p ʌ t̪ e
छठ	t͡sʰ ʌ t̪ʰ
मालश्री	m ä l ʂ r i
क्रन्दन	k r ʌ n̪ d̪ ʌ n
लिपपोत	l i p ʌ p o t̪
घोलुवा	ɡʱ o l u w ä
खोल्सी	kʰ o l s i
पक्षी	p ʌ k ʂ i
ढकमक्क	ɖʱ ʌ k m ʌ k k
लहना	l ʌ ɦ n ä
इमारत	i m ä r ʌ t̪
डिजिटल	ɖ i d͡ʒ i t̪ ʌ l
गुठी	ɡ u t̪ʰ i
कोलाहल	k o l ä ɦ ʌ l
सँगेल्	s ã ɡ e l

    सनसनती	s ʌ n ʌ s ʌ n ʌ t̪ i
दिशाकुञ्जी	d̪ i ʃ ä k u ɳ d͡ʒ i
झिलमिल	d͡zʱ i l ʌ m i l
पितित्त	p i t̪ i t̪ t̪
सलसल	s ʌ l ʌ s ʌ l
वाक्यविन्यास	b ä k j ʌ b i n j ä s
अल्पस्मृति	ʌ l p ʌ s m ɾ i t̪ i
बिच्छुक	b i t͡ʃʰ u k
कुम्ले	k u m l e
कौटिलीय	k ʌʊ̯ ʈ i l i j ʌ
पाण्डव	p ä ɳ ɖ ʌ b ʌ
शारदा	ʃ ä r ʌ d ä
फुल्चोकी	pʰ u l t͡ʃ o k i
धानबाली	d̪ʱ ä n ʌ b ä l i
गतिमान	ɡ ʌ t̪ i m ä n
समेट्	s ʌ m e ʈ
असौजे	ʌ s ʌʊ̯ d͡ʒ e
सेलफोन	s e l pʰ o n
गिरफ्तार	ɡ i r ʌ pʰ t̪ ä r
गुलाब	ɡ u l ä b
परख	p ʌ r ʌ kʰ
तन	t̪ ʌ n
मारुनी	m ä r u n i
खोर्‍याउ	kʰ o r j ä u
न्यायाधीश	n j ä j ä d̪ʱ i ʃ
लाम्पाटो	l ä m p ä ʈ o
टेक्	ʈ e k
जिल	z i l
वाहवाह	b ä ɦ b ä ɦ
थाती	ʈʰ ä t̪ i
चुड्का	t͡ʃ u ɖ k ä
डफ्फा	ɖ ʌ pʰ pʰ ä
दृष्टान्त	d̪ ɾ i ʃ ʈ ä n ʈ
सुर्क	s u r ʌ k
टुङ्‍ना	ʈ u ŋ n ä
वरपर	b ʌ r p ʌ r
सङ्गम	s ʌ ŋ ɡ ʌ m
सारिका	s ä r i k ä
अम्बर	ʌ m b ʌ r
प्राची	p r ä t͡ʃ i
दिलाउ	d̪ i l ä u
हार्दिकता	ɦ ä r d̪ i k ʌ t̪ ä
आविद्ध	ä b i d̪ʱ
बेमज्जा	b e m ʌ d͡ʒ d͡ʒ ä
लागिमेली	l ä ɡ i m e l i
आभ्यन्तरिक	ä bʱ j ʌ n ʈ ʌ r i k
आरोपित	ä r o p i t̪
चिच्चो	t͡ʃ i t͡ʃʰ o
तौलसमूह	t̪ ʌʊ̯ l s ʌ m u ɦ
आर्ज	ä r d͡ʒ
भर्र	bʱ ə r r
हार्दिक	ɦ ɑː r d̪ i k
शिलापत्र	ʃ i l ɑː p ə t̪ r
ल्याउ	l j ɑː u
असंवेदनता	ə s ə̃ w e d̪ ə n ə t̪ ɑː
घडघडे	ɡʱ ə ɖ ɡʱ ə ɖ e
चुतिया	t͡ʃ u t̪ i j ɑː
उत्केन्द्र	u t̪ k e n d̪ r
सुनार	s u n ɑː r
आर्यसमाजी	ɑː r j ə s ə m ɑː d͡ʒ i
नाइटो	n ɑː i ʈ o
टेण्डर	ʈ e ɳ ɖ r
जतनलाख	d͡ʒ ə t̪ ə n l ɑː kʰ
चवालीसौं	t͡ʃ ə w ɑː l iː s ɔ̃
इच्छित	i t͡ʃʰ i t̪
निशिदिन	n i ʃ i d̪ i n
रेटाइ	r e ʈ ɑː i
गदा	ɡ ə d̪ ɑː
षोडश	ʂ o ɖ ʂ
चस्मदिद	t͡ʃ ə s m ə d̪ i d̪
पूर्ण	p uː r ɳ
वक्र	w ə k r
गव्य	ɡ ə w j
कीटाणुनाशक	k iː ʈ ɑː ɳ u n ɑː ʃ ə k
उद्धार	u d̪ d̪ʱ ɑː r
अजित	ə d͡ʒ i t̪
काँचुली	k ɑ̃ t͡ʃ u l i
आर्य	ɑː r j
पत्रिका	p ə t̪ r i k ɑː
हिउँचितुवा	ɦ i ũ t͡ʃ i t̪ u w ɑː
ठोक्	ʈʰ o k
जर्क	d͡ʒ ə r k
डवल	ɖ ə w ə l
सरिशृप	s ə r i ʃ r̩ p
खत्ति	kʰ ə t̪ t̪ i
ढलीमली	ɖʱ l iː m ə l iː
छुताहा	t͡ʃʰ u t̪ ɑː ɦ ɑː
प्रवाह	p r ə w ɑː ɦ
अजनबी	ə d͡ʒ ə n ə b iː
सालनाल	s ɑː l n ɑː l
द्रब्यशाह	d̪ r ə b j ə ʃ ɑː ɦ
फस्क	f ə s k
द्रुत	d̪ r u t̪
अर्गला	ə r ɡ ə l ɑː
विधानसभा	w i d̪ʱ ɑː n ə s ə bʱ ɑː
अङ्कारा	ə ŋ k ɑː r ɑː
तागत	t̪ ɑː ɡ ə t̪
चरचरे	t͡ʃ ə r t͡ʃ ə r e
निजगढ	n i d͡ʒ ə ɡʱ ə ɖ
आयुष्मान	ɑː j u ʂ m ɑː n

    लत्रक्क	l ʌ t̪ r ʌ k̚ k
जोकर	j o k ʌ r
नरदेवी	n ʌ r ʌ d̪ e v i
बर्मा	b ʌ r m ä
शंसोधन	ʃ ʌ̃ s o d̪ʱ ʌ n
हार्दिक	ɦ ä r d̪ i k
बर्बर	b ʌ r b ʌ r
गिरावट	ɡ i r ä ʋ ʌ t̪
ल्वापल्वापती	l ʋ ä p l ʋ ä p ʌ t̪ i
पिरीपिरी	p i r i p i r i
घैले	ɡʱ ä i l e
जर्खरो	j ʌ r kʰ ʌ r o
समयाङ्कन	s ʌ m ʌ j ä ŋ k ʌ n
माओ	m ä o
घोप्ट्	ɡʱ o p ʈ
दुवाकोट	d̪ u ʋ ä k o ʈ
कठपाइले	k ʌ t̪ʰ p ä i l e
खाम	kʰ ä m
वात्सल्य	ʋ ä t̪ s ʌ l j ʌ
आक्षेपक	ä kʃ e p ʌ k
डकार्	ɖ ʌ k ä r
आधार	ä d̪ʱ ä r
कस्तो	k ʌ s t̪ o
आशौच	ä ʃ ä u t͡s ʌ
छताछुल्ल	t͡sʰ ʌ t̪ ä t͡sʰ u l l
रोक्	r o k
गम्भीरता	ɡ ʌ m bʱ i r ʌ t̪ ä
आत्मपरक	ä ʌ t̪ m ʌ p ʌ r ʌ k
विधानसभा	ʋ i d̪ʱ ä n ʌ s ʌ bʱ ä
ठिङ्ग	ʈʰ i ŋ ɡ
जबरा	j ʌ b ʌ r ä
चनाखो	t͡s ʌ n ä kʰ o
ह्नेदिक	ɦ n e d̪ i k
खानपान	kʰ ä n ʌ p ä n
महेश	m ʌ ɦ e ʃ
अम्बर	ʌ m b ʌ r
बिँगो	b i ŋ ɡ o
पुरिया	p u r i j ä
आमुन्नेसामुन्ने	ä m u n n e s ä m u n n e
रेल्वे	r e l ʋ e
अधिकारवाला	ʌ d̪ʱ i k ä r ʌ ʋ ä l ä
खतरा	kʰ ʌ t̪ ʌ r ä
अपेक्षणीय	ʌ p e k ʃ ʌ n i j ʌ
कायिक	k ä j i k
गज्क	ɡ ʌ d͡z k
अनेकार्थी	ʌ n e k ä r t̪ʰ i
उनन्‍तीस	u n ʌ n t̪ i s
वृद्धि	ʋ r ʌ d̪ʱ i
पुच्छर	p u t͡sʰ ʌ r
बेमज्जा	b e m ʌ d͡z d͡z ä
जङ्गब	ʤʌŋɡʌb
चुबुरचुबुर	t͡ʃʊbʊɾt͡ʃʊbʊɾ
सप्लाइ	sʌplɑːi
चावहिल	t͡ʃɑːʋʌhil
नोवेल	noʋel
सँगी	sʌ̃ɡiː
दावा	dɑːʋɑː
अन्तर्त्वचा	ʌntʌɾtʌʋt͡ʃɑː
व्यङ्ग्य	ʋjʌŋɡjʌ
लताम	lʌtɑːm
परिभाषा	pʌɾibʱɑːʂɑː
तथा	tʌtʰɑː
खुलापन	kʰʊlɑːpʌn
पिशाच	pisʰɑːt͡ʃ
साहा	sɑːhɑː
मड्क	mʌɖk
राजप्रासाद	rɑːʤprɑːsɑːd
सालसुल	sɑːlsʊl
गोलि	ɡoli
स्याहार	sjɑːhɑːɾ
कुटुम्ब	kʊʈʊmb
आशौच	ɑːʃɔːt͡ʃ
रुपरेखा	rʊpʌrekʰɑː
नङ्ग्याउ	nʌŋɡjɑːʊ
नब्बे	nʌbbeː
गाँस्	ɡɑː̃s
चाप्	t͡ʃɑːp
बाह्रखरी	bɑːhrʌkʰriː
वाहन	ʋɑːhʌn
माउ	mɑːʊ
दैनिकी	dɑːinikiː
पास	pɑːs
कनसुत्ली	kʌnʌsʊtliː
सुलसुल	sʊlsʊl
समेना	sʌmenɑː
छ्याकन	t͡ʃʰjɑːkʌn
उत्तुङ	ʊttʊŋ
खपटि	kʰʌpʌʈi
सम्झौतापत्र	sʌmʤʰɔːtɑːpʌtɾ
थाप्ला	tʰɑːplɑː
अस्पष्टता	ʌspʌʂʈtɑː
होल्डर	hoːlɖʌr
लडाक	lʌɖɑːk
प्रोजेक्ट	proːʤekt
भलभल	bʰʌlbʰʌl
घरजम	ɡʰʌrʤʌm
आक्षेपक	ɑːkʃepʌk
खारी	kʰɑːriː
सहटाउ	sʌhʌʈɑːʊ
रुक्मिणी	rʊkmɪɳiː
टकराउ	ʈʌkʌɾɑːʊ
चिल्ल्याउ	t͡ʃɪlːjɑːʊ
रन्कि	ɾʌnkɪ
झर्को	d͡ʒʱʌɾkoː
फस्क	pʰʌsk
अति	ʌtɪ
एकौटी	ekɔːʈiː
अजय	ʌd͡ʒʌj
ऐँचाताना	ɛ̃t͡ʃɑːtɑːnɑː
उनान्नब्बे	unɑːnːʌbːeː
आपत	ɑːpʌt
जनवरी	d͡ʒʌnʌʋʌɾiː
उद्धारक	ʊd̪d̪ʱɑːɾʌk
नागरिकता	nɑːɡʌɾɪkʌt̪ɑː
राजनीति	rɑːd͡ʒniːt̪ɪ
अनिन्द्य	ʌnɪnd̪jʌ
अनुत्पादित	ʌnʊt̪pɑːd̪ɪt̪
खुरुङ्गो	kʰʊɾʊŋɡoː
परख	pʌɾʌkʰ
कप्ल्याककुप्लुक्क	kʌpljɑːkʌkʊplʊkː
बिच्छुक	bɪt͡ʃʰʊk
छल्ल	t͡ʃʰʌlː
चानेचुने	t͡ʃɑːneːt͡ʃʊneː
गवेषण	ɡʌʋeːʂʌn
कहीं	kʌɦiː̃
चिनु	t͡ʃɪnʊ
पन्छ	pʌnt͡ʃʰ
लैजा	lɛːd͡ʒɑː
बुन्	bʊn
बलिउड	bʌliːʊd̪
भेडा	bʱeːd̪ɑː
हिचकिचाउ	ɦɪt͡ʃkɪt͡ʃɑːʊ
बाँको	bɑ̃ːkoː
एकजीउ	ekd͡ʒiːʊ
प्रतिपादन	pɾʌt̪ɪpɑːd̪ʌn
झताउरे	d͡ʒʱʌt̪ɑːʊɾeː
हार	ɦɑːɾ
अरुचिकर	ʌɾʊt͡ʃɪkʌɾ
एकले	ekʌleː
उध्र	ʊd̪ʱɾ
कटाकटाउँदो	kʌʈɑːkʌʈɑːʊ̃doː
वाच्य	ʋɑːt͡ʃjʌ
सोध्	soːd̪ʱ
लर्याङतर्याङ	lʌɾjɑːŋt̪ʌɾjɑːŋ
च्यापु	t͡ʃjɑːpuː
मोज	moːd͡ʒ
अपकर्षक	ʌpʌkʌɾʂʌk
हाक्कहुक्क	ɦɑːkːʌɦʊkː
क्षति	kʂʌt̪ɪ
शक्तिमान	ʃʌkt̪ɪmɑːn

    सरणि	s ʌ r ʌ n i
आज्ञा	ä d͡z ɲ ä
लेखोट	l e kʰ oʈ
पाँडे	p ä̃ ɖ e
चासोपर्दो	t͡ʃ ä s o p ʌ r d o
डाकिनी	ɖ ä k i n i
आच्छन्न	ä t͡ʃʰ ʌ n ʌ n
सारुप्य	s ä r u p j ʌ
हस्तक्षेप	ɦ ʌ s t̪ ʌ kʃ e p
उखन्ड	u kʰ ʌ n ɖ
टाई	ʈ ä i
थु:	ʈʰ u
थिर्	ʈʰ i r
फाल	pʰ ä l
आहाल	ä ɦ ä l
मोटक	m o ʈ ʌ k
पनौती	p ʌ n ʌ u t i
अग्रिम	ʌ ɡ r i m
कार्यकर्ता	k ä r j ʌ k ʌ r t ä
इन्टेल	i n ʈ e l
मुख	m u kʰ
कुरकुर	k u r ʌ k u r
कोलाहल	k o l ä ɦ ʌ l
मुलुक	m u l u k
चौसट्ठी	t͡ʃ ʌ u s ʌʈʰ i
पग्लि	p ʌ ɡ l i
स्वेच्छ्या	s ʋ e t͡ʃʰ j ä
फकिर	pʰ ʌ k i r
लोप्रि	l o p r i
धड्	dʱ ʌ ɖ
औलो	ʌ u l o
उत्केन्द्र	u t̪ k e n d r ʌ
ढक्क	ɖʱ ʌ k k
खेदुवा	kʰ e d u ʋ ä
संवास	s ʌ̃ ʋ ä s
सनातन	s ʌ n ä t̪ ʌ n
पञ्चायत	p ʌ̃ t͡ʃ ä j ʌ t̪
सबार	s ʌ b ä r
टेलीभिजन	ʈ e l i bʱ i d͡z ʌ n
अग्रता	ʌ ɡ r ʌ t̪ ä
पर्वाह	p ʌ r ʋ ä ɦ
ब्रस	b r ʌ s
पूँजीपति	p ũ d͡ʒ i p ʌ t̪ i
धुरी	dʱ u r i
जङ्गि	d͡z ʌ ŋ ɡ i
मेष	m e ʃ
अभिवन्दनीय	ʌ bʱ i ʋ ʌ n d ʌ n i j ʌ
उत्पादी	u t̪ p ä d i
द्विज	d̪ ʋ i d͡z
लैजा	l ä i d͡z ä
बिमाख	b i m a kʰ
कीर्तिशाली	k i r t i ʃ a l i
क्षति	k ʂ a t i
अग्रिम	a ɡ r i m
छुताहा	t͡ʃʰ u t a h a
विचारधारा	ʋ i t͡ʃ a r dʰ a r a
पितित्त	p i t i t t
पूर्णविराम	p u r ɳ a ʋ i r a m
चिट्ट	t͡ʃ i ʈ ʈ
उकाली	u k a l i
झङ्कारित	d͡zʱ ŋ k a r i t
मुनामदन	m u n a m a d a n
कालोनीलो	k a l o n i l o
वेदवाक्य	ʋ e d a ʋ a k j a
अमीर	a m i r
स्याहार	s j a h a r
काँधि	k a ɳ dʱ i
गोल्छा	ɡ o l t͡ʃʰ a
मोज	m o d͡z
गणतन्त्री	ɡ ɳ a t a n t r i
व्यङ्ग्य	ʋ j a ŋ g j a
आखिभूइँ	a kʰ i bʱ u ĩ
स्वास्थ्यकेन्द्र	s ʋ a s tʰ j a k e n d r a
आत्मपरक	a a t m a p a r a k
पद्मकन्या	p a d m a k a n j a
वीरेन्द्रनगर	ʋ i r e n d r a n a ɡ a r
आशाकारी	a ʃ a k a r i
जिब्रो	d͡ʒ i b r o
ककपीट	k a k a p i ʈ
वौद्धिक	ʋ a u d dʱ i k
आफन्तजन	a a f a n t a d͡ʒ a n
हारहुर	h a r h u r
सादापाठ	s a d a p a ʈʰ
छक्का	t͡ʃʰ a k k a
मिलन	m i l a n
किड्नी	k i ɖ n i
कुसुम	k u s u m
वनसाङ्लो	ʋ a n a s a ŋ l o
बिलौनी	b i l a u n i
पतलाउ	p a t a l a u
मालिका	m a l i k a
बलाघात	b a l a ɡʱ a t
राजगद्दी	r a d͡ʒ a ɡ a d d i
अधमरो	a dʱ m a r o
उहिले	u h i l e
पाप्रा	p a p r a
हिरन	h i r a n
झट्कार्	d͡zʱ a ʈ k a r
थैली	ʈʰ a i l i
सट्याकसुटुक	s a ʈ j a k a s u ʈ u k
श्यार्पा	ʃ j ɑː r p ɑː
खचाखच	kʰ ʌ t͡ʃ ɑː kʰ ʌ t͡ʃ
आदर्श	ɑː d ʌ r ʃ
निकासी	n i k ɑː s iː
रामो	r ɑː m o
रुद्राक्ष	r u d r ɑː kʃ
सिट्	s i ʈ
अजय	ʌ d͡ʒ ʌ j
जरुर	d͡ʒ ʌ r u r
यगण	j ʌ ɡ ʌ ɳ
भल	bʱ ʌ l
खुल्लमखुल्ला	kʰ u l l ʌ m kʰ u l l ʌ
तकदिर	t ʌ kʌ d i r
घिनाहा	ɡʱ i n ɑː h ɑː
झरझर	d͡ʒʱ ʌ r d͡ʒʱ ʌ r
जगर्सेठ	d͡ʒ ʌ ɡ ʌ r s eː ʈʰ
भँगडी	bʱ ʌ ŋ ɡ ʌ d iː
प्रति	p r ʌ t i
ताउलो	t ɑː u l o
घोटाला	ɡʱ oː ʈ ɑː l ɑː
महेश	m ʌ h e ʃ
खुर्क	kʰ u r k
सहटाउ	s ʌ h ʈ ɑː u
ऐँचाताना	ʌ iː n t͡ʃ ɑː t ɑː n ɑː
छपन	t͡ʃʰ ʌ p ʌ n
राणा	r ɑː ɳ ɑː
वनचर	b ʌ n ʌ t͡ʃ ʌ r
क्यास्ट्रो	k j ɑː s ʈ r o
खौवा	kʰ ɔː b ɑː
ज्यास्ता	d͡ʒ j ɑː s t ɑː
शहर	ʃ ʌ h ʌ r
छत्तीस	t͡ʃʰ ʌ t t iː s
सल्याकसुलुक	s ʌ l j ɑː k ʌ s u l u k
निराश	n i r ɑː ʃ
धनेस	dʱ ʌ n e s
अधर	ʌ dʱ ʌ r
रजिस्ट्रार	r ʌ d͡ʒ i s ʈ r ɑː r
चट्याङ्ग	t͡ʃ ʌ ʈ j ɑː ŋ ɡ
ठिङुरि	ʈʰ i ŋ u r i
मन्जन	m ʌ n d͡ʒ ʌ n
अकलगुम	ʌ k ʌ l ʌ ɡ u m
चार	t͡ʃ ɑː r
आश्रम	ɑː ʃ r ʌ m
थाती	ʈʰ ɑː t iː
हायहाय	h ɑː j h ɑː j
ट्याम्पो	ʈ j ɑː m p o
तानाशाह	t ɑː n ɑː ʃ ɑː h
दहिलो	d ʌ h i l o
शब्दकोष	ʃ ʌ b d ʌ k oː ʃ
चूनढुङ्गो	t͡ʃ uː n ʌ ɖʱ u ŋ ɡ o
अनेकौं	ʌ n e k ɔ̃
गुम्सि	ɡ u m s i
पुस्टाउ	p u s ʈ ä u
ट्वाल्ल	ʈ w ä l l
टपरे	ʈ ʌ p ʌ r e
शान्तिवार्ता	ʃ ä n ʈ i w ä r ʈ ä
सम्झौतापत्र	s ʌ m d͡ʒʱ ɔ ʈ ä p ʌ t̪ r
परिवार	p ʌ r i w ä r
दन्तशूल	d ʌ n ʈ ʌ ʃ u l
सुल्ल	s u l l
झरझर	d͡ʒʱ ʌ r d͡ʒʱ ʌ r
अभिजातवर्ग	ʌ bʱ i d͡ʒ ä ʈ ʌ w ʌ r ɡ
भेडो	bʱ e ɖ o
बदला	b ʌ d̪ l ä
अनगिन्ती	ʌ n ʌ ɡ i n ʈ i
सारथि	s ä r ʌ t̪ʱ i
आदि	ä d̪ i
आमाछोरी	ä m ä t͡ʃʰ o r i
साबुन	s ä b u n
गप्फ्याउ	ɡ ʌ p f j ä u
जिबुल्ले	d͡ʒ i b u l l e
बेगल	b e ɡ ʌ l
अविभाज्य	ʌ w i bʱ ä d͡ʒ j ʌ
बरु	b ʌ r u
गणपूरक	ɡ ʌ n p u r ʌ k
त्यता	t̪ j ʌ t̪ ä
निराश	n i r ä ʃ
चिमचिम	t͡ʃ i m t͡ʃ i m
मोचन	m o t͡ʃ ʌ n
थेग्रि	ʈʰ e ɡ r i
उद्‌भासी	u d bʱ ä s i
ठेकेदार	ʈʰ e k e d ä r
जप्	d͡ʒ ʌ p
असहयोग	ʌ s ʌ h ʌ j o ɡ
रसि	r ʌ s i
सिगसिगाउ	s i ɡ s i ɡ ä u
चौतीसौं	t͡ʃ ɔ t̪ i s ɔ̃
खबटो	kʰ ʌ b ʈ o
सन्यास	s ʌ n j ä s
परिपक्वता	p ʌ r i p ʌ k w ʌ t̪ ä
एकुन्टा	e k u n ʈ ä
घरधन्दा	ɡʱ ʌ r d̪ʱ ʌ n d̪ ä
खर्रो	kʰ ʌ r r o
सन्तति	s ʌ n ʈ ʌ t̪ i
तालिम	t̪ ä l i m
टुकटुकती	ʈ u k ʈ u k ʈ i
अनियमित	ʌ n i j ʌ m i t̪
चेकपोस्ट	t͡ʃ e k ʌ p o s ʈ
झटाझटी	d͡ʒʱ ʈ ä d͡ʒʱ ʈ i
उल्लासक	u l l ä s ʌ k
मुसल	m u s ʌ l
दनदन	d ʌ n ʌ d ʌ n
अबोधव्यक्ति	ʌ b o d̪ʱ ʌ b j ʌ k t̪ i
खनाल	kʰ ʌ n ä l
चुनौती	t͡s u n ʌ u t̪ i
सुत्	s u t̪
छाँटा	t͡sʰ ä̃ ʈ ä
छापा	t͡sʰ ä p ä
म्याउँ	m j ä ũ
भारी	bʱ ä r i
समयाङ्कन	s ʌ m ʌ j ä ŋ k ʌ n
आलोक	ä l o k
कुकुर्कि	k u k u r k i
मिटर	m i ʈ ʌ r
उल्लासित	u l l ä s i t̪
छिपछिपे	t͡sʰ i p t͡sʰ i p e
तलतिर	t̪ ʌ l ʌ t̪ i r
बाध्य	b ä d̪ʱ j ʌ
उमेर	u m e r
थासो	ʈʰ ä s o
तुलसीपुर	t̪ u l ʌ s i p u r
बोतो	b o t̪ o
सहशिक्षा	s ʌ ɦ ʌ s i k ʃ ä
बाहु	b ä ɦ u
विज्ञापक	b i d͡z ʌ̃ p ʌ k
कदरपत्र	k ʌ d̪ ʌ r p ʌ t̪ r
ग्वाँगे	ɡʷ ä̃ ŋ ɡ e
होचि	ɦ o t͡s i
हुँदो	ɦ ũ d o
कुँड्	k ũ ʈ
कार्यकक्ष	k ä r j ʌ k ʌ k ʃ
ग्याँठवाल	ɡ j ä̃ ʈʰ ʌ ʋ ä l
हरहर	ɦ ʌ r ɦ ʌ r
जरा	d͡z ʌ r ä
आराम	ä r ä m
शिवालय	ʃ i ʋ ä l ä j
अट्टालिका	ʌ ʈ ʈ ä l i k ä
किफाएति	k i f ä e t̪ i
सुविस्ता	s u ʋ i s t̪ ä
गजेन्द्र	ɡ ʌ d͡z e n d̪ r
वारुणयन्त्र	ʋ ä r u ɳ ʌ j ʌ n t̪ r
चन्द्रिका	t͡s ʌ n d̪ r i k ä
झिलमिल	d͡zʱ i l m i l
म्याट्रिक्स	m j ä ʈ r i k s
ज्वालामुखी	d͡z ʋ ä l ä m u kʰ i
खरिददार	kʰ ʌ r i d̪ ʌ d̪ ä r
त्यही	t̪ j ʌ ɦ i
अपहरणकारी	ʌ p ʌ ɦ ʌ r ʌ n k ä r i
जजमाने	d͡z ʌ d͡z m ä n e
चिहान	t͡s i ɦ ä n
टाई	ʈäi
गतिछाडा	gʌt̪it͡ʃʰäɖä
मञ्च	mʌɳt͡ʃ
ठेकेदार	ʈʰekedär
मरमरी	mʌrmʌri
आहारा	äɦärä
क्यानभास	kjänbhäs
बुरुण्डी	burʊɳɖi
आशंसित	äʃə̃sit
रत्नदास	rʌt̪nʌdäs
उतार	utär
ओभाउ	obhäu
आलोडन	älodʌn
उदाराशय	udäräʃʌj
चुनीचुनाउ	t͡ʃuniːt͡ʃunäu
तमाखु	tʌmäkʰu
लोकार्पण	lokärpʌɳ
कटाकटाउँदो	kʌʈäkʌʈäũdo
आनाकानी	änäkäni
आर्य	ärj
मौजुदा	maud͡ʒudä
गदा	gʌdä
चन्दने	t͡ʃʌndʌne
सुरेन्द्र	suren̪d̪rʌ
उन्मादपन	unmäd̪pʌn
शिष्टाचार	ʃiʂʈäcär
चीफ	t͡ʃif
चुनौती	t͡ʃunäut̪i
खुरुङ्गो	kʰurʊŋgo
अभिषेचन	ʌbʱiʃet͡ʃʌn
कुरूप	kurup
ओट्	oʈ
जारजन्मा	d͡ʒärʤʌnmä
ताउलो	täul̪o
ऊर्ध्वगामी	urd̪ʱwʌgämi
अकपट	ʌkʌpʌʈ
रे	re
प्राङ्‍गार	präŋgär
कोटिनाम	koʈinäm
निवृत्त	nivrʊt̪t̪
किनार	kʰinär
प्राविधिक	präbid̪ʱik
वृद्ध	vrʊd̪ʱ
द्रब्यशाह	d̪rʌbjʃäh
पिठ्युँ	pʌʈʰjũ
कामधेनु	kämʌd̪ʱenu
कार्यवाही	kärjʋähi
अनिन्द्य	ʌnind̪j
नर्मल	nʌrmʌl
खन	kʰʌn
खकाल्	kʰ ʌ k ä l
रामेश्वर	r ä m e ʃ w ʌ r
बहिष्कार	b ʌ ɦ i ʃ k ä r
प्रति	p r ʌ t̪ i
कालोनीलो	k ä l o n i l o
मान्धाता	m ä n̪ d̪ʱ ä t̪ ä
कवास	k ʌ w ä s
आख्यायक	ä kʰ j ä j ʌ k
अश्रान्त	ʌ ʃ r ä n̪ t̪
धोक्	d̪ʱ o k
उखाड्	u kʰ ä ɖ
हरितगृह-प्रभाव	ɦ ʌ r i t̪ ʌ ɡ r ʌ ɦ p r ʌ bʱ ä w
फतरि	pʰ ʌ t̪ ʌ r i
ओझेल	o d͡zʱ e l
चम्सुर	t͡s ʌ m s u r
असहयोग	ʌ s ʌ ɦ j o ɡ
आयुष्मान	ä j u ʃ m ä n
आखिभूइँ	ä kʰ i bʱ u ĩ
आईएसपी	ä i e s p i
अविपन्न	ʌ w i p ʌ n̪ n
दयानिधान	d̪ ʌ j ä n i d̪ʱ ä n
दातृसंस्था	d̪ ä t̪ r s ʌ̃ s t̪ʰ ä
उलामाला	u l ä m ä l ä
सुअवसर	s u ʌ w ʌ s ʌ r
करामत	k ʌ r ä m ʌ t̪
अत्यावस्यकरुप	ʌ t̪ j ä w ʌ s j ʌ k ʌ r u p
लेखपढ	l e kʰ p ʌ ɖ
जीन	j i n
काइँकुइँ	k ä ĩ k u ĩ
झिल्स्याइँदो	d͡zʱ i l s j ä ĩ d̪ o
घुन्न	ɡʱ u n̪ n
श्री	ʃ r i
गीतिचेत	ɡ i t̪ i t͡s e t̪
उत्तरदायित्त्व	u t̪ t̪ ʌ r d̪ ä j i t̪ t̪ w
सत्तारुढ	s ʌ t̪ t̪ ä r u ɖʱ
मनुष्य	m ʌ n u ʃ j
अश्वशक्ति	ʌ ʃ w ʌ ʃ ʌ k t̪ i
कमर्स	k ʌ m ʌ r s
सम	s ʌ m
अनित्य	ʌ n i t̪ j
दुर्दशा	d̪ u r d̪ ʌ ʃ ä
अमिलि	ʌ m i l i
अभिव्यक्ति	ʌ bʱ i w j ʌ k t̪ i
आकस्मिकता	ä k ʌ s m i k ʌ t̪ ä
मूल्य	m u l j
सबथोक	s ʌ b ʌ t̪ʰ o k
परपरि	p ʌ r p ʌ r i
केर्	k e r
देवी	d̪ e w i
टुपुटुपु	ʈ u p u ʈ u p u
समयाङ्कन	s ʌ m ʌ j ä ŋ k ʌ n
क्षोभक	kʰ ʃ o bʱ ʌ k
अप्ठ्यारा	ʌ p ʈʰ j ä r ä
मुद्दा	m u d̪ d̪ ä
झन्अस्ति	d͡zʱ ʌ n ʌ s t̪ i
खर्लप्प	kʰ ʌ r l ʌ p p
बाबुआमा	b ä b u ʌ m ä
टाल	ʈ ä l
साकेवा	s ä k e b ä
भ्रम	bʱ r ʌ m
अरगज्ज	ʌ r ʌ ɡ ʌ d͡zʱ d͡zʱ
ब्रह्‍मर्षि	b r ʌ ɦ m ʌ r ʃ i
अनुपमेय	ʌ n u p ʌ m e j
स्थिर	s ʈʰ i r
सुकुटे	s u k u ʈ e
मसौदा	m ʌ s ʌ u̯ d̪ ä
वहि:	b ʌ ɦ i
प्यारा	p j ä r ä
अनिमन्त्रित	ʌ n i m ʌ n ʈ r i t̪
क्याल्सीयम	k j ä l s i j ʌ m
थापाथली	ʈʰ ä p ä ʈʰ l i
मीठो	m i ʈʰ o
पुरिया	p u r i j ä
परीक्षण	p ʌ r i kʰ ʃ ʌ n
मुड्की	m u ɖ k i
मट्याङ्ग्रो	m ʌ ʈ j ä ŋ r o
अनुन्नत	ʌ n u nː ʌ t̪
पुरस्कार	p u r ʌ s k ä r
व्यन्जन	b j ʌ n d͡zʱ ʌ n
फारो	pʰ ä r o
वृश्चिक	b r ʌ ʃ t͡ʃ i k
परिवहन	p ʌ r i b ʌ ɦ ʌ n
गलसेरा	ɡ ʌ l s e r ä
खत्ति	kʰ ʌ t̪ t̪ i
तथा	t̪ ʌ ʈʰ ä
नलिखुट्टो	n ʌ l i kʰ u ʈ ʈ o
गोब्य्राउ	ɡ o b j r ä u̯
तिखार्	t̪ i kʰ ä r
रामनारायण	r ä m n ä r ä j ʌ n
भक्तिमान	bʱ ʌ k t̪ i m ä n
सेवक	s e b ʌ k
उच्च	u t͡ʃ t͡ʃ
देवालय	d̪ e b ä l ʌ j
वारुणयन्त्र	b ä r u n j ʌ n ʈ r
धर्मशास्त्र	d̪ʱ ʌ r m ʃ ä s t̪ r
तिर्सना	t̪ i r s n ä
गिरावट	ɡ i r ä b ʌ ʈ
खराखर	kʰ ʌ r ä kʰ ʌ r
अन्तर्ध्वंस	ʌ n t̪ ʌ r dʱ ʋ ʌ̃ s
झिँगो	d͡zʱ i ŋ ɡ o

    पाउँ	paʊ̃
पेटिका	pɛʈika
वाक्यरचना	vaːkjɾat͡ʃanaː
एक्युपङ्चर	ɛkjupaŋt͡ʃar
निस्कासन	niskaːsan
अड्कल्	aɖkal
थिमी	ʈhimiː
थाह	ʈhaːh
खिस्सा	khissaː
लेखापरीक्षण	lɛkhaːpariːkʃaɳ
ढिलो	ɖhilo
चटक	t͡ʃaʈak
पिनास	pinaːs
चौतीसौं	t͡ʃautiːsaʊ̃
फट्याङ्ग्रो	phaʈjaŋgro
ठोस	ʈhos
कोप्रि	kopri
किर्नु	kirnu
कपी	kapiː
प्रसिद्ध	prasid̪d̪h
कुञ्‍ज	kuɲd͡ʒ
गुमराह	gumaraːh
वैधीकरण	vaid̪hiːkaraɳ
जस्ता	d͡ʒastaː
मुक्ति	mukti
परिदृश्य	paridr̩ʃj
तार्	taːr
अंशुवर्मा	ãʃuvarmaː
पिँद्	pind
चौतीस	t͡ʃautiːs
अपेक्षणीय	apɛkʃaɳiːj
खोर्‍याउ	khorjaʊ
द्वीप	dviːp
सितन	sitan
मतान्तर	matanʈar
म्याट्रिक्स	mjaːʈriks
कस्केली	kaskeliː
आभासित	aːbhaːsit
अफलाइन	aphalain
कर्कशता	karkaʃataː
आरोहण	aːrohaɳ
तदपि	tadapi
एत्तेरी	ɛʈʈeriː
टुङ्‍ना	ʈuŋnaː
लिगलिगे	ligalige
आराम	aːraːm
बलाघात	balaːghaːt
गढी	gaɖhiː
टुकटुकती	ʈukaʈukaʈiː
जिउ	d͡ʒiu
गोर्खाली	ɡ o r kʰ aː l i
चिउँडो	t͡ʃ i ũ ɖ o
बहुदल	b ʌ ɦ u d ʌ l
क्षत	kʂ ʌ t
गणेशपुर	ɡ ʌ ɳ e ʃ p u r
शिलापत्र	ʃ i l aː p ʌ t r
माइक्रोप्रोसेसर	m aː i k r o p r o s e s ʌ r
वेबफोल्डर	b e b pʰ o l ɖ ʌ r
बँदिया	b ã d i j aː
लिपित्त	l i p i t t
थान	tʰ aː n
कथञ्चित्	k ʌ tʰ ʌ ɲ t͡ʃ i t
लगत्तै	l ʌ ɡ ʌ t t aː i
औचित्य	ɔ t͡ʃ i t j ʌ
आस	aː s
विधायक	b i dʱ aː j ʌ k
खेप्	kʰ e p
उपहासक	u p ʌ ɦ aː s ʌ k
गजब	ɡ ʌ d͡ʒ ʌ b
हाइटी	ɦ aː i t iː
चन्द्रमुखी	t͡ʃ ʌ n d r ʌ m u kʰ iː
मनाङ	m ʌ n aː ŋ
थुतुनो	tʰ u t u n o
पूर्णविराम	p uː r ɳ ʋ i r aː m
पाउलो	p aː u l o
उच्चस्तरीय	u t͡ʃ t͡ʃ ʌ s t ʌ r i j ʌ
चमचाम	t͡ʃ ʌ m t͡ʃ aː m
सामा	s aː m aː
अङ्गीकृत	ʌ ŋ ɡ iː k r i t
पजेरो	p ʌ d͡ʒ e r o
बोतल	b o t ʌ l
परपरि	p ʌ r p ʌ r i
किनार	k i n aː r
नागार्जुन	n aː ɡ aː r d͡ʒ u n
भैँसी	bʱ aː ĩ s iː
पट्याउ	p ʌ ʈ j aː u
ठकठकी	ʈʰ ʌ k ʈʰ ʌ k iː
भुँडल्लो	bʱ ũ ɖ ʌ l l o
यथा	j ʌ tʰ aː
शारदा	ʃ aː r ʌ d aː
झेलाहा	d͡ʒʱ e l aː ɦ aː
लम्चि	l ʌ m t͡ʃ i
भिउँट	bʱ i ũ ʈ
रामेश्वर	r aː m e ʃ ʋ ʌ r
कस्तो	k ʌ s t o
दिक्तेल	d i k t e l
भोजपुर	bʱ o d͡ʒ p u r
गधा	ɡ ʌ dʱ aː
सुनुवाइ	s u n u ʋ aː i
झङ्कारित	d͡ʒʱ ʌ ŋ k aː r i t

    सुविधा	s u v i dʱ ä
ब्यबहार	b j ʌ b ʌ ɦ ä r
खैँच	kʰ ʌ̃ t͡ʃ
धतुलाउ	dʱ ʌ t̪ u l ä u
दुर्दशा	d u r d ʌ ʃ ä
क्विन्टल	k v i n t̪ l
उज्ज्वलित	u d͡ʒ d͡ʒ w ʌ l i t̪
सुलसुल	s u l s u l
क्याल्सीयम	k j ä l s i j ʌ m
जिल्ला	d͡ʒ i l l ä
प्लेग	p l e ɡ
बेच्	b e t͡ʃ
मोजा	m o d͡ʒ ä
खकार्	kʰ ʌ k ä r
पूर्व	p u r v
पलट्ट	p ʌ l ʌ t̪ t̪
एकाह	e k ä ɦ
विम्बविधान	v i m b ʌ v i dʱ ä n
संसाधन	s ʌ̃ s ä dʱ ʌ n
उत्प्रेक्षक	u t̪ p r e kʃ ʌ k
सोपान	s o p ä n
भक्खर	bʱ ʌ kʰ ʌ r
उद्यम	u d j ʌ m
छलित	t͡ʃʰ ʌ l i t̪
जटे	d͡ʒ ʌ t̪ e
आँक	ä̃ k
भसाभस	bʱ ʌ s ä bʱ ʌ s
इमानदारी	i m ä n ʌ d ä r i
मड्क	m ʌ d̪ k
कुस्तुर	k u s t̪ u r
थान	t̪ʰ ä n
कुँदुवा	k ũ̯ d u v ä
कार्यरथी	k ä r j ʌ r ʌ t̪ʰ i
कलसाउँदो	k ʌ l s ä ũ̯ d o
ढाँड	ɖʱ ä̃ ɖ
खुम्बु	kʰ u m b u
अविजित	ʌ v i d͡ʒ i t̪
कर्कट	k ʌ r k ʌ t̪
उनन्‍तीस	u n ʌ n t̪ i s
सदा	s ʌ d ä
मिल्नु	m i l n u
ट्रेडिङ	t̪ r e d i ŋ
भन्दा	bʱ ʌ n d ä
बत्ती	b ʌ t̪ t̪ i
फुटवेयर	pʰ u t̪ v e j ʌ r
इच्छापत्र	i t͡ʃʰ ä p ʌ t̪ r
ओछो	o t͡ʃʰ o
एनान	e n ä n
हग्	ɦ ʌ ɡ
थपाइ	t̪ʰ ʌ p ä i
गुणहीन	ɡ u ɳ ɦ iː n
आन्तरिक	ɑː n t̪ ʌ r i k
मालिक	m ɑː l i k
छट	t͡ʃʰ ʌ t̪
ककनी	k ʌ k ʌ n i
पस्मिना	p ʌ s m i n ɑː
चौतीस	t͡ʃ ɔː t̪ iː s
मैलो	m ʌ i l o
ऐन्द्रकूट	ʌ i n d̪ r ʌ k uː t̪
गेगरान	ɡ e ɡ ʌ r ɑː n
सुम्लो	s u m l o
सतिसाल	s ʌ t̪ i s ɑː l
रसना	r ʌ s n ɑː
अकाल	ʌ k ɑː l
जयस्थिति	d͡ʒ ʌ j ʌ s t̪ʰ i t̪ i
रफ्तार	r ʌ f t̪ ɑː r
बाटोघाटो	b ɑː t̪ o ɡʱ ɑː t̪ o
मनिब्याग	m ʌ n i b j ɑː ɡ
झलझल	d͡ʒʱ ʌ l d͡ʒʱ ʌ l
खौवा	kʰ ɔː v ɑː
चिन्ताकुल	t͡ʃ i n t̪ ɑː k u l
खलनायक	kʰ ʌ l n ɑː j ʌ k
कार्यदल	k ɑː r j ʌ d ʌ l
कट्टु	k ʌ t̪ t̪ u
सिंहासन	s i ŋ ɦ ɑː s ʌ n
मर्चेन्ट	m ʌ r t͡ʃ e n t̪
मिलिसिया	m i l i s i j ɑː
कुञ्जी	k u ɲ d͡ʒ i
ट्युब	t̪ j u b
प्रमाणपत्र	p r ʌ m ɑː ɳ p ʌ t̪ r
ताण्डव	t̪ ɑː ɳ d̪ ʌ v
मोज	m o d͡ʒ
खस्क	kʰ ʌ s k
भुटान	bʱ u t̪ ɑː n
तमोर	t̪ ʌ m o r
कान्तिमान्	k ɑː n t̪ i m ɑː n
निशान	n i ʃ ɑː n
ट्रयाकबल	t̪ r j ɑː k ʌ b ʌ l
सिमसार	s i m s ɑː r
दैनिकी	d̪ ʌ i n i k i
पार्टी	p ɑː r t̪ iː
डिसेम्बर	d̪ i s e m b ʌ r
एकसट्ठी	e k s ʌ t̪ t̪ʰ iː
भ्यार्र	bʱ j ɑː r r
ख्याल	kʰ j ɑː l
थेग्	t̪ʰ e ɡ
विद्यावारिधि	v i d̪ j ɑː v ɑː r i d̪ʱ i
हाल्लहुल्ल	ɦ ɑː l l ʌ h u l l
बाइनरी	b ɑː i n ʌ r i
फट्याङ्ग्रो	f ʌ t̪ j ɑː ŋ ɡ r o
जुस	d͡ʒ u s
फाल	pʰ ä l
बुधुना	b u d̪ʱ u n ä
तत्त्व	t̪ ʌ t̪ t̪ʋ
भक्तिमान	bʱ ʌ k̚ t̪ i m ä n
घिनाहा	ɡʱ i n ä ɦ ä
असुरक्षा	ʌ s u r ʌ kʃ ä
आशाकारी	ä ʃ ä k ä r i
कलमजीवी	k ʌ l ʌ m d͡ʒ i ʋ i
जस्तो	d͡ʒ ʌ s t̪ o
बाण	b ä ɳ
कप्ल्याककुप्लुक्क	k ʌ p l j ä k ʌ k u p l u k̚ k
कन्डक्टर	k ʌ n̪ ɖ ʌ k t̪ ʌ r
कलकलाउँदो	k ʌ l ʌ k ʌ l ä u̯ n̪ d o
बछेडा-बछेडी	b ʌ t͡ʃʰ e ɖ ä - b ʌ t͡ʃʰ e ɖ i
उल्लसित	u l l ʌ s i t̪
साँघी	s ä̃ ɡʱ i
छप्प	t͡ʃʰ ʌ p p
थाल्नी	t̪ʰ ä l n i
ज्वालामुखी	d͡ʒ ʋ ä l ä m u kʱ i
चमचाम	t͡ʃ ʌ m ʌ t͡ʃ ä m
रुढी	r u ɖʱ i
रहनसहन	r ʌ ɦ ʌ n ʌ s ʌ ɦ ʌ n
सियाँल	s i j ä̃ l
जैरे	d͡ʒ ä i r e
असबल्ले	ʌ s ʌ b ʌ l l e
कार्बन	k ä r b ʌ n
डफ्फा	ɖ ʌ f f ä
विवश	ʋ i ʋ ʌ ʃ
भुपाल	bʱ u p ä l
निवृत्त	n i ʋ ɾ i t̪ t̪
त्यहीँ	t̪ j ʌ ɦ ĩ
मर्चेन्ट	m ʌ r t͡ʃʰ e n̪ t̪
थासो	t̪ʰ ä s o
चित	t͡ʃ i t̪
थाप्	t̪ʰ ä p
विघटन	ʋ i ɡʱ ʌ t̪ ʌ n
चुच्चेनङ्ग्रा	t͡ʃ u t͡ʃʰ e n ʌ ŋ ɡ r ä
जोइले	d͡ʒ o i l e
खपटे	kʰ ʌ p ʌ t̪ e
उफर्पाफर	u pʰ ʌ r p ä pʰ ʌ r
अणु	ʌ ɳ u
मध्यस्थता	m ʌ d̪ʱ j ʌ s t̪ʰ ʌ t̪ ä
रोकाया	r o k ä j ä
राजगद्दी	r ä d͡ʒ ʌ ɡ ʌ d̪ d i
गुरगुरी	ɡ u r ɡ u r i
तन	t̪ ʌ n
तसै	t̪ ʌ s ä i
ख्याति	kʰ j ä t̪ i
पूर्ण	p u r ɳ
ग्लानि	ɡ l ɑː n i
आत्मग्लानि	ɑː t m ɡ l ɑː n i
उच्छिन्न	u t͡ʃʰ i n n
मोजा	m o d͡ʒ ɑː
बिल्टो	b i l t o
झुट्ट	d͡ʒʱ u t t
हालसाल	ɦ ɑː l s ɑː l
सीता	s iː t ɑː
चोक्रे	t͡ʃ o k r e
जङ्गम	d͡ʒ ʌ ŋ ɡ ʌ m
आगा	ɑː ɡ ɑː
कनचिरा	k ʌ n ʌ t͡ʃ i r ɑː
कामधेनु	k ɑː m ʌ dʱ e n u
बग्रेन	b ʌ ɡ r e n
लाद्	l ɑː d
भरभित्तो	bʱ ʌ r bʱ i t t o
राम	r ɑː m
छुमछुम	t͡ʃʰ u m ʌ t͡ʃʰ u m
ड्रामा	ɖ r ɑː m ɑː
लोपचिह्न	l o p ʌ t͡ʃ i ɦ n
खेप्	kʰ e p
फकिर	pʰ ʌ k i r
सिँगारु	s i ŋ ɡ ɑː r u
नङ्ङि	n ʌ ŋ ɡ i
घोक्	ɡʱ o k
वात्सल्य	v ɑː t s ʌ l j ʌ
उपाय	u p ɑː j
कृयाकलाप	k r i ɑː k ʌ l ɑː p
क्रियाकलाप	k r i ɑː k ʌ l ɑː p
सेक्टर	s e k t ʌ r
वेबफोल्डर	v e b pʰ o l ɖ ʌ r
केशव	k e ʃ ʌ v
वर्काइफर्काइ	v ʌ r k ɑː i f ʌ r k ɑː i
तुलजा	t u l d͡ʒ ɑː
बियाउ	b i j ɑː u
उहुँ	u ɦ u ŋ
च्यान्टो	t͡ʃ j ɑː n t o
गुन्डा	ɡ u n ɖ ɑː
फट्ट	pʰ ʌ t t
सुरेन्द्र	s u r e n d r ʌ
समारोह	s ʌ m ɑː r o ɦ
गतिहारा	ɡ ʌ t i ɦ ɑː r ɑː
आमुन्नेसामुन्ने	ɑː m u n n e s ɑː m u n n e
सिराहा	s i r ɑː ɦ ɑː
तेक्वान्दो	t e k v ɑː n d o
अडाउ	ʌ ɖ ɑː u
लौरी	l aʊ r i
लुँडे	l u ŋ ɖ e
आविभूर्त	ɑː v i bʱ uː r t
आर्वर	ɑː r v ʌ r

    सम्भार	s ʌ m bʱ ä r
अप्रिय	ʌ p r i j
छुट्टा	t͡sʰ u ʈ ʈ ä
प्रतिदिन	p r ʌ t̪ i d̪ i n
कामयाब	k ä m j ä b
क्रियायोग	k r i j ä j o ɡ
मिलाप	m i l ä p
विधायक	b i d̪ʱ ä j ʌ k
बाउसे	b ä u s e
इन्टेल	i n ʈ e l
घ्याम्पे	ɡʱ j ä m p e
गजेन्द्र	ɡ ʌ d͡z e n d̪ r
एकसट्ठी	e k ʌ s ʈ ʈʰ i
खानदानी	kʰ ä n ʌ d̪ ä n i
अनसन	ʌ n ʌ s ʌ n
खै	kʰ ä i
ल्याफल्याफती	l j ä f l j ä f ʌ t̪ i
उतर्सि	u t̪ ʌ r s i
हात-हालाहाल	ɦ ä t̪ - ɦ ä l ä ɦ ä l
दमन	d̪ ʌ m ʌ n
खाँदिलो	kʰ ä̃ d̪ i l o
अतिक्रमण	ʌ t̪ i k r ʌ m ʌ n
गन्धर्व	ɡ ʌ n d̪ʱ ʌ r b
ख्याक्क	kʰ j ä k̚ k
समवाय	s ʌ m ʌ b ä j
सत्याग्रह	s ʌ t̪ j ä ɡ r ʌ ɦ
अनरसा	ʌ n ʌ r ʌ s ä
घाँस	ɡʱ ä̃ s
थिच्	ʈʰ i t͡s
अविचल	ʌ b i t͡s ʌ l
कमेन्ट	k ʌ m e n ʈ
लोकप्रियता	l o k p r i j ʌ t̪ ä
हरहर	ɦ ʌ r ɦ ʌ r
अनत	ʌ n ʌ t̪
फोटो	pʰ o ʈ o
दपेट्	d̪ ʌ p e ʈ
थान	ʈʰ ä n
रुद्री	r u d̪ r i
झूटो	d͡zʱ u ʈ o
अतर्कित	ʌ t̪ ʌ r k i t̪
करेट्	k ʌ r e ʈ
बढ्	b ʌ d̪ʱ
जिरिङ्ग	d͡z i r i ŋ ɡ
झाँगड	d͡zʱ ä̃ ɡ ʌ d̪
सिप्किनु	s i p k i n u
अक्षांश	ʌ kʂ ä̃ ʂ
गुम्क्र्याउ	ɡ u m k r j ä u
तिब्बत	t̪ i b b ʌ t̪
परिवहन	p ʌ r i b ʌ ɦ ʌ n
आहुत	ä ɦ u t̪
विजयोत्सव	v i d͡z j o t̪ s ʌ b
दन्तशूल	d̪ ʌ n̪ t̪ ʃ u l
लहना	l ʌ ɦ n ä
खारि	kʰ ä r i
स्वज्ञान	s ʋ ʌ d͡z ɲ ä n
कार्यशैली	k ä r j ʃ ä l i
रफ्तार	r ʌ f t ä r
अनुक्रमण	ʌ n u k r ʌ m ʌ n
पाँडे	p ä̃ ɖ e
सावा	s ä ʋ ä
अनुसार	ʌ n u s ä r
चिहान	t͡ʃ i ɦ ä n
चुइँकने	t͡ʃ u ĩ k n e
लौत	l ʌ u t
थुप्रा	t̪ʰ u p r ä
ऋजु	r i d͡z u
नर्सिङ	n ʌ r s i ŋ
थुर्	t̪ʰ u r
फिर्क	pʰ i r k
मूल	m u l
मुसल	m u s ʌ l
तरखर	t̪ ʌ r kʰ ʌ r
चुकुल	t͡ʃ u k u l
कीर्तिशाली	k i r t̪ i ʃ ä l i
ढुकढुकी	ɖʱ u k ɖʱ u k i
वाङ्‍मय	ʋ ä ŋ m ʌ j
आदिवासी	ä ʌ d̪ i ʋ ä s i
क्यानभास	k j ä n ʌ bʱ ä s
चयन	t͡ʃ ʌ j ʌ n
सनातन	s ʌ n ä t̪ ʌ n
मुगलान	m u ɡ ʌ l ä n
त्रिहत्तर	t̪ r i ɦ ʌ t̪ t̪ ʌ r
दरी	d̪ ʌ r i
गमनीय	ɡ ʌ m ʌ n i j
प्रमोद	p r ʌ m o d̪
रिसोर्ट	r i s o r t̪
टेलिभिजन	ʈ e l i bʱ i d͡z ʌ n
पद्यनाटक	p ʌ d̪ j ʌ n ä ʈ ʌ k
उद्‌गार	u d̪ ɡ ä r
कर्णफूल	k ʌ r ɳ ʌ pʰ u l
धर्मशास्त्र	d̪ʱ ʌ r m ʃ ä s t̪ r
वनभूमि	ʋ ʌ n ʌ bʱ u m i
धड्काइ	d̪ʱ ʌ ɖ k ä i
उम्र	u m r
त्रिचन्द्र	t̪ r i t͡ʃ ʌ n̪ d̪ r
डेरी	ɖ e r i
गद्दा	ɡ ʌ d̪ d̪ ä
ठोस	ʈʰ o s
दीप्‍ति	d̪ i p t̪ i
खुम्रि	kʰ u m r i

    चुइँकने	t͡ʃ u ĩ k n e
बजिर	b ʌ d͡ʒ i r
वृद्ध	b ɾ i d̪ːʱ
खौवा	kʰ ɔ u̯ ʋ ä
अभ्यर्थना	ʌ bʱ j ʌ r t̪ʰ n ä
नब्बे	n ʌ bː e
अपुङ्गी	ʌ p u ŋ g i
आस्वादक	ä s ʋ ä d ʌ k
झट्याक	d͡zʱ ʌ t̪ j ä k
लडे	l ʌ d̪ e
जोइले	d͡ʒ o i l e
घिनलाग्दो	ɡʱ i n l ä ɡ̞ d̪ o
सारौँ	s ä r ɔ̃
मनोभावना	m ʌ n o bʱ ä ʋ n ä
साहा	s ä ɦ ä
पहिचान्	p ʌ ɦ i t͡ʃ ä n
खानपान	kʰ ä n p ä n
खस्राङखुस्रुङ	kʰ ʌ s r ä ŋ kʰ u s r u ŋ
झूर	d͡zʱ u r
अजय	ʌ d͡ʒ ʌ j
बेथे	b e t̪ʰ e
बेमज्जा	b e m ʌ d͡ʒː ä
फाट्टफुट्ट	pʰ ä t̪ː pʰ u t̪ː
चेकपोस्ट	t͡ʃ e k ʌ p o s t̪
टकटका	t̪ ʌ k t̪ ʌ k ä
एक्लोपन	e k l o p ʌ n
राजेश	r ä d͡ʒ e ʃ
विशालबजार	b i ʃ ä l b ʌ d͡ʒ ä r
मारुनी	m ä r u n i
अन्योन्याश्रित	ʌ n j o n j ä ʃ r i t̪
चिन्हारु	t͡ʃ i n̪ ɦ ä r u
परुत्	p ʌ r u t̪
दनक	d̪ ʌ n ʌ k
शासनपतन्त्र	ʃ ä s ʌ n p ʌ t̪ ʌ n t̪ r
पुरस्कार	p u r ʌ s k ä r
साँबी	s ä̃ b i
मुना	m u n ä
फारु	pʰ ä r u
कार्यरथी	k ä r j ʌ r ʌ t̪ʰ i
भूउपग्रह	bʱ u u p ʌ ɡ r ʌ ɦ
ठूली	t̪ʰ u l i
मनुष्य	m ʌ n u ʃ j
फुटर	pʰ u t̪ ʌ r
बेल्ट	b e l t̪
खुल्	kʰ u l
सुन्नि	s u n n i
सरि	s ʌ r i
अदृश्य	ʌ d̪ r ʃ j
बैगुन	b ä i ɡ u n
उप-मार्ग	u p m ä r ɡ
रामकुमारी	r ɑː m k uː m ɑː r iː
जफत	j ʌ f ʌ t
उड्डयन	uː ɖː ʌ j ʌ n
सम्भोग	s ʌ m bʱ oː ɡ
अप्रिय	ʌ p r iː j
अल्पस्मृति	ʌ l p s ʌ m r̩ t iː
तन्दा	t ʌ n d ɑː
सिधेनुन	s iː dʱ eː n uː n
दुरावस्था	d uː r ɑː v ʌ s tʰ ɑː
झुर्र	ʤʱ uː r r
जिस्क	j iː s k
अपुङ्गी	ʌ p uː ŋ g iː
आक्रामक	ɑː k r ɑː m ʌ k
छान	tʃʰ ɑː n
घटिका	ɡʱ ʌ t iː k ɑː
खलनायक	kʰ ʌ l n ɑː j ʌ k
कुमारीपन	k uː m ɑː r iː p ʌ n
सभा	s ʌ bʱ ɑː
जलाम्मे	j ʌ l ɑː m m eː
झिम्रे	ʤʱ iː m r eː
धनसम्पत्ति	dʱ ʌ n s ʌ m p ʌ t t iː
खुर्क	kʰ uː r k
गणतन्त्री	ɡ ʌ n t ʌ n t r iː
दनदन	d ʌ n ʌ d ʌ n
आखिरी	ɑː kʰ iː r iː
खोजी	kʰ oː ʤ iː
फुलिस्केप	f uː l iː s k eː p
राजनेता	r ɑː ʤ n eː t ɑː
चलन	tʃ ʌ l ʌ n
एकजीउ	eː k ʌ ʤ iː uː
हेडर	ɦ eː ɖ r
सिरिङ्ङ	s iː r iː ŋ ŋ
घडघडे	ɡʱ ʌ ɖ ɡʱ ʌ ɖ eː
अगम्य	ʌ ɡ ʌ m j ʌ
बेकाम	b eː k ɑː m
खबटो	kʰ ʌ b ʌ t oː
अप्रधान	ʌ p r ʌ dʱ ɑː n
सराप	s ʌ r ɑː p
क्रियाकलाप	k r iː j ɑː k ʌ l ɑː p
खिस्सा	kʰ iː s s ɑː
आनन्दित	ɑː n ʌ n d iː t
जनशक्ति	ʤ ʌ n ʃ ʌ k t iː
गउँत	ɡ ʌ uː n t
आँखीभुईँ	ɑː ŋ kʰ iː bʱ uː iː ŋ
कपोत	k ʌ p oː t
वाञ्छना	v ɑː ɲ tʃʰ n ɑː
चाट्	tʃ ɑː t
कखौतो	k ʌ kʰ ʌ uː t oː
भ्वाँक	bʱ v ɑː ŋ k
जटे	ʤ ʌ t eː
उपाय	u p aː j
मुद्दा	m u d̪ d̪ aː
पोल्टो	p o lʈ o
आलमारी	aː l m aː r i
बलदेव	b a l d̪ eː ʋ
यथा	j a t̪ʰ aː
बाबुआमा	b aː b u aː m aː
इन्डिया	i n̪ ɖ i j aː
भरभित्तो	bʱ a r bʱ i t̪ʰ o
उपहार	u p aː ɦ aː r
त्रिवेणी	t̪ r i ʋ eː ɳ iː
अनुशासित	a n u ʃ aː s i t̪
गुहार	ɡ u ɦ aː r
पञ्चैती	p a ɲ t͡ʃ aɪ t̪ iː
योञ्जन	j o ɲ d͡ʒ n̪
अनुपमेय	a n u p m eː j
प्रवर्तन	p r ʋ a r t̪ n̪
नमुना	n a m u n aː
असन्तुलन	a s n̪ t̪ u l n̪
क्यारेक्टर	k j aː r eː kʈ ə r
आस	aː s
अवतरण	a ʋ t̪ r ɳ
चारित्र	t͡ʃ aː r i t̪ r
चिउँडो	t͡ʃ i ũ ɖ o
सपक्क	s p k k
प्रदर्शनकारी	p r d̪ ə r ʃ n̪ k aː r i
सरदार	s r d̪ aː r
अमलबाज	a m l b aː d͡ʒ
थाप्ला	t̪ʰ aː p l aː
कुशासन	k u ʃ aː s n̪
अधमरो	a d̪ʱ m r o
रण	r ɳ
ठिङुरि	ʈʰ i ŋ u r i
आक्रान्त	aː k r aː n̪ t̪
उवासंघ	u ʋ aː s ŋ̊ ɡʱ
कुशलता	k u ʃ l t̪ aː
इथर	i t̪ʰ r
अविभाज्य	a ʋ i bʱ aː d͡ʒ j
कुक्रुक्क	k u k r u k k
अदृष्टपूर्व	a d̪ r ʂʈ p uː r ʋ
ज्ञानवरणीय	d͡ʒ ɲ aː n̪ ʋ r ɳ iː j
थेगो	t̪ʰ eː ɡ o
कुटकी	k uʈ k iː
उचाइ	u t͡ʃ aː i
बालाजु	b aː l aː d͡ʒ u
हीनता	ɦ iː n̪ t̪ aː
ओझेल	o d͡ʒʱ eː l
मानवजाति	m aː n̪ ʋ d͡ʒ aː t̪ i
चलुवा	t͡ʃ l u ʋ aː
तन	t̪ n̪

    लेखापरीक्षण	l e kʰ ɑ p ɑ r i kʃ ɑ n
सालो	s ɑː l o
अग्रिम	ʌ ɡ r i m
हृदय	ɦ ɾ i d ʌ j
ज्वान	ʤ w ɑː n
राष्ट्रनायक	r ɑː ʃ t̪ r ɳ ɑː j ʌ k
इन्कार	i n k ɑː r
छादित	t͡ʃʰ ɑː d i t
विघटन	b i ɡʱ ʌ t̪ ʌ n
तागत	t ɑː ɡ ʌ t
टसक्क	ʈ s ʌ k k
अम्बुज	ʌ m b u ʤ
बिमाख	b i m ɑː kʰ
मालिका	m ɑː l i k ɑː
झस्का	ʤʱ ʌ s k ɑː
टपरे	ʈ p ʌ r e
सावधान	s ɑː w ʌ dʱ ɑː n
हन्न	ɦ ʌ n ʌ
हाइटी	ɦ ɑː i ʈ iː
आगो	ɑː ɡ o
आभ्यास	ɑː bʱ j ɑː s
थु:	ʈʰ uː
उछिनपाछिन	u t͡ʃʰ i n p ɑː t͡ʃʰ i n
तोड	t o ɖ
च्वास्स	t͡ʃ w ɑː s s
आश्रम	ɑː ʃ r ʌ m
माहुर	m ɑː ɦ u r
होचि	ɦ o t͡ʃ i
टेस्टट्युब	ʈ e s ʈ ʈ j u b
ब्रह्‍मर्षि	b r ʌ ɦ m ʌ r ʃ i
स्वेच्छ्या	s w e t͡ʃʰ ʧʰ j ɑː
ब्यबहार	b j ʌ b ʌ ɦ ɑː r
योञ्जन	j o ɲ ʤ ʌ n
ढेडु	ɖʱ e ɖ u
सुका	s u k ɑː
छ्‌वाँके	t͡ʃʰ w ɑ̃ k e
देवर्षि	d e b ʌ r ʃ i
रकाबी	r ʌ k ɑː b i
उदयोन्मुख	u d ʌ j o n m u kʰ
डिनर	ɖ i n ʌ r
अड्कल्	ʌ ɖ k ʌ l
लोपचिह्न	l o p t͡ʃ i ɦ ʌ n
यती	j ʌ t iː
गुनगुन	ɡ u n ɡ u n
उपरि	u p ʌ r i
हर्सा	ɦ ʌ r s ɑː
थाप्	ʈʰ ɑː p
दिशाकुञ्जी	d i ʃ ɑː k u ɲ ʤ iː
उचाइ	u t͡ʃ ɑː i
विपक्षी	b i p ʌ kʃ i
अपरिणामी	ʌ p ʌ r i ɳ ɑː m i
लठैत	l ʌ tʰ ɑː i t
सुमर्	s u m ʌ r
कठ्याङ्ग्रि	k ʌ tʰ j ɑː ŋ g r i
केश	k e ʃ
निदाल	n i d ɑː l
गणित	g ʌ ɳ i t
मानवाधिकार	m ɑː n ʌ v ɑː dʱ i k ɑː r
यता	j ʌ t ɑː
अरुन्धती	ʌ r u n dʱ ʌ t i
भरभित्तो	bʱ ʌ r bʱ i tʰ ʈ o
अधिकारवाला	ʌ dʱ i k ɑː r v ɑː l ɑː
अगाडि	ʌ g ɑː d i
जगदम्बा	j ʌ g ʌ d ʌ m b ɑː
आटा	ɑː ʈ ɑː
अथक	ʌ tʰ ʌ k
सुलसुल	s u l ʌ s u l
इख	i kʰ
आँठो	ɑː ŋ tʰ o
जम्बु	j ʌ m b u
जीउसाँचा	j iː u s ɑː ŋ tʃ ɑː
छिपाउ	tʃʰ i p ɑː u
मिट्टी	m i ʈ ʈ iː
सुर्खेत	s u r kʰ e t
तुर्लुङ्ङ	t u r l u ŋ ŋ
लोहनी	l o ɦ ʌ n i
न्याय	n j ɑː j
पटटट	p ʌ ʈ ʌ ʈ ʌ ʈ
प्लेग	p l e g
आपत	ɑː p ʌ t
अभिशाप	ʌ bʱ i ʃ ɑː p
चिम्टे	tʃ i m ʈ e
प्रेसिडेन्ट	p r e s i d e n ʈ
विरोह	v i r o ɦ
धनञ्जय	dʱ ʌ n ʌ ɳ j ʌ j
तिम्रो	t i m r o
बिक्	b i k
पुरेत	p u r e t
कसरी	k ʌ s ʌ r i
फ्याल्ल	pʰ j ɑː l l
बिँगो	b i ŋ g o
आत्मसन्तोष	ɑː t m ʌ s ʌ n t o ʃ
पेटिका	p e ʈ i k ɑː
थर्क	tʰ ʌ r k
अमीर	ʌ m iː r
उकुसमुकुस	u k u s ʌ m u k u s
विराजमान	v i r ɑː j m ɑː n
दर्द	d ʌ r d
रात्रि	r ɑː t r i
आज	ɑː j
चयनशील	t͡ʃ ə j ə n ə ʃ iː l
हन्न	ɦ ə nː ə
पर्वाह	p ə r w ɑː ɦ
सोझि	s o d͡ʒ ɦ i
कम्युनिष्‍ट	k ə m j uː n i ʃ ʈ
अद्यतन	ə d j ə t ə n
गम्मागम्मी	ɡ ə m m ɑː ɡ ə m m iː
टसक्क	ʈ ə s ə kː
आरोहण	ɑː r o ɦ ə ɳ
झेलाहा	d͡ʒ ʱ eː l ɑː ɦ ɑː
झाँगकझुँगल	d͡ʒ ʱ ɑ̃ː ɡ ə k d͡ʒ ʱ ũː ɡ ə l
लटपट	l ə ʈ p ə ʈ
ह्वाप्प	ɦ w ɑː pː
टोपल्	ʈ oː p ə l
परिच्छेद	p ə r i t͡ʃʰ ʰ eː d
परिमिति	p ə r i m i t i
इकोसिस्टम	iː k oː s i s ʈ ə m
हे	ɦ eː
भागा	bʱ ɑː ɡ ɑː
सेवक	s eː w ə k
ढाल्	ɖʱ ɑː l
गर्भपाती	ɡ ə r bʱ p ɑː t iː
अपरेटर	ə p ə r eː ʈ ə r
चाटुकार	t͡ʃ ɑː ʈ uː k ɑː r
कम्मर	k ə m m ə r
अध्ययन	ə dʱ j ə j ə n
बालाजु	b ɑː l ɑː d͡ʒ u
पाडरी	p ɑː ɖ r iː
प्वाइन्ट	p w ɑː i n ʈ
गव्य	ɡ ə w j ə
कुँवर	k ũː w ə r
चिप्ल	t͡ʃ i p l ə
उगाउ	u ɡ ɑː u
अनुन्मुक्त	ə n u n m u k t ə
खुच्चिङ	kʰ u t͡ʃ t͡ʃ i ŋ
रोकाया	r o k ɑː j ɑː
आधाररेखा	ɑː dʱ ɑː r ə r eː kʰ ɑː
भित्ति	bʱ i t t i
झिलझिल	d͡ʒ ʱ i l d͡ʒ ʱ i l
काँकडभिट्टा	k ɑ̃ː k ə ɖ bʱ i ʈ ʈ ɑː
अब्रह्मचर्य	ə b r ə ɦ m ə t͡ʃ ə r j ə
खाका	kʰ ɑː k ɑː
भ्यार्र	bʱ j ɑː r r ə
कुचेष्टा	k u t͡ʃ eː ʂ ʈ ɑː
चहार	t͡ʃ ə ɦ ɑː r
छिनुवा	t͡ʃʰ i n u w ɑː
सड्क	s ə ɖ k ə
धुनी	dʱ u n iː
कट्टु	k ə ʈ ʈ u
झेली	d͡ʒ ʱ eː l i
