فحم	f a ħ m
سرط	s a r a tˤ a
للأسف	l i l ʔ a s a f
مومس	m uː m i s
مهنة	m i h n a
تودريج	t uː d a r iː d͡ʒ
خارصين	x aː r a sˤ iː n
حوافل	ħ a w aː f i l
أوعية	ʔ a w ʕ i j a
عميق	ʕ a m iː q
منبه	m u n a b b i h
صؤل	sˤ a ʔ u l a
حوالي	ħ a w aː l a j
تكدس	t a k a d d a s a
مستقبل	m u s t a q b a l
حورس	ħ uː r u s
ديناميكا	d iː n aː m iː k aː
محول	m u ħ a w w i l
كلبة	k a l b a
بلغم	b a l ɣ a m
متسامح	m u t a s aː m i ħ
كتابة	k i t aː b a
مجري	m a d͡ʒ a r i j j
سجين	s a d͡ʒ iː n
تنزانيا	t a n z aː n j aː
تالي	t aː l iː
تذكار	t a ð k aː r
قتلة	q a t l a h
استطار	i s t a tˤ aː r a
فقاقيع	f a q aː q iː ʕ
مناخي	m a n aː x i j j
خرزة	x u r z a
ترصد	t a r a sˤ sˤ a d a
طنجيرة	tˤ a n d͡ʒ iː r a
محمد	m a ħ m a d
منقار	m a n q aː r
رونق	r a w n a q
إكتاب	ʔ i k t aː b
مملوك	m a m l uː k
مصراع	m i sˤ r aː ʕ
حيوان	ħ a j a w aː n
نعامة	n a ʕ aː m a
انسلخ	i n s a l a x a
عفيف	ʕ a f iː f
إقالة	ʔ i q aː l a
ملقن	m u l a q q i n
نشرة	n a ʃ r a
كادس	k aː d i s
بسكرة	b i s k a r a
سبج	s a b a d͡ʒ
لله	l i l l aː h
شحاذة	ʃ i ħ aː ð a
بوسكورة	b uː s k uː r a
أوحد	ʔ a w ħ a d
ازدحم	i z d a ħ a m a
قربان	q i r b aː n
جرذ	d͡ʒ u r a ð
رعرع	r a ʕ r a ʕ a
سار	s aː r r
أقرع	ʔ a q r a ʕ
إكليل	ʔ i k l iː l
ذروة	ð u r w a
ضمة	dˤ a m m a
استثمار	i s t i θ m aː r
حلتيث	ħ i l t iː θ
مراهق	m u r aː h i q
خلاعي	x a l aː ʕ i j j
تعليق	t a ʕ l iː q
دند	d a n d
مرادف	m u r aː d i f
اتحد	i t t a ħ a d a
ميتوكندريون	m iː t uː k u n d r i j uː n
حكومة	ħ u k uː m a
فوف	f uː f
متناول	m u t a n aː w i l
بلغاري	b u l ɣ aː r i j j
طاف	tˤ aː f a
تناوم	t a n aː w a m a
إذاعة	ʔ i ð aː ʕ a
فصد	f a sˤ a d a
أرسطوطاليس	ʔ a r i s tˤ uː tˤ aː l iː s
دلل	d a l l a l a
رائع	r aː ʔ i ʕ
استشرق	i s t a ʃ r a q a
حسنا	ħ a s s a n n aː
شهلة	ʃ a h l a
إبيقوري	ʔ i b iː q uː r i j j
أوضح	ʔ a w dˤ a ħ a
قبج	q a b a d͡ʒ
أبها	ʔ a b h aː
ملكوت	m a l a k uː t
فني	f a n i j a
مريء	m a r iː ʔ
محن	m i ħ a n
قفة	q u f f a
وطني	w a tˤ a n i j j
خصوص	x u sˤ uː sˤ
مثنان	m a θ n aː n
تقدم	t a q a d d a m a
سبأ	s a b a ʔ
فاجرة	f aː d͡ʒ i r a
لوياثان	l a w i j aː θ aː n
بخير	b i x a j r
تطبب	t a tˤ a b b a b a
مرجع	m a r d͡ʒ i ʕ
أصطرك	ʔ a sˤ tˤ a r a k
أنتن	ʔ a n t u n n a
نفقة	n a f a q a
ميمون	m a j m uː n
لام	l aː m
تحرش	t a ħ a r r a ʃ a
تقدد	t a q a d d a d a
أعز	ʔ a ʕ a z z
حلتيت	ħ a l t iː t
مكسور	m a k s uː r
مجادلة	m u d͡ʒ aː d a l a h
مقالة	m a q aː l a
تهدد	t a h a d d a d a
أتقن	ʔ a t q a n a
تهالك	t a h aː l a k a
عران	ʕ i r aː n
قداحة	q a d d aː ħ a
دفتر	d a f t a r
إناء	ʔ i n aː ʔ
انقضاض	i n q i dˤ aː dˤ
توصية	t a w sˤ i j a
هراوة	h i r aː w a
وجنة	w a d͡ʒ n a
عرنسية	ʕ a r a n s i j j a
قذارة	q a ð aː r a
نزية	n a z i j j a
تباطأ	t a b aː tˤ a ʔ a
ماعون	m aː ʕ uː n
مذيع	m u ð iː ʕ
حيثيات	ħ a j θ i j j aː t
قراءة	q i r aː ʔ a
حرقدة	ħ a r q a d a
توتيا	t uː t i j aː
القرآن	a l q u r ʔ aː n
بطرك	b a tˤ r a k
فوضى	f a w dˤ aː
عنبروت	ʕ a n b a r uː t
حسناء	ħ a s n aː ʔ
ودج	w a d a d͡ʒ
واشنطن	w aː ʃ i n tˤ u n
اكتحل	i k t a ħ a l a
قابلية	q aː b i l i j j a
جذع	d͡ʒ a ð a ʕ
شاهلوج	ʃ aː h a l uː d͡ʒ
وسع	w a s i ʕ a
موسكو	m uː s k uː
كيرلس	k iː r u l u s
مقشرة	m i q ʃ a r a
لكمة	l a k m a
ذال	ð aː l
مثار	m u θ aː r
عدمية	ʕ a d a m i j j a
حصاد	ħ a sˤ aː d
جنسية	d͡ʒ i n s i j j a
كعك	k a ʕ k
اكتفى	i k t a f aː
عظم	ʕ a ðˤ m
أخدر	ʔ a x d a r
أمان	ʔ a m aː n
بالوعات	b aː l uː ʕ aː t
قاليقلا	q aː l iː q a l aː
غدير	ɣ a d iː r
مدرك	m u d r a k
أول	ʔ a w w a l
عناب	ʕ u n n aː b
لاسلطوي	l aː s u l tˤ a w i j j
وبيل	w a b iː l
مخطئ	m u x tˤ i ʔ
مري	m u r iː
برشيد	b a r ʃ iː d
صواع	sˤ i w aː ʕ
بين	b a j n a
رابطة	r aː b i tˤ a
دمدم	d a m d a m a
ثانوي	θ aː n a w i
إشبينة	ʔ i ʃ b iː n a
ملاتيوس	m i l aː t i j uː s
قرطاجي	q a r tˤ aː d͡ʒ i j j
اليسع	a l j a s a ʕ
نتوء	n u t uː ʔ
فوطة	f uː tˤ a
عزا	ʕ a z aː
ساء	s aː ʔ a
كانون	k aː n uː n
قومية	q a w m i j j a
عمى	ʕ a m m aː
لاسلطوية	l aː s u l tˤ a w i j j a
مرحلة	m a r ħ a l a
باسل	b aː s i l
نادل	n aː d i l
عمودي	ʕ a m uː d i j j
اختل	i x t a l l a
أبتر	ʔ a b t a r
مساطر	m a s aː tˤ i r
صرافة	sˤ a r r aː f a
عيني	ʕ a j n i j j
اشترى	i ʃ t a r aː
بلاهة	b a l aː h a
بعير	b a ʕ iː r
قيتار	q iː t aː r
دنو	d u n u w w
عاصف	ʕ aː sˤ i f
أبكم	ʔ a b k a m
فرسخ	f a r s a x
بوصير	b uː sˤ iː r
وقود	w a q uː d
عنيف	ʕ a n iː f
كره	k a r h
تمنى	t a m a n n aː
زعتر	z a ʕ t a r
مروحة	m i r w a ħ a
عفت	ʕ a f a t a
قشف	q a ʃ i f a
اختط	i x t a tˤ tˤ a
سرخس	s a r x a s
مظهر	m a ðˤ h a r
نبذة	n u b ð a
ملاك	m u l l aː k
مقدونس	m a q d uː n i s
عليق	ʕ u l l a j q
أكتوبر	ʔ a k t uː b a r
إهليلج	ʔ i h l iː l a d͡ʒ
حوب	ħ uː b
قلب	q a l a b a
وزراء	w u z a r aː ʔ
إسكتلندا	ʔ i s k u t l a n d aː
رسداق	r u s d aː q
تجرع	t a d͡ʒ a r r a ʕ a
جاذبية	d͡ʒ aː ð i b i j j a
مكتب	m a k t a b
سلح	s a l a ħ a
اصطدأ	i sˤ tˤ a d a ʔ a
عراك	ʕ i r aː k
نخشوش	n a x ʃ uː ʃ
قذيفة	q a ð iː f a
أيهقان	ʔ a j h a q aː n
عتب	ʕ a t a b
المكسيك	a l m a k s iː k
ناخوذة	n aː x uː ð a
كويكب	k u w a j k i b
شبح	ʃ a b a ħ
مسود	m u s w a d d
الكاميرون	a l k aː m iː r uː n
برقوق	b a r q uː q
داعش	d aː ʕ i ʃ
وراط	w i r aː tˤ
غالبية	ɣ aː l i b i j j a
وتدي	w a t a d i j j
أفسنتين	ʔ a f s i n t iː n
هجوم	h u d͡ʒ uː m
فسيفساء	f u s a j f i s aː ʔ
مدبر	m u d a b b i r
أناغلس	ʔ a n aː ɣ a l i s
نخاع	n u x aː ʕ
جزدان	d͡ʒ i z d aː n
صحى	sˤ a ħ ħ aː
رهينة	r a h iː n a
تعويذة	t a ʕ w iː ð a
خالف	x aː l a f a
أذاع	ʔ a ð aː ʕ a
ربت	r a b b a t a
فعالية	f a ʕ ʕ aː l i j j a
استيقظ	i s t a j q a ðˤ a
عربيزي	ʕ a r a b iː z i j j
قفص	q a f a sˤ
كزمازج	k a z m aː z a d͡ʒ
بلادونا	b i l aː d uː n aː
شاقولي	ʃ aː q uː l i j j
ضاحية	dˤ aː ħ i j a
تصالح	t a sˤ aː l a ħ a
انتشار	i n t i ʃ aː r
سنط	s a n tˤ
عادة	ʕ aː d a
ركبة	r a k a b a
إسكتلندي	ʔ i s k u t l a n d i j j
هيبة	h a j b a
حلال	ħ a l aː l
زوم	z uː m
ذئبة	ð i ʔ b a
طعام	tˤ a ʕ aː m
حمصيص	ħ a m a sˤ iː sˤ
جلنار	d͡ʒ u l l a n aː r
ماه	m aː h a
مغلوب	m a ɣ l uː b
أكشف	ʔ a k ʃ a f a
فاسد	f aː s i d
الصربية	a sˤ sˤ i r b i j j a
أفقي	ʔ u f u q i j j
مضايف	m a dˤ aː j i f
لكنة	l u k n a
عقيدة	ʕ a q iː d a
فكرة	f i k r a
ذرة	ð a r r a
عباءة	ʕ a b aː ʔ a
فيما	f iː m aː
تغريدة	t a ɣ r iː d a
تنحى	t a n a ħ ħ aː
صراع	sˤ i r aː ʕ
مقاص	m a q aː sˤ sˤ
ليلي	l a j l i j j
هواء	h a w aː ʔ
إعلامي	ʔ i ʕ l aː m i j j
تعطى	t a ʕ a tˤ tˤ aː
رقيب	r a q iː b
فانيد	f aː n iː d
هلسنكي	h i l s i n k iː
قريب	q a r iː b
قطيفة	q a tˤ iː f a
رخخة	r i x a x a
فناء	f a n aː ʔ
غيرة	ɣ a j r a
رائب	r aː ʔ i b
أرهب	ʔ a r h a b a
أصبح	ʔ a sˤ b a ħ
اصطك	i sˤ tˤ a k k a
حماق	ħ a m aː q
آسيوي	ʔ aː s i j a w i j j
تصادم	t a sˤ aː d a m a
ديسمبر	d iː s a m b a r
قندهار	q u n d u h aː r
ميم	m iː m
ضخم	dˤ a x m
جمهور	d͡ʒ u m h uː r
استمر	i s t a m a r r a
أموي	ʔ u m a w i j j
علم	ʕ a l a m
اتجه	i t t a d͡ʒ a h a
تخطى	t a x a tˤ tˤ aː
أوقد	ʔ a w q a d a
أعرن	ʔ a ʕ r a n a
استخدم	i s t a x d a m a
أيون	ʔ a j uː n
قلم	q a l a m
فاشرا	f aː ʃ i r aː
الآن	a l ʔ aː n a
مرحاض	m i r ħ aː dˤ
رطانة	r a tˤ aː n a
هدس	h a d a s
سقرلاط	s i q i r l aː tˤ
كسا	k a s aː
سورة	s a w r a
نذير	n a ð iː r
إدريس	ʔ i d r iː s
الحبشة	a l ħ a b a ʃ a
منطقي	m a n tˤ i q i j j
أتاح	ʔ a t aː ħ a
صنارة	sˤ i n aː r a
اتعاظ	i t t i ʕ aː ðˤ
خزانة	x i z aː n a
صلابة	sˤ a l aː b a
معنى	m a ʕ n aː
محرك	m u ħ a r r i k
كشتبان	k u ʃ t u b aː n
تدريج	t a d r iː d͡ʒ
بروناي	b r uː n aː j
تزعزع	t a z a ʕ z a ʕ a
صلعة	sˤ a l ʕ a
مهندس	m u h a n d i s
تتلى	t u t l aː
زنخ	z a n i x a
أولياء	ʔ a w l i j aː ʔ
طابور	tˤ aː b uː r
مناعة	m a n aː ʕ a
تجربة	t a d͡ʒ r i b a
مسافة	m a s aː f a
أطنب	ʔ a tˤ n a b a
ارتباك	i r t i b aː k
وزغة	w a z a ɣ a
حيهل	ħ a j j a h a l
أنزع	ʔ a n z a ʕ a
سراح	s a r aː ħ
ممحوق	m a m ħ uː q
تراجيديا	t r aː d͡ʒ iː d j aː
حنيف	ħ a n iː f
أبش	ʔ a b a ʃ a
أعتاب	ʔ a ʕ t aː b
أرز	ʔ a r a z z a
بأس	b a ʔ s
ضمير	dˤ a m iː r
نائم	n aː ʔ i m
حاسم	ħ aː s i m
وزنة	w a z n a
كرز	k a r a z
ناقل	n aː q i l
لهاث	l u h aː θ
فوار	f a w w aː r
قلية	q i l l i j j a
بغاء	b i ɣ aː ʔ
ابتنى	i b t a n aː
أسس	ʔ a s s a s a
فريسة	f a r iː s a
نصراني	n a sˤ r aː n i j j
خامس	x aː m i s
عيدية	ʕ iː d i j j a
مرصبان	m a r sˤ a b aː n
ظيان	ðˤ a j j aː n
يبروح	j a b r uː ħ
مختبر	m u x t a b a r
نعناع	n a ʕ n aː ʕ
درع	d a r r a ʕ a
عجرفة	ʕ a d͡ʒ r a f a
قاعة	q aː ʕ a
يونس	j uː n u s
مشرك	m u ʃ r i k
أعصر	ʔ a ʕ sˤ a r a
عشيرة	ʕ a ʃ iː r a
سعد	s u ʕ d
سدل	s a d a l a
قاف	q aː f
تعسفي	t a ʕ a s s u f i j j
ألا	ʔ a l aː
تأميم	t a ʔ m iː m
مغلق	m i ɣ l a q
بركار	b i r k aː r
دشمة	d u ʃ m a
بئسما	b i ʔ s a m aː
شذر	ʃ a ð r
رياضة	r i j aː dˤ a
شره	ʃ a r i h a
صدغ	sˤ a d ɣ
ثقبة	θ u q b a
سقراط	s u q r aː tˤ
صاخة	sˤ aː x x a
مجرفة	m i d͡ʒ r a f a
عبودية	ʕ u b uː d i j j a
مصبنة	m a sˤ b a n a
مذكرة	m u ð a k k a r a
تاء	t aː ʔ
خزامى	x u z aː m aː
رتيلة	r u t a j l a
إبليز	ʔ i b l iː z
فرقاطة	f i r q aː tˤ a
آخر	ʔ aː x a r
قتل	q a t a l a
بلاغة	b a l aː ɣ a
ميانمار	m i j aː n m aː r
ثانية	θ aː n i j a
صربيا	sˤ i r b i j aː
وريد	w a r iː d
معزف	m i ʕ z a f
أباخس	ʔ a b aː x i s u
فنجنكشت	f a n d͡ʒ a n k u ʃ t
حلقة	ħ a l a q a
نعيم	n a ʕ iː m
رضى	r u dˤ aː
السفن	a s s u f u n
غزاوة	ɣ a z aː w a
صحي	sˤ a ħ i j a
غباء	ɣ a b aː ʔ
منبر	m i n b a r
علاجي	ʕ i l aː d͡ʒ iː
هرول	h a r w a l
قعد	q a ʕ a d a
أشوس	ʔ a ʃ w a s
مغنم	m a ɣ n a m
ظمئ	ðˤ a m i ʔ a
بسفايج	b a s f aː j a d͡ʒ
ساط	s aː tˤ a
أتوم	ʔ a t uː m
مكمل	m u k a m m a l
صفع	sˤ a f a ʕ a
لادن	l aː d a n
عمان	ʕ a m m aː n
انتهى	i n t a h aː
ناميبيا	n aː m iː b j aː
قويعدة	q u w a j ʕ i d a
هارون	h aː r uː n
تدريب	t a d r iː b
غذى	ɣ a ð ð aː
مالاوي	m aː l aː w iː
أخصائي	ʔ a x i sˤ sˤ aː ʔ i j j
نانخواة	n aː n a x w aː h
نادى	n aː d aː
جثة	d͡ʒ u θ θ a
نفط	n a f tˤ
بابل	b aː b i l
رزداق	r u z d aː q
دوغ	d uː ɣ
أخمص	ʔ a x m u sˤ
منور	m a n w a r
حكة	ħ i k k a
رخيص	r a x iː sˤ
خرج	x a r a d͡ʒ a
فدائي	f i d aː ʔ i j j
أحول	ʔ a ħ w a l
حصان	ħ i sˤ aː n
كرج	k a r i d͡ʒ a
مدام	m u d aː m
وقية	w i q i j j a
لاوس	l aː w s
كسوة	k i s w a
رئاسة	r i ʔ aː s a
عادات	ʕ aː d aː t
جوذاب	d͡ʒ uː ð aː b
أريزونا	ʔ a r iː z uː n aː
عالمي	ʕ aː l a m i j j
انتقل	i n t a q a l a
صربي	sˤ i r b i j j
غلاء	ɣ a l aː ʔ
ورن	w a r a n
جذر	d͡ʒ a ð a r a
نموذج	n a m uː ð a d͡ʒ
رغيفة	r a ɣ iː f a
إشبيلية	ʔ i ʃ b iː l i j a
أسياخ	ʔ a s j aː x
هدار	h a d d aː r
فراغ	f a r aː ɣ
مليء	m a l iː ʔ
رجب	r a d͡ʒ a b
دبلجة	d a b l a d͡ʒ a
تشهل	t a ʃ a h h a l a
نافذة	n aː f i ð a
براغ	b r aː ɣ
حيث	ħ a j θ u
صوف	sˤ a w i f a
أفل	ʔ a f a l a
ضوى	dˤ a w aː
حيطة	ħ a j tˤ a
كوخ	k uː x
وردة	w a r d a
مرارة	m a r aː r a
فتوى	f a t w aː
إحسان	ʔ i ħ s aː n
ماجد	m aː d͡ʒ i d
أطباء	ʔ a tˤ i b b aː ʔ
السودان	a s s uː d aː n
مكالمة	m u k aː l a m a
أكثرية	ʔ a k θ a r i j j a
بناية	b i n aː j a
حامض	ħ aː m i dˤ
زحزح	z a ħ z a ħ a
إسناد	ʔ i s n aː d
جزمازق	d͡ʒ a z m aː z a q
قيصوم	q a j sˤ uː m
قوم	q a w m
بوذي	b uː ð i j j
جبانات	d͡ʒ a b aː n aː t
تساوى	t a s aː w aː
صفن	sˤ a f a n
تعالم	t a ʕ aː l a m a
شطر	ʃ a tˤ a r a
بعيد	b a ʕ iː d
شمس	ʃ a m a s
تسعمائة	t i s ʕ u m i ʔ a
عند	ʕ i n d a
طقم	tˤ a q m
شلباية	ʃ i l b aː j a
وثيقة	w a θ iː q a
وحمة	w a ħ m a
ضاع	dˤ aː ʕ a
الكنية	a l k u n j a
بارز	b aː r a z a
وعدة	w a ʕ d a
وجد	w a d͡ʒ a d a
رأسي	r a ʔ s i j j
نزهة	n u z h a
بقشة	b u q ʃ a
بلاذر	b a l aː ð i r
خلنجان	x a l a n d͡ʒ aː n
اشهلال	i ʃ h i l aː l
دغدغ	d a ɣ d a ɣ a
مرقشيتا	m a r q a ʃ iː t aː
وثيق	w a θ iː q
لثغة	l u θ ɣ a
الجمعة	a l d͡ʒ u m a ʕ a
محى	m a ħ aː
اجتلى	i d͡ʒ t a l aː
كامخ	k aː m a x
صيخود	sˤ a j x uː d
أبريل	ʔ a b r iː l
مرفوع	m a r f uː ʕ
تكميلي	t a k m iː l i j j
ضالين	dˤ aː l l iː n
فركس	f i r k i s
بكارج	b a k aː r i d͡ʒ
عبادة	ʕ i b aː d a
أنبذ	ʔ a n b a ð a
لوز	l a w z
طرق	tˤ a r a q a
عائلة	ʕ aː ʔ i l a
خسأ	x a s a ʔ a
ممتلئ	m u m t a l i ʔ
قسطران	q a s tˤ a r aː n
كنيسة	k a n iː s a
شعير	ʃ a ʕ iː r
اعتدى	i ʕ t a d aː
نوراني	n uː r aː n i j j
سئم	s a ʔ i m a
شهدانق	ʃ a h d aː n a q
هبد	h a b d
داخل	d aː x a l a
السنغال	a s s i n i ɣ aː l
زرجون	z a r d͡ʒ uː n
تداعى	t a d aː ʕ aː
قاض	q aː dˤ a
تلحين	t a l ħ iː n
أوقف	ʔ a w q a f a
بلعوم	b u l ʕ uː m
رعراع	r a ʕ r aː ʕ
متماد	m u t a m aː d d
دون	d a w w a n a
أترج	ʔ u t r u d͡ʒ d͡ʒ
جور	d͡ʒ a w r
تربية	t a r b i j a
عصيب	ʕ a sˤ iː b
سيماء	s iː m aː ʔ
ملوخيا	m u l uː x i j j aː
كوة	k a w w a
ليمي	l a j m i j j
خفر	x a f a r a
تحسس	t a ħ a s s a s a
ناضج	n aː dˤ i d͡ʒ
أكسد	ʔ a k s a d a
ابتذل	i b t a ð a l a
رصفان	r u sˤ f aː n
مداد	m i d aː d
أصف	ʔ a sˤ a f
مقدار	m i q d aː r
انتبه	i n t a b a h a
أنزل	ʔ a n z a l a
بارد	b aː r i d
صؤول	sˤ a ʔ uː l
ذوق	ð a w q
مغن	m u ɣ a n n i n
بيلادونا	b iː l aː d uː n aː
رصاصة	r a sˤ aː sˤ a
لبلبي	l a b l a b i j j
هجران	h i d͡ʒ r aː n
إبادة	ʔ i b aː d a
أعجوبة	ʔ u ʕ d͡ʒ uː b a
أبث	ʔ a b a θ a
برذعة	b a r ð a ʕ a
عقال	ʕ i q aː l
أهدى	ʔ a h d aː
قصرية	q a sˤ r i j j a
أبرز	ʔ a b r a z
ضال	dˤ aː l l
أباسخيرون	ʔ a b aː s x iː r uː n
دمغة	d a m ɣ a
نشيد	n a ʃ iː d
انكتاب	i n k i t aː b
إجاصة	ʔ i d͡ʒ d͡ʒ aː sˤ a
مقطر	m u q a tˤ tˤ i r
سؤدد	s u ʔ d a d
ترميم	t a r m iː m
مستعرب	m u s t a ʕ r i b
أشيب	ʔ a ʃ j a b
سليلى	s u l a j l aː
تركمانستان	t u r k u m aː n i s t aː n
مبارز	m u b aː r a z
تقليدي	t a q l iː d i j j
غزال	ɣ a z aː l
سربام	s a r a b aː m
أصغى	ʔ a sˤ ɣ aː
سلاح	s i l aː ħ
طباق	tˤ a b b aː q
بنفسجي	b a n a f s a d͡ʒ i j j
أريكا	ʔ a r iː k aː
إشغال	ʔ i ʃ ɣ aː l
هذا	h aː ð a
اشتاق	i ʃ t aː q a
ارتعش	i r t a ʕ a ʃ a
استمارة	i s t i m aː r a
طشقند	tˤ a ʃ q a n d
فيجن	f a j d͡ʒ a n
رقيق	r a q iː q
مخبول	m a x b uː l
هذب	h a ð ð a b a
اندمل	i n d a m a l a
مشعر	m a ʃ ʕ a r
جريد	d͡ʒ a r iː d
سلة	s a l l a
ائتلاف	i ʔ t i l aː f
صاءك	sˤ aː ʔ a k a
مطران	m a tˤ r aː n
غافت	ɣ aː f a t
جلب	d͡ʒ a l a b
شابانك	ʃ aː b aː n a k
همس	h a m a s a
مشجب	m i ʃ d͡ʒ a b
منيرة	m u n iː r a
بينيث	b a j n iː θ
ملعون	m a l ʕ uː n
وهلة	w a h l a
فاتر	f aː t i r
شونيز	ʃ uː n iː z
كوم	k a w m
تقوى	t a q w aː
بهلول	b u h l uː l
جليس	d͡ʒ a l iː s
بحاح	b u ħ aː ħ
صمغ	sˤ a m ɣ
ابتلال	i b t i l aː l
براشوت	b a r aː ʃ uː t
جماد	d͡ʒ a m aː d
فكر	f a k a r a
مشرق	m a ʃ r i q
وفاء	w a f aː ʔ
دافئ	d aː f i ʔ
كفاح	k i f aː ħ
جادل	d͡ʒ aː d a l a
أنيون	ʔ a n j uː n
عبق	ʕ a b b a q a
نصاب	n a sˤ sˤ aː b
استمد	i s t a m a d d a
قراسيا	q a r aː s i j aː
بعثة	b a ʕ θ a
روسي	r uː s i j j
انسل	i n s a l l a
تعشيقة	t a ʕ i ʃ iː q a
فولاذ	f uː l aː ð
كثيراء	k a θ iː r aː ʔ
حتام	ħ a t t aː m a
ندد	n a d d a d a
زحافة	z a ħ ħ aː f a
صورة	sˤ uː r a
قاووش	q aː w uː ʃ
شيعة	ʃ iː ʕ a
بادية	b aː d i j a
عيادة	ʕ i j aː d a
إقناع	ʔ i q n aː ʕ
ضواحك	dˤ a w aː ħ i k
سوراني	s uː r aː n i j j
كهف	k a h f
ساج	s aː d͡ʒ
اكتسب	i k t a s a b a
ثاودسيوس	θ aː w u d u s i j uː s
طائر	tˤ aː ʔ i r
الأرجنتين	a l ʔ a r d͡ʒ a n t iː n
عام	ʕ aː m
طريخ	tˤ a r r iː x
حليب	ħ a l iː b
غانا	ɣ aː n aː
سلباح	s i l b aː ħ
صيدلي	sˤ a j d a l i j j
توظيف	t a w ðˤ iː f
غنيمة	ɣ a n iː m a
مسرحي	m a s r a ħ i j j
بغداد	b a ɣ d aː d
فاثور	f aː θ uː r
تصتم	t a sˤ a t t a m a
مصحنة	m i sˤ ħ a n a
أيقن	ʔ a j q a n a
طاقية	tˤ aː q i j j a
إياك	ʔ i j j aː k a
نحاس	n u ħ aː s
بقي	b a q i j a
إنما	ʔ i n n a m aː
مستطيلات	m u s t tˤ iː l aː t
خولنجان	x a w l a n d͡ʒ aː n
خمسة	x a m s a
ذمة	ð i m m a
لواط	l i w aː tˤ
بيرق	b a j r a q
مشعل	m a ʃ ʕ a l
متحد	m u t t a ħ i d
رفائيل	r u f aː ʔ iː l
المشتري	a l m u ʃ t a r iː
سهر	s a h i r a
بطرخ	b a tˤ r a x
بطروخ	b a tˤ r uː x
هتف	h a t a f a
رائعة	r aː ʔ i ʕ a
ملا	m u l l aː
استغرق	i s t a ɣ r a q a
حجة	ħ i d͡ʒ d͡ʒ a
رماد	r a m aː d
تعزب	t a ʕ a z z a b a
هاتف	h aː t i f
لتوانيا	l i t u w aː n i j aː
تحكيم	t a ħ k iː m
سافانا	s aː f aː n aː
باب	b aː b
هعخع	h u ʕ x u ʕ
أنور	ʔ a n w a r
أدب	ʔ a d a b
دكتور	d u k t uː r
استثنائي	i s t i θ n aː ʔ i j j
دلب	d u l b
عربية	ʕ a r a b i j j a
مساومة	m u s aː w a m a
ملعقة	m i l ʕ a q a
أنف	ʔ a n f
معاونة	m u ʕ aː w a n a
اخترق	i x t a r a q a
جليد	d͡ʒ a l iː d
قدوم	q a d d uː m
عبرة	ʕ i b r a
طلع	tˤ a l a ʕ a
مطراني	m u tˤ r aː n i j j
سفرجلة	s a f a r d͡ʒ a l a
فكاهي	f u k aː h i j j
رساطون	r a s aː tˤ uː n
تقرر	t a q a r r a r a
مسلم	m u s a l l a m
قداد	q a d aː d
هدف	h a d a f
رتينج	r a t iː n a d͡ʒ
خلفي	x a l f i j j
إقامة	ʔ i q aː m a
استفرغ	i s t a f r a ɣ a
تذمر	t a ð a m m a r a
مقدر	m u q a d d a r
توكيد	t a w k iː d
ملامح	m a l aː m i ħ
قرقع	q a r q a ʕ a
فنطاس	f i n tˤ aː s
كابل	k aː b u l
أرضي	ʔ a r dˤ i j j
مشتاق	m u ʃ t aː q
اشتباك	i ʃ t i b aː k
اشتباه	i ʃ t i b aː h
إمضاء	ʔ i m dˤ aː ʔ
نعوظ	n u ʕ uː ðˤ
أشنان	ʔ u ʃ n aː n
ستار	s i t aː r
قثاء	q i θ θ aː ʔ
طرخون	tˤ a r x uː n
آخن	ʔ aː x a n
تلفاف	t i l f aː f
دودة	d uː d a
بذرقطونا	b a ð a r q a tˤ uː n aː
طهران	tˤ a h r aː n
قشعريرة	q u ʃ a ʕ r iː r a
مبشرة	m i b ʃ a r a
فرهود	f u r h uː d
رمش	r a m a ʃ a
فلفل	f i l f i l
بعث	b a ʕ a θ a
كمء	k a m ʔ
نبأ	n a b a ʔ
ابتل	i b t a l l a
كميت	k u m a j t
همزة	h a m z a
قوقعة	q a w q a ʕ a
كون	k a w n
بارزذ	b aː r z a ð
أردمون	ʔ a r d a m uː n
لؤلؤ	l u ʔ l u ʔ
انهمك	i n h a m a k a
أكسح	ʔ a k s a ħ
جين	d͡ʒ iː n
استفز	i s t a f a z z a
شكال	ʃ i k aː l
أخت	ʔ u x t
نادلة	n aː d i l a
سيخي	s iː x i j j
ساوم	s aː w a m a
سوسة	s uː s a
سطم	s a tˤ a m a
قاد	q aː d a
ابرغش	i b r a ɣ a ʃ ʃ a
عباء	ʕ a b aː ʔ
رغف	r u ɣ u f
القنيطرة	a l q u n a j tˤ i r a
شخص	ʃ a x a sˤ a
أمريكا	ʔ a m r iː k aː
أكل	ʔ a k a l a
شفاف	ʃ a f f aː f
أحسن	ʔ a ħ s a n
شعلة	ʃ u ʕ l a
جارة	d͡ʒ aː r a
حجر	ħ a d͡ʒ a r
فدان	f a d d aː n
أمسك	ʔ a m s a k a
امتعض	i m t a ʕ a dˤ a
اغتنم	i ɣ t a n a m a
سوس	s a w i s a
قرميدة	q i r m iː d a
صخد	sˤ a x a d a
إبرة	ʔ i b r a
ليرة	l a j r a
استقلال	i s t i q l aː l
بقبق	b a q b a q a
بنفسج	b a n a f s a d͡ʒ
زؤام	z u ʔ aː m
عصف	ʕ a sˤ a f a
دغبوس	d u ɣ b uː s
كرفس	k a r a f s
خصوصي	x u sˤ uː sˤ i j j
تخدير	t a x d iː r
أرومة	ʔ a r uː m a
صعوبة	sˤ u ʕ uː b a
دائرة	d aː ʔ i r a h
سفارة	s i f aː r a
متواضع	m u t a w aː dˤ i ʕ
شلة	ʃ a l l a
مجسمة	m u d͡ʒ a s s a m a
كستبان	k u s t u b aː n
قطار	q i tˤ aː r
ضاجع	dˤ aː d͡ʒ a ʕ a
تواصى	t a w aː sˤ aː
تنظيم	t a n ðˤ iː m
تترى	t a t r aː
لوط	l uː tˤ
أحيلى	ʔ u ħ a j l aː
تلاشى	t a l aː ʃ aː
فقيه	f a q iː h
زنبور	z a n b uː r
اكتتب	i k t a t a b a
فجل	f a d͡ʒ a l
هزج	h a z i d͡ʒ a
رسول	r a s uː l
حساسي	ħ a s s aː s i j j
مداولة	m u d aː w a l a
كبل	k a b l
استقتل	i s t a q t a l a
أزأم	ʔ a z ʔ a m a
علة	ʕ i l l a
مشترك	m u ʃ t a r a k
مكون	m u k a w w i n
شاف	ʃ aː f a
شكارة	ʃ i k aː r a
آدمي	ʔ aː d a m i j j
دردق	d a r d a q
مغناطيسية	m a ɣ n aː tˤ iː s i j j a
بيوت	b u j uː t
ذكرى	ð i k r aː
فضول	f dˤ uː l
سلعة	s i l ʕ a
حقد	ħ a q a d a
تمسيد	t a m s iː d
مقعدة	m a q ʕ a d a
ازدهر	i z d a h a r a
برشام	b i r ʃ aː m
عفريت	ʕ a f r iː t
شبهة	ʃ u b h a
مفرش	m i f r a ʃ
الكويت	a l k u w a j t
شفة	ʃ a f a
صدر	sˤ a d a r a
قرصنة	q a r sˤ a n a
كأس	k a ʔ s
قوة	q u w w a
فنلندا	f i n l a n d aː
مضرب	m i dˤ r a b
بيد	b a j d a
ساعد	s aː ʕ a d a
ثوب	θ a w b
جنطيانا	d͡ʒ a n tˤ i j aː n aː
خرنق	x i r n i q
ضيون	dˤ a j w a n
فرخ	f a r r a x a
فور	f a w r
لثم	l a θ a m a
تمرين	t a m r iː n
مثنوية	m a θ n a w i j j a
مبالغة	m u b aː l a ɣ a
دواسة	d a w w aː s a
أزرق	ʔ a z r a q
إبل	ʔ i b i l
عائشة	ʕ aː ʔ i ʃ a
ميتوكندريا	m iː t uː k u n d r i j aː
جنائي	d͡ʒ i n aː ʔ i j j
منهج	m a n h a d͡ʒ
إيريناوس	ʔ iː r iː n aː w u s
بيت	b a j j a t a
حصرم	ħ a sˤ r a m
استعارة	i s t i ʕ aː r a
جذام	d͡ʒ u ð aː m
هول	h a w l
مصاب	m a sˤ aː b b
قصاب	q a sˤ sˤ aː b
خيزران	x a j z u r aː n
صحافة	sˤ a ħ aː f a
زمجر	z a m d͡ʒ a r a
شظية	ʃ a ðˤ i j j a
معجم	m u ʕ d͡ʒ a m
صفر	sˤ a f a r
أين	ʔ a j j a n a
مالق	m aː l a q
جلباب	d͡ʒ i l b aː b
أكرى	ʔ a k r aː
زنبوع	z a n b uː ʕ
فتش	f a t t a ʃ a
خطام	x i tˤ aː m
غلقة	ɣ a l q a
ميز	m a j j a z a
أنتيكخانة	ʔ a n t iː k x aː n a
الأشهل	a l ʔ a ʃ h a l
فسح	f a s a ħ a
بضع	b i dˤ ʕ
أمدمي	ʔ u m d a m i j j
شاورما	ʃ aː w a r m aː
هنالك	h u n aː l i k a
غضاضة	ɣ a dˤ aː dˤ a
رشفة	r a ʃ f a
خيرات	x a j r aː t
بستوقة	b u s t uː q a
فئران	f i ʔ r aː n
تومان	t uː m aː n
رغوة	r a ɣ w a
عرناس	ʕ a r n aː s
شاكر	ʃ aː k i r
تفاجأ	t a f aː d͡ʒ a ʔ a
تصادأ	t a sˤ aː d a ʔ a
شبيه	ʃ a b iː h
صحصح	sˤ a ħ sˤ a ħ
ارتفع	i r t a f a ʕ a
تين	t iː n
دنر	d a n n a r a
شلكاية	ʃ a l a k aː j a
أزب	ʔ a z a b b
شمشار	ʃ a m ʃ aː r
حاذق	ħ aː ð i q
خصية	x i sˤ j a
بركري	b a r k a r i j j
باراغواي	b aː r aː ɣ u w aː j
زميلة	z a m iː l a
عنوسة	ʕ u n uː s a
قرمزي	q i r m i z i j j
استجار	i s t a d͡ʒ aː r a
راحل	r aː ħ i l
لجام	l i d͡ʒ aː m
متزوج	m u t a z a w w i d͡ʒ
اصطخم	i sˤ tˤ a x a m a
غريبة	ɣ a r iː b a
عاب	ʕ aː b a
ميمنة	m a j m a n a
هوتة	h a w t a
سوريا	s uː r i j aː
أخثاث	ʔ a x θ aː θ
لازوردي	l aː z u w a r d i j j
سباك	s a b b aː k
جحفل	d͡ʒ a ħ f a l
متجر	m a t d͡ʒ a r
خالد	x aː l i d
تشويق	t a ʃ w iː q
فريق	f a r iː q
لحلاح	l a ħ l aː ħ
لاط	l aː tˤ a
إسرائيل	ʔ i s r aː ʔ iː l
العاصي	a l ʕ aː sˤ iː
آمين	ʔ aː m iː n a
قيطون	q a j tˤ uː n
خنزير	x i n z iː r
مقود	m i q w a d
جدوى	d͡ʒ a d w aː
ملوخية	m u l uː x i j j a
ألمانيا	ʔ a l m aː n i j aː
انهمر	i n h a m a r a
مجموعة	m a d͡ʒ m uː ʕ a
تجاوزات	t a d͡ʒ aː w u z aː t
زريبة	z a r iː b a
غريغوريوس	ɣ i r iː ɣ uː r i j uː s
فحص	f a ħ a sˤ a
آتون	ʔ aː t uː n
صحاف	sˤ a ħ ħ aː f
أنباض	ʔ a n b aː dˤ
سهل	s a h h a l a
النمسا	a n n a m s aː
افترى	i f t a r aː
أغرى	ʔ a ɣ r aː
قافلة	q aː f i l a
كمأ	k a m a ʔ
شعرى	ʃ a ʕ r aː
ريباس	r iː b aː s
سيكران	s a j k a r aː n
ثقة	θ i q a
قنديل	q a n d iː l
بيعة	b a j ʕ a
بطاطس	b a tˤ aː tˤ i s
بهيمة	b a h iː m a
ملبس	m a l b a s
سقطرة	s u q u tˤ r a
همجي	h a m a d͡ʒ i j j
أتى	ʔ a t aː
اجتذب	i d͡ʒ t a ð a b a
سخاء	s a x aː ʔ
مخبأ	m a x b a ʔ
البهاما	a l b a h aː m aː
فتاة	f a t aː h
مالك	m aː l i k
تسكع	t a s a k k a ʕ a
قرطاس	q i r tˤ aː s
أسمرة	ʔ a s m a r a
مفلفل	m u f a l f a l
يعقوب	j a ʕ q uː b
نرجيل	n a r d͡ʒ iː l
تصغير	t a sˤ ɣ iː r
جوز	d͡ʒ a w z
سمعي	s a m ʕ i j j
اختصر	i x t a sˤ a r a
عار	ʕ aː r
قستوس	q i s t uː s
صبان	sˤ a b b aː n
ديمومة	d a j m uː m a
جزئي	d͡ʒ u z ʔ i j j
بصير	b a sˤ iː r
طاجيكستان	tˤ aː d͡ʒ iː k i s t aː n
أعجمي	ʔ a ʕ d͡ʒ a m i j j
اتسع	i t t a s a ʕ a
غرفة	ɣ u r f a
رثية	r a θ j a
ناي	n aː j
قناع	q i n aː ʕ
ارتاح	i r t aː ħ a
فرجون	f i r d͡ʒ a w n
تأمور	t a ʔ m uː r
طلعة	tˤ a l ʕ a
ذاق	ð aː q a
ممسح	m i m s a ħ
رتيل	r u t a j l
مضمار	m i dˤ m aː r
صبحة	sˤ a b ħ a
تنسيق	t a n s iː q
غوشنة	ɣ a w ʃ a n a
هطلس	h a tˤ a l l a s
مصباح	m i sˤ b aː ħ
شلح	ʃ a l a ħ a
راعدة	r aː ʕ i d a
كوسوفو	k uː s uː f uː
زملاء	z u m a l aː ʔ
مفك	m i f a k k
سكرجة	s u k r u d͡ʒ a
سلاطين	s a l aː tˤ iː n
بارزد	b aː r z a d
مديرة	m u d iː r a
انجراف	i n d͡ʒ i r aː f
سلطانية	s u l tˤ aː n i j j a
حذلقة	ħ a ð l a q a
بوط	b uː tˤ
بركة	b a r a k a
منافس	m u n aː f i s
شبشب	ʃ i b ʃ i b
ناطف	n aː tˤ i f
زرع	z a r a ʕ a
جلهم	d͡ʒ a l h a m
سويدي	s u w a j d i j j
حجم	ħ a d͡ʒ a m a
مضيرة	m a dˤ iː r a
ترنج	t r i n d͡ʒ
مشاورة	m u ʃ aː w a r a
تنقض	t a n a q q a dˤ a
انعدى	i n ʕ a d aː
أسارون	ʔ a s aː r uː n
مائدة	m aː ʔ i d a
ماحق	m aː ħ i q
قلما	q a l l a m aː
سرقين	s i r q iː n
أوريغون	ʔ uː r iː ɣ uː n
تعس	t a ʕ a s a
عنق	ʕ a n a q
أنسون	ʔ a n s uː n
حينما	ħ iː n a m aː
فعل	f a ʕ a l a
اقتضى	i q t a dˤ aː
فيتق	f a j t a q
باقة	b aː q a
أليس	ʔ a l iː s
فأر	f a ʔ r
قولنج	q a w l a n d͡ʒ
لطم	l a tˤ a m a
ضمران	dˤ a m r aː n
تزامن	t a z aː m a n a
باصور	b aː sˤ uː r
أسلوب	ʔ u s l uː b
كودن	k a w d a n
قاطعة	q aː tˤ i ʕ a
معدن	m a ʕ d i n
فرث	f a r a θ a
اشتق	i ʃ t a q q a
مأدبة	m a ʔ d u b a
مجازر	m a d͡ʒ aː z i r
حمص	ħ a m m a sˤ a
غسق	ɣ a s a q
كوسا	k uː s aː
راء	r aː ʔ
عين	ʕ a j j a n a
عدالة	ʕ a d aː l a
استحضر	i s t a ħ dˤ a r a
تماشى	t a m aː ʃ aː
قرفصاء	q u r f u sˤ aː ʔ
إربيان	ʔ i r b i j aː n
طمأن	tˤ a m ʔ a n a
مقارنة	m u q aː r a n a
الهند	a l h i n d
لبوس	l a b uː s
زخات	z a x x aː t
تزويد	t a z w iː d
صهيوني	sˤ a h j uː n i j j
اكتسى	i k t a s aː
مثلجات	m u θ a l l a d͡ʒ aː t
رذاذ	r a ð aː ð
صدرية	sˤ a d r i j j a
جمانة	d͡ʒ u m aː n a
باقلاء	b aː q i l aː ʔ
ذكر	ð a k a r
انتخب	i n t a x a b a
إيثار	ʔ iː θ aː r
أحاط	ʔ a ħ aː tˤ a
بطانة	b i tˤ aː n a
ومض	w a m a dˤ a
ملاقاة	m u l aː q aː h
زرنب	z a r n a b
قلعي	q a l a ʕ i j j
إصبع	ʔ i sˤ b a ʕ
راتينج	r aː t iː n a d͡ʒ
مؤسسة	m u ʔ a s s a s a
أعف	ʔ a ʕ a f f a
السعودية	a s s a ʕ uː d i j j a
شرشيري	ʃ a r ʃ iː r i j j
مفسر	m u f a s s i r
حبالة	ħ i b aː l a
بقية	b a q i j j a
سلطوي	s u l tˤ a w i j j
باص	b aː sˤ
ديباج	d iː b aː d͡ʒ
حرير	ħ a r iː r
كاحل	k aː ħ i l
سعيد	s a ʕ iː d
تقدس	t a q a d d a s a
ملحن	m u l a ħ ħ i n
اكتئاب	i k t i ʔ aː b
رغيفات	r a ɣ iː f aː t
أمس	ʔ a m a s s a
مطحنة	m a tˤ ħ a n a
بعثران	b a ʕ θ a r aː n
لماذا	l i m aː ð aː
قطيع	q a tˤ iː ʕ
أمهل	ʔ a m h a l a
كرك	k u r k
أولى	ʔ a w l aː
تقوض	t a q a w w a dˤ a
مخرفة	m a x r a f a
موسم	m a w s i m
شربوش	ʃ a r b uː ʃ
حنظلة	ħ a n ðˤ a l a
قريدسة	q u r a j d i s a
متنوع	m u t a n a w w i ʕ
احترف	i ħ t a r a f a
مطفأة	m i tˤ f a ʔ a
قسطاس	q i s tˤ aː s
الصين	a sˤ sˤ iː n
مخيم	m u x a j j a m
ندبة	n a d b a
فانوس	f aː n uː s
جنينة	d͡ʒ u n a j n a
إزعاج	ʔ i z ʕ aː d͡ʒ
لئلا	l i ʔ a l l aː
بطريك	b a tˤ r iː k
مصنع	m a sˤ n a ʕ
موسمي	m a w s i m i j j
أجنبي	ʔ a d͡ʒ n a b i j j
مجسم	m u d͡ʒ a s s a m
غمغم	ɣ a m ɣ a m a
فوض	f a w w a dˤ a
تألق	t a ʔ a l l a q a
أزرع	ʔ a z r a ʕ a
عيد	ʕ a j j a d a
كافور	k aː f uː r
بينما	b a j n a m aː
إنموذج	ʔ i n m uː ð a d͡ʒ
غائر	ɣ aː ʔ i r
أنفحة	ʔ a n f i ħ a
أسير	ʔ a s iː r
معقود	m a ʕ q uː d
استفتى	i s t a f t aː
معارضة	m u ʕ aː r a dˤ a
فوضوي	f a w dˤ a w i j j
لصف	l a sˤ a f
مدلجة	m i d l a d͡ʒ a
جنازة	d͡ʒ a n aː z a
مذاق	m a ð aː q
زاغ	z aː ɣ a
ظبي	ðˤ a b j
ذبابة	ð u b aː b a
طبخ	tˤ a b a x a
وظف	w a ðˤ ðˤ a f a
عرقوب	ʕ u r q uː b
معتزلة	m u ʕ t a z i l a
حلكة	ħ u l k a
اجتماع	i d͡ʒ t i m aː ʕ
مشى	m a ʃ aː
سقمونيا	s a q a m uː n i j aː
أضاع	ʔ a dˤ aː ʕ a
حنجرة	ħ a n d͡ʒ a r a
مجاور	m u d͡ʒ aː w i r
أغسطس	ʔ a ɣ u s tˤ u s
لجين	l u d͡ʒ a j n
سفر	s a f a r
عنقود	ʕ a n q uː d
رجلة	r u d͡ʒ l a
مسد	m a s a d a
غاضب	ɣ aː dˤ i b
كبش	k a b ʃ
تصهين	t a sˤ a h j a n a
جمع	d͡ʒ a m a ʕ a
سفيه	s a f iː h
توتياء	t uː t i j aː ʔ
آبيس	ʔ aː b iː s
دستور	d u s t uː r
زرشك	z a r r a ʃ k
سيخية	s iː x i j j a
صعيد	sˤ a ʕ iː d
شمال	ʃ a m aː l
فسقية	f a s q i j j a
سراق	s a r r aː q
حديد	ħ a d iː d
مجن	m i d͡ʒ a n n
سبعة	s a b ʕ a
إسلام	ʔ i s l aː m
أطفال	ʔ a tˤ f aː l
أعطى	ʔ a ʕ tˤ aː
أجار	ʔ a d͡ʒ aː r a
استحصل	i s t a ħ sˤ a l a
إفريقية	ʔ i f r iː q i j a
نموذجي	n a m uː ð a d͡ʒ i j j
مسجد	m a s d͡ʒ i d
تقيأ	t a q a j j a ʔ a
قميحة	q a m iː ħ a
نخالة	n u x aː l a
تزحلق	t a z a ħ l a q a
إحصائي	ʔ i ħ sˤ aː ʔ i j j
شعبة	ʃ i ʕ b a
ماسح	m aː s i ħ
تجرد	t a d͡ʒ a r r a d a
رأسمال	r a ʔ s m aː l
انصرف	i n sˤ a r a f a
بيروقراطي	b iː r uː q r aː tˤ i j j
أمريكي	ʔ a m r iː k i j j
زحف	z a ħ a f a
مرطبان	m a r tˤ a b aː n
أغوى	ʔ a ɣ w aː
نعمة	n i ʕ m a
هالوك	h aː l uː k
تسريب	t a s r iː b
استدل	i s t a d a l l a
أسفر	ʔ a s f a r a
وغل	w a ɣ a l a
علقة	ʕ a l a q a
أندر	ʔ a n d a r
الوداع	a l w a d aː ʕ
سوط	s a w tˤ
جار	d͡ʒ aː r
عمامة	ʕ i m aː m a
كاتدرائية	k aː t i d r aː ʔ i j j a
ميناء	m iː n aː ʔ
ممتلكات	m u m t a l a k aː t
هزل	h a z a l a
سينمائي	s i j n a m aː ʔ i j j
اعتمد	i ʕ t a m a d a
راسخت	r aː s u x t
فوذنج	f uː ð a n a d͡ʒ
قرصان	q u r sˤ aː n
قابيل	q aː b iː l
متسول	m u t a s a w w i l
أتون	ʔ a t t uː n
ثمانون	θ a m aː n uː n
أيل	ʔ a j j a l
وضاح	w a dˤ dˤ aː ħ
مرتعب	m u r t a ʕ i b
أعلى	ʔ a ʕ l aː
انتظم	i n t a ðˤ a m a
زكام	z u k aː m
برقية	b a r q i j j a
تلك	t i l k a
غرق	ɣ a r i q a
تأخير	t a ʔ x iː r
صهيونية	sˤ a h j uː n i j j a
سمكة	s a m a k a
قام	q aː m a
شنجار	ʃ a n d͡ʒ aː r
كبير	k a b iː r
موحش	m uː ħ i ʃ
آخرة	ʔ aː x i r a
هريرة	h u r a j r a h
ختان	x i t aː n
تدثر	t a d a θ θ a r a
حاء	ħ aː ʔ
فداحة	f a d aː ħ a
قارن	q aː r a n a
جزع	d͡ʒ a z a ʕ a
أفاد	ʔ a f aː d a
مشواة	m i ʃ w aː h
زواج	z a w aː d͡ʒ
كمون	k a m m uː n
شمشم	ʃ a m ʃ a m a
بورصة	b uː r sˤ a
رطب	r a tˤ b
كنزة	k a n z a
رتيلاء	r u t a j l aː ʔ
أخلاقية	ʔ a x l aː q i j j a
غامق	ɣ aː m i q
حافلات	ħ aː f i l aː t
معتل	m u ʕ t a l l
عقرب	ʕ a q r a b
معنوي	m a ʕ n a w i j j
ظفر	ðˤ a f a r
قرآني	q u r ʔ aː n i j j
تراخوما	t a r aː x uː m aː
انخرط	i n x a r a tˤ a
فحشاء	f a ħ ʃ aː ʔ
جني	d͡ʒ i n n i j j
بيدر	b a j d a r
طنبور	tˤ u n b uː r
ناعورة	n aː ʕ uː r a
شلنبر	ʃ u l u n b a r
عنصر	ʕ u n sˤ u r
تورم	t a w a r r a m a
تغريد	t a ɣ r iː d
تغلب	t a ɣ a l l a b a
مورد	m a w r i d
إبداعي	ʔ i b d aː ʕ i j j
تيغار	t a j ɣ aː r
نوع	n a w w a ʕ a
سقلاطون	s i q i l l aː tˤ uː n
طمث	tˤ a m θ
إبريز	ʔ i b r iː z
توارى	t a w aː r aː
قفاز	q u f aː z
حامول	ħ aː m uː l
استيعاب	i s t iː ʕ aː b
الصومال	a sˤ sˤ uː m aː l
لسع	l a s a ʕ a
جبناء	d͡ʒ u b a n aː ʔ
زمزم	z a m z a m
مشتريات	m u ʃ t a r a j aː t
دكان	d u k k aː n
غلب	ɣ a l a b
سائمة	s aː ʔ i m a
متشكر	m u t a ʃ a k k i r
أسري	ʔ u s r i j j
راقص	r aː q a sˤ a
لكم	l a k a m a
صهريج	sˤ a h r iː d͡ʒ
عري	ʕ a r i j a
اتهم	i t t a h a m a
ألغى	ʔ a l ɣ aː
سقلطوني	s i q i l l a tˤ uː n i j j
هرة	h i r r a h
مبارزة	m u b aː r a z a
ترك	t a r a k a
شلغم	ʃ a l ɣ a m
برسيم	b i r s iː m
ضوء	dˤ a w ʔ
أميرة	ʔ a m iː r a
خربش	x a r b a ʃ a
مرند	m a r a n d
بزاق	b u z aː q
هندسي	h a n d a s i j j
مسدس	m u s a d d a s
صحة	sˤ i ħ ħ a
منتصف	m u n t a sˤ a f
أزلي	ʔ a z a l i j j
ديس	d iː s
حربث	ħ u r b u θ
عجلة	ʕ a d͡ʒ a l a
مدغشقر	m a d a ɣ a ʃ q a r
غمامة	ɣ a m aː m a
ارتياع	i r t i j aː ʕ
أحمق	ʔ a ħ m a q
بعلبك	b a ʕ l a b a k k
صبابة	sˤ a b aː b a
نظير	n a ðˤ iː r
قوس	q a w i s a
شوفان	ʃ uː f aː n
خطيب	x a tˤ iː b
قاجوج	q aː d͡ʒ uː d͡ʒ
استفزاز	i s t i f z aː z
ذرية	ð u r r i j j a
سندس	s u n d u s
قادوس	q aː d uː s
وجدة	w a d͡ʒ d a
حراري	ħ a r aː r i j j
حشيش	ħ a ʃ iː ʃ
محسن	m u ħ a s s a n
دردي	d i r d iː
أمضى	ʔ a m dˤ aː
ذهن	ð i h n
نسى	n a s s aː
طرمبة	tˤ r u m b a
إندونيسي	ʔ i n d uː n iː s i j j
مخاض	m a x aː dˤ
مهم	m u h i m m
خراء	x i r aː ʔ
مريلة	m i r j a l a
جدد	d͡ʒ a d a d
خفج	x a f a d͡ʒ
بوذا	b uː ð aː
دهليز	d i h l iː z
كمثراة	k u m m a θ r aː h
ناسك	n aː s i k
مبرة	m a b a r r a
بطريركية	b a tˤ r i j a r k i j j a
منقرض	m u n q a r i dˤ
زنزانة	z i n z aː n a
مزدهر	m u z d a h i r
إعراب	ʔ i ʕ r aː b
البحرين	a l b a ħ r a j n
زيتي	z a j t i j j
مويزج	m a w iː z a d͡ʒ
مخافة	m a x aː f a
قلقديس	q a l q a d iː s
موسيقى	m uː s iː q aː
جهة	d͡ʒ i h a
عودة	ʕ a w d a
فلو	f a l u w w
استصبر	i s t a sˤ b a r a
منشأة	m u n ʃ a ʔ a
أعمى	ʔ a ʕ m aː
ملاحقة	m u l aː ħ a q a
طاح	tˤ aː ħ a
عيش	ʕ a j ʃ
ماذا	m aː ð aː
تسلق	t a s a l l a q a
حنبلي	ħ a n b a l i j j
زايلفون	z aː j l u f uː n
أوج	ʔ a w d͡ʒ
يسار	j a s aː r
ويكاموس	w iː k aː m uː s
فالودج	f aː l uː d a d͡ʒ
نشيدة	n a ʃ iː d a
مسطح	m u s a tˤ tˤ a ħ
شجا	ʃ a d͡ʒ aː
رضائع	r a dˤ aː ʔ i ʕ
الإسكندرية	a l ʔ i s k a n d a r i j j a
أطرش	ʔ a tˤ r a ʃ
بشرة	b a ʃ a r a
مفتعل	m u f t a ʕ a l
نباهة	n a b aː h a
اتهام	i t t i h aː m
مضيق	m a dˤ iː q
مماثلة	m u m aː θ a l a
معروف	m a ʕ r uː f
فراسيون	f a r aː s i j uː n
سلا	s a l aː
إذخر	ʔ i ð x i r
نجي	n a d͡ʒ i j j
بنان	b a n aː n
خداج	x i d aː d͡ʒ
بلجيكي	b i l d͡ʒ iː k i j j
ناقوس	n aː q uː s
دمقس	d i m a q s
أهلي	ʔ a h l i j j
جعل	d͡ʒ a ʕ a l a
نيفق	n a j f a q
تواقف	t a w aː q a f a
قسوة	q a s w a
طأطأ	tˤ a ʔ tˤ a ʔ a
قذال	q a ð aː l
دفاع	d i f aː ʕ
انتقال	i n t i q aː l
وجب	w a d͡ʒ a b a
سكن	s a k a n
حرباء	ħ i r b aː ʔ
أنوق	ʔ a n uː q
قائد	q aː ʔ i d
لذيذ	l a ð iː ð
أبطل	ʔ a b tˤ a l a
يافع	j aː f i ʕ
خيزان	x iː z aː n
أرخبيل	ʔ a r x a b iː l
لكن	l aː k i n
أباس	ʔ u b aː s
محموم	m a ħ m uː m
قايين	q aː j iː n
طبشورة	tˤ a b ʃ uː r a
تحكم	t a ħ a k k a m a
تململ	t a m a l m a l a
أنا	ʔ a n aː
عاطفي	ʕ aː tˤ i f i j j
زبيل	z a b b iː l
فؤاد	f u ʔ aː d
كوز	k uː z
بسالة	b a s aː l a
ندى	n a d aː
اختنق	i x t a n a q a
دمية	d u m j a
سدر	s a d i r a
أعيان	ʔ a ʕ j aː n
لبلاب	l a b l aː b
بتاتا	b a t aː t aː
عنزروت	ʕ a n z a r uː t
تاق	t aː q a
دحرج	d a ħ r a d͡ʒ a
زوان	z a w aː n
ريشة	r iː ʃ a
عنوان	ʕ u n w aː n
سبب	s a b a b
وجيز	w a d͡ʒ iː z
فراطة	f u r aː tˤ a
أباجور	ʔ a b aː d͡ʒ uː r
معاء	m i ʕ aː ʔ
نضار	n u dˤ aː r
صراخة	sˤ a r r aː x a
نمر	n a m i r
معدات	m u ʕ a d d aː t
فاء	f aː ʔ
حمار	ħ a m m aː r
ليلك	l a j l a k
استئمارة	i s t i ʔ m aː r a
انكمش	i n k a m a ʃ a
اليمن	a l j a m a n
مقبرة	m a q b a r a
حميم	ħ a m iː m
نارجيل	n aː r a d͡ʒ iː l
أعجم	ʔ a ʕ d͡ʒ a m a
إسكندراني	ʔ i s k a n d a r aː n i j j
احتقر	i ħ t a q a r a
تلفت	t a l a f f a t a
فراشة	f a r aː ʃ a
مكة	m a k k a
خليجي	x a l iː d͡ʒ i j j
ارتاع	i r t aː ʕ a
دبي	d i b b iː
تحرير	t a ħ r iː r
أشابة	ʔ u ʃ aː b a
غمى	ɣ a m m aː
أطل	ʔ a tˤ a l l a
تصوير	t a sˤ w iː r
حوض	ħ a w dˤ
جورجيا	d͡ʒ uː r d͡ʒ i j aː
دستج	d a s t a d͡ʒ
سلبي	s a l b i j j
تدليك	t a d l iː k
راود	r aː w a d a
أجلح	ʔ a d͡ʒ l a ħ
تفاوض	t a f aː w a dˤ a
باذنجان	b aː ð i n d͡ʒ aː n
سكنجبين	s i k a n d͡ʒ a b iː n
غارة	ɣ aː r a
نجار	n a d͡ʒ d͡ʒ aː r
يناير	j a n aː j i r
لبن	l a b a n
معمل	m a ʕ m a l
كمام	k i m aː m
تخلص	t a x a l l a sˤ a
صأصأ	sˤ a ʔ sˤ a ʔ a
مهماز	m i h m aː z
فوتنج	f uː t a n a d͡ʒ
زوجة	z a w d͡ʒ a
زكريا	z a k a r i j j aː
فتوش	f a t t uː ʃ
دويبة	d u w a j b b a
قمح	q a m ħ
متوسط	m u t a w a s s i tˤ
موز	m a w z
حاسوب	ħ aː s uː b
سابق	s aː b i q
هدى	h a d aː
عود	ʕ a w d
ملح	m i l ħ
لحاق	l a ħ aː q
سركنجبين	s i r k a n d͡ʒ a b iː n
باريس	b aː r iː s
مسمار	m i s m aː r
طبيبة	tˤ a b iː b a
ولكن	w a l aː k i n
باروق	b aː r uː q
أسفنيك	ʔ a s f a n iː k
بسمة	b a s m a
فردي	f a r d i j j
ألم	ʔ a l a m
قلقاس	q u l q aː s
استنشق	i s t a n ʃ a q a
رجرج	r a d͡ʒ r a d͡ʒ a
كرسوع	k u r s uː ʕ
قاقلة	q aː q i l l a
لؤلؤة	l u ʔ l u ʔ a
نجاة	n a d͡ʒ aː h
روسيا	r uː s i j aː
مخدر	m u x a d d i r
صقر	sˤ a q r
فجور	f u d͡ʒ uː r
طما	tˤ a m aː
باخوم	b aː x uː m
صأل	sˤ a ʔ a l a
فصيل	f a sˤ iː l
أشترغار	ʔ u ʃ t u r ɣ aː r
مبكر	m u b a k k i r
ندوة	n a d w a
كرواتي	k u r u w aː t i j j
أفلاطون	ʔ a f l aː tˤ uː n
برهة	b u r h a
صوت	sˤ a w t
مكحلة	m u k a ħ l a
كتان	k a t t aː n
شاور	ʃ aː w a r a
صغار	sˤ i ɣ aː r
أندراوس	ʔ a n d a r aː w u s
أخبر	ʔ a x b a r a
سميذ	s a m iː ð
زربية	z a r b i j j a
تدريس	t a d r iː s
مكسرات	m u k a s s a r aː t
هندباء	h i n d i b aː ʔ
نحال	n a ħ ħ aː l
أساسي	ʔ a s aː s i j j
فلز	f i l a z z
خنق	x a n a q a
هنغاري	h a n ɣ aː r i j j
جمال	d͡ʒ a m aː l
برق	b a r a q a
الخميس	a l x a m iː s
طفيف	tˤ a f iː f
متانة	m a t aː n a
مجراف	m i d͡ʒ r aː f
صحراوي	sˤ a ħ r aː w i j j
سنبل	s u n b u l
قنديد	q i n d iː d
مفرد	m u f r a d
سيس	s a j j a s a
شركة	ʃ a r i k a
أرض	ʔ a r dˤ
حنون	ħ a n uː n
فتاحة	f a t t aː ħ a
تعشق	t a ʕ a ʃ ʃ a q a
كاذب	k aː ð i b
يونيو	j uː n i j uː
كلح	k a l a ħ a
خزان	x a z z aː n
جعفر	d͡ʒ a ʕ f a r
تبريز	t a b r iː z
مربوط	m a r b uː tˤ
خبا	x a b aː
دخل	d a x a l
بليز	b a l iː z
آيسلندا	ʔ aː j i s l a n d aː
أهيف	ʔ a h j a f
جندية	d͡ʒ u n d i j j a
مخالف	m u x aː l i f
كستج	k a s t a d͡ʒ
لبان	l u b aː n
زأم	z a ʔ a m a
حمل	ħ a m a l
قال	q aː l
جيم	d͡ʒ iː m
أسطورة	ʔ u s tˤ uː r a
تهجى	t a h a d͡ʒ d͡ʒ aː
شاهدانق	ʃ aː h d aː n a q
ظلف	ðˤ i l f
مشقة	m a ʃ a q q a
سيف	s a j f
غاب	ɣ aː b a
محاكمة	m u ħ aː k a m a
سيبويه	s iː b a w a j h
عباية	ʕ a b aː j a
نفاخة	n u f f aː x a
فادي	f aː d iː
حاشا	ħ aː ʃ aː
قلاية	q a l l aː j a
أوجس	ʔ a w d͡ʒ a s a
سخد	s u x d
تعليم	t a ʕ l iː m
لفف	l a f f a f a
أكب	ʔ a k a b b a
اضطهاد	i dˤ tˤ i h aː d
خصفة	x a sˤ a f a
جحا	d͡ʒ u ħ aː
شهدانج	ʃ a h d aː n a d͡ʒ
نزعة	n a z ʕ a
شرسوف	ʃ u r s uː f
مغلاق	m i ɣ l aː q
منتظم	m u n t a ðˤ a m
مكياج	m a k i j aː d͡ʒ
إمالة	ʔ i m aː l a
عجور	ʕ a d͡ʒ d͡ʒ uː r
اكتنف	i k t a n a f a
مشنة	m i ʃ a n n a
صوة	sˤ u w w a
مطبعة	m a tˤ b a ʕ a
شتاء	ʃ i t aː ʔ
ابتلى	i b t a l aː
بائن	b aː ʔ i n
فلك	f a l a k
مغنيسيا	m a ɣ n iː s i j aː
متين	m a t iː n
حلف	ħ a l a f a
أيقظ	ʔ a j q a ðˤ a
تلفاز	t i l f aː z
أخوية	ʔ a x a w i j j a
آنك	ʔ aː n u k
صنعاء	sˤ a n ʕ aː ʔ
وفق	w a f f a q a
يحيى	j a ħ j aː
أدحية	ʔ u d ħ i j a
قارة	q aː r a
قصاج	q u sˤ aː d͡ʒ
ركيزة	r a k iː z a
استل	i s t a l l a
كرنيب	k a r n iː b
رقصة	r a q sˤ a
لقاح	l a q aː ħ
ديان	d a j j aː n
ثور	θ a w r
كسيح	k a s iː ħ
سفرة	s u f r a
ينبوع	j a n b uː ʕ
بلاعة	b a l l aː ʕ a
راع	r aː ʕ a
باستا	b aː s t aː
يتيم	j a t iː m
أمصوخ	ʔ u m sˤ uː x
سعادة	s a ʕ aː d a
بربخ	b a r b a x
مزاد	m a z aː d
تعالى	t a ʕ aː l aː
عضلة	ʕ a dˤ a l a
طريق	tˤ a r iː q
دونمة	d uː n m a
لفافة	l i f aː f a
كذينق	k u ð iː n a q
أنتما	ʔ a n t u m aː
السبت	a s s a b t
شوبك	ʃ a w b a k
حاجة	ħ aː d͡ʒ a
مهرة	m u h r a
حجرة	ħ u d͡ʒ r a
توسع	t a w a s s a ʕ a
حجن	ħ a d͡ʒ a n a
تفاحة	t u f f aː ħ a
لحظتذاك	l a ħ ðˤ a t a ð aː k a
نهب	n a h a b a
تقرير	t a q r iː r
تقزز	t a q a z z a z a
فيل	f iː l
مصدوم	m a sˤ d uː m
إحاطة	ʔ i ħ aː tˤ a
عبو	ʕ a b w
أنما	ʔ a n n a m aː
قاموس	q aː m uː s
موسيقا	m uː s iː q aː
قفلوط	q a f a l uː tˤ
يربوع	j a r b uː ʕ
راقب	r aː q a b a
معانقة	m u ʕ aː n a q a
ألية	ʔ a l j a
درقة	d a r a q a
ارتباط	i r t i b aː tˤ
قبائلي	q a b aː ʔ i l i j j
تشخيصي	t a ʃ x iː sˤ i j j
يرقة	j a r a q a
ذمم	ð i m a m
مجمد	m u d͡ʒ a m m a d
اليرموك	a l j a r m uː k
ضغبوس	dˤ u ɣ b uː s
لأك	l a ʔ a k a
مكان	m a k aː n
إبليس	ʔ i b l iː s
ألقى	ʔ a l q aː
جرثوم	d͡ʒ u r θ uː m
أسطمة	ʔ u s tˤ u m m a
أصخر	ʔ a sˤ x a r a
تطفل	t a tˤ a f f a l a
ناسفة	n aː s i f a
بندقاني	b u n d u q aː n iː
عمرة	ʕ u m r a
شيرج	ʃ a j r a d͡ʒ
لعنة	l a ʕ n a
أخدود	ʔ u x d uː d
أركن	ʔ a r k u n
سمار	s a m aː r
فاصوليا	f aː sˤ uː l i j aː
مشعاع	m i ʃ ʕ aː ʕ
اجتماعي	i d͡ʒ t i m aː ʕ i j j
بنجنكشت	b a n d͡ʒ a n k u ʃ t
لاذ	l aː ð a
تريث	t a r a j j a θ a
يابس	j aː b i s
أنبج	ʔ a m b i d͡ʒ
مكدس	m u k a d d a s
مايو	m aː j uː
المنامة	a l m a n aː m a
مغسلة	m a ɣ s a l a
استفراغ	i s t i f r aː ɣ
كراويا	k a r aː w i j aː
استمنى	i s t a m n aː
جنب	d͡ʒ a n a b
أعقد	ʔ a ʕ q a d
ابتلاش	i b t i l aː ʃ
مأمأة	m a ʔ m a ʔ a
بواب	b a w w aː b
أبيدجان	ʔ a b iː d d͡ʒ aː n
مرآة	m i r ʔ aː h
إبعاد	ʔ i b ʕ aː d
صيد	sˤ a j d
فاكهة	f aː k h a
استغاث	i s t a ɣ aː θ a
جوهري	d͡ʒ a w h a r i j j
تصدير	t a sˤ d iː r
تحوط	t a ħ a w w a tˤ a
دستوري	d u s t uː r i j j
سرنديب	s a r a n d iː b
العراق	a l ʕ i r aː q
محادث	m u ħ aː d a θ
عربن	ʕ a r b a n a
خادم	x aː d i m
مستقبلي	m u s t a q b a l i j j
ثرب	θ a r b
جبت	d͡ʒ i b t
عانى	ʕ aː n aː
كلب	k a l b
شحن	ʃ a ħ a n a
انتقم	i n t a q a m a
شامخ	ʃ aː m i x
عظمى	ʕ u ðˤ m aː
خيار	x i j aː r
اجتاز	i d͡ʒ t aː z a
قونية	q uː n i j a
أصفهان	ʔ a sˤ f a h aː n
شراع	ʃ i r aː ʕ
أجوف	ʔ a d͡ʒ w a f
زرقطونا	z a r q a tˤ uː n aː
رزتاق	r u z t aː q
عافية	ʕ aː f i j a
تذاكى	t a ð aː k aː
عسكر	ʕ a s k a r
طرشي	tˤ u r ʃ i j j
متكبر	m u t a k a b b i r
سطام	s i tˤ aː m
شهاب	ʃ i h aː b
إيا	ʔ i j j aː
هندس	h a n d a s a
صاج	sˤ aː d͡ʒ
درزن	d a r z a n
مطار	m a tˤ aː r
بطارخ	b a tˤ aː r i x
صيدلة	sˤ a j d a l a
اعتزام	i ʕ t i z aː m
جعفيل	d͡ʒ a ʕ f iː l
غفر	ɣ a f a r a
شاذ	ʃ aː ð ð
حالة	ħ aː l a
أخامص	ʔ a x aː m i sˤ
تفرغ	t a f a r r a ɣ a
حوجلة	ħ a w d͡ʒ a l a
واحة	w aː ħ a
محطة	m a ħ a tˤ tˤ a
رمم	r a m m a m a
أنتم	ʔ a n t u m
لعبة	l a ʕ b a
الإنجيل	a l ʔ i n d͡ʒ iː l
مرشد	m u r ʃ i d
رضوخ	r u dˤ uː x
خرس	x a r a s a
عريان	ʕ u r j aː n
شاشية	ʃ aː ʃ i j j a
جسم	d͡ʒ a s s a m a
سلامة	s a l aː m a
تمساح	t i m s aː ħ
إنقاض	ʔ i n q aː dˤ
ببنودة	b a b n uː d a
شرق	ʃ a r q
تايوان	t aː j w aː n
ترنح	t a r a n n a ħ a
بورتسودان	b uː r t s uː d aː n
لهي	l a h i j a
مرو	m a r w
حرق	ħ a r a q a
عصب	ʕ a sˤ a b a
خباز	x a b b aː z
واطن	w aː tˤ a n a
مخفر	m a x f a r
أكاذيب	ʔ a k aː ð iː b
بوسة	b a w s a
احتكار	i ħ t i k aː r
صأكة	sˤ a ʔ k a
براعة	b a r aː ʕ a
حيران	ħ a j r aː n
ليل	l a j l
أناغاليس	ʔ a n aː ɣ aː l iː s
رستاق	r u s t aː q
ضمور	dˤ u m uː r
شبع	ʃ a b i ʕ a
نقيض	n a q iː dˤ
ماثل	m aː θ a l a
قدم	q a d a m
طموحات	tˤ u m uː ħ aː t
فاقة	f aː q a
ندوات	n a d a w aː t
لهذا	l i h aː ð aː
ضبط	dˤ a b a tˤ a
ليث	l a j θ
نافى	n aː f aː
بقرة	b a q a r a
روض	r a w w a dˤ a
مدة	m a d d a
مسى	m a s aː
عبيثران	ʕ a b a j θ a r aː n
غالب	ɣ aː l i b
وسق	w a s q
أدهش	ʔ a d h a ʃ a
جهادي	d͡ʒ i h aː d i j j
إسرنج	ʔ i s r i n d͡ʒ
خشاب	x a ʃ ʃ aː b
باحث	b aː ħ a θ a
نفاذ	n a f aː ð
إسماعيل	ʔ i s m aː ʕ iː l
تناقض	t a n aː q a dˤ a
فالوذق	f aː l uː ð a q
عمروسة	ʕ a m r uː s a
برن	b i r n
أغلب	ʔ a ɣ l a b
تفاح	t u f f aː ħ
تخدر	t a x a d d a r a
تيش	t iː ʃ
توزيع	t a w z iː ʕ
صقنقور	sˤ a q a n q uː r
إفادة	ʔ i f aː d a
دارفلفل	d aː r f i l f i l
خصص	x a sˤ sˤ a sˤ a
توازى	t a w aː z aː
عطاء	ʕ a tˤ aː ʔ
غناء	ɣ i n aː ʔ
استقبال	i s t i q b aː l
سقم	s a q a m
خارج	x aː r i d͡ʒ
فهم	f a h h a m a
قبرة	q u b b a r a
أنعم	ʔ a n ʕ a m
سخبر	s a x b a r
شيردال	ʃ iː r d aː l
شريعة	ʃ a r iː ʕ a
استنفد	i s t a n f a d a
مرحبا	m a r ħ a b aː
يافوخ	j aː f uː x
رادود	r aː d uː d
مراسل	m u r aː s i l
انفتح	i n f a t a ħ a
بخص	b a x a sˤ
محراث	m i ħ r aː θ
هود	h a w d
شبوطة	ʃ a b b uː tˤ a
جنيف	d͡ʒ i n iː f
تقية	t a q i j j a
تقني	t i q n i j j
كندس	k u n d u s
أنضب	ʔ a n dˤ a b a
وغد	w a ɣ d
شيرة	ʃ a j r a
فيروس	f a j r uː s
سعي	s a ʕ j
إعلان	ʔ i ʕ l aː n
وسد	w a s s a d a
سلجم	s a l d͡ʒ a m
كفى	k a f aː
حنجري	ħ a n d͡ʒ a r i j j
أنواع	ʔ a n w aː ʕ
تسعون	t a s ʕ a w n a
مفاجأة	m u f aː d͡ʒ a ʔ a
مسطرة	m i s tˤ a r a
اعتلى	i ʕ t a l aː
رحيل	r a ħ iː l
صرب	sˤ a r a b a
بقر	b a q a r
الذي	a l l a ð iː
حافة	ħ aː f a
قابل	q aː b a l a
أنواط	ʔ a n w aː tˤ
قبو	q a b w
صاع	sˤ aː ʕ
جلاد	d͡ʒ a l l aː d
أبلس	ʔ a b l a s a
وعليكم	w a ʕ a l a j k u m
مازريون	m aː z a r i j uː n
دهنج	d a h n a d͡ʒ
منذ	m u n ð u
مشاعر	m a ʃ aː ʕ i r
ولاية	w a l aː j a
نظام	n i ðˤ aː m
تحاشى	t a ħ aː ʃ aː
غيظ	ɣ a j ðˤ
فقس	f a q a s a
ميثاق	m iː θ aː q
عجاوة	ʕ u d͡ʒ aː w a
ناقص	n aː q i sˤ
أجرب	ʔ a d͡ʒ r a b
نقطة	n u q tˤ a
دستة	d a s t a
استفسار	i s t i f s aː r
نبرة	n a b r a
ناجذ	n aː d͡ʒ i ð
خرطال	x a r tˤ aː l
كذين	k u ð iː n
خوذة	x uː ð a
عاشب	ʕ aː ʃ i b
باطية	b aː tˤ i j a
فقاعة	f u q q aː ʕ a
صغير	sˤ a ɣ iː r
إطراء	ʔ i tˤ r aː ʔ
تعلة	t a ʕ i l l a
إرادي	ʔ i r aː d i j j
القاهرة	a l q aː h i r a
بحر	b a ħ a r
شعبية	ʃ a ʕ b i j j a
بند	b a n d
حدوة	ħ a d w a
سلافي	s l aː f i j j
احتضن	i ħ t a dˤ a n a
طيرة	tˤ a j r a
أسطوري	ʔ u s tˤ uː r i j j
عسبق	ʕ a s b a q
صمام	sˤ i m aː m
أوحل	ʔ a w ħ a l a
قشمير	q i ʃ m iː r
معاوية	m u ʕ aː w i j a
تلم	t a l a m
كأب	k a ʔ b
سطح	s a tˤ ħ
زوفا	z uː f aː
ظربان	ðˤ a r i b aː n
متصل	m u t t a sˤ i l
ساحلي	s aː ħ i l i j j
ينسون	j a n s uː n
رقم	r a q m
أسترالي	ʔ u s t u r aː l i j j
انشقاق	i n ʃ i q aː q
رفاهة	r a f aː h a
جعضيض	d͡ʒ a ʕ dˤ iː dˤ
ذكاء	ð a k aː ʔ
كافتيريا	k aː f i t iː r i j aː
حصل	ħ a sˤ a l
شقة	ʃ a q q a
شعيب	ʃ u ʕ a j b
مضض	m a dˤ a dˤ
عنقاد	ʕ i n q aː d
مداخلة	m u d aː x a l a
قبيلة	q a b iː l a
نساب	n a s s aː b
ألهى	ʔ a l h aː
دفلى	d i f l aː
عابس	ʕ aː b i s
متخلف	m i t x a l l a f
ثريد	θ a r iː d
ستارة	s i t aː r a
قيصر	q a j sˤ a r
ترنيم	t a r n iː m
اتحاد	i t t i ħ aː d
مسطار	m i s tˤ aː r
غلا	ɣ a l aː
دماغ	d i m aː ɣ
مسيح	m a s iː ħ
إيجار	ʔ iː d͡ʒ aː r
مطب	m a tˤ a b b
خرقة	x i r q a
مرجان	m a r d͡ʒ aː n
المغرب	a l m a ɣ r i b
مراوغة	m u r aː w a ɣ a
ارتخى	i r t a x aː
بولاد	b uː l aː d
تليس	t a l l iː s
دهس	d a h a s a
أسماء	ʔ a s m aː ʔ
ردد	r a d d a d a
محترف	m u ħ t a r i f
سماء	s a m aː ʔ
تقيؤ	t a q a j j u ʔ
تخفيض	t a x f iː dˤ
مقلق	m u q l i q
اشتهى	i ʃ t a h aː
صخيد	sˤ a x iː d
دشداشة	d i ʃ d aː ʃ a
مذهبي	m a ð h a b i j j
قرد	q a r d
قيمة	q iː m a
عندما	ʕ i n d a m aː
قفازات	q u f f aː z aː t
فاض	f aː dˤ a
عظيم	ʕ a ðˤ iː m
فودنج	f uː d a n a d͡ʒ
مضمون	m a dˤ m uː n
قنبيل	q a n b iː l
زراعي	z i r aː ʕ i j j
نطل	n a tˤ a l a
اتصال	i t t i sˤ aː l
زائر	z aː ʔ i r
تجارة	t i d͡ʒ aː r a
معجزات	m u ʕ d͡ʒ i z aː t
ناعم	n aː ʕ i m
أنكر	ʔ a n k a r a
ثيوقراطي	θ i j uː q r aː tˤ i j j
هذر	h a ð a r a
نفث	n a f a θ a
طلب	tˤ a l a b
أمير	ʔ a m iː r
إدحية	ʔ i d ħ i j a
وصيد	w a sˤ iː d
أشل	ʔ a ʃ a l l
حوول	ħ uː w i l a
حبارى	ħ u b aː r aː
نحن	n a ħ n i
غرب	ɣ a r a b
تذكرة	t a ð k i r a
حبق	ħ a b a q
غرامة	ɣ a r aː m a
بواليع	b a w aː l iː ʕ
انتماء	i n t i m aː ʔ
ياسين	j aː s iː n
خزينة	x a z iː n a
مقاعد	m a q aː ʕ i d
استعمل	i s t a ʕ m a l a
ميعاد	m iː ʕ aː d
فوج	f a w d͡ʒ
شاء	ʃ aː ʔ
هرولة	h a r w a l a
خاطئ	x aː tˤ i ʔ
عروس	ʕ a r uː s
رابط	r aː b i tˤ
رهبانية	r a h b aː n i j j a
طائفة	tˤ aː ʔ i f a
أنهك	ʔ a n h a k a
قاوق	q aː w u q
بامية	b aː m i j a
وابور	w aː b uː r
دولاب	d a w l aː b
مسيحي	m a s iː ħ i j j
باطس	b aː tˤ u s
مقشدة	m i q ʃ a d a
جلس	d͡ʒ a l a s a
أغيد	ʔ a ɣ j a d
صرق	sˤ a r a q
رفأ	r a f a ʔ a
مظلة	m a ðˤ a l l a
جائز	d͡ʒ aː ʔ i z
بغيض	b a ɣ iː dˤ
كوالا	k u w aː l aː
كارة	k aː r a
إيران	ʔ iː r aː n
اعتقاد	i ʕ t i q aː d
ريح	r a j j a ħ a
استمات	i s t a m aː t a
خرفة	x u r f a
سلاف	s u l aː f
أسف	ʔ a s a f f a
فأس	f a ʔ s
سلوى	s a l w aː
كسرة	k a s r a
خوف	x a w f
حنان	ħ a n aː n
معاينة	m u ʕ aː j a n a
استهجان	i s t i h d͡ʒ aː n
عوائد	ʕ a w aː ʔ i d
ثورة	θ a w r a
زنباع	z a n b aː ʕ
مقطعية	m a q tˤ a ʕ i j j a
أثث	ʔ a θ θ a θ a
شيهم	ʃ a j h a m
ضجيج	dˤ a d͡ʒ iː d͡ʒ
عزيز	ʕ a z iː z
خابور	x aː b uː r
مرأة	m a r ʔ a
راجل	r aː d͡ʒ i l
إلحاق	ʔ i l ħ aː q
أبنوس	ʔ a b a n uː s
اعتل	i ʕ t a l l a
كعبة	k a ʕ b a
شهترج	ʃ a h t a r a d͡ʒ
صابورة	sˤ aː b uː r a
بكرج	b a k r a d͡ʒ
طبقة	tˤ a b a q a
غضة	ɣ a dˤ dˤ a
فيثاغورس	f iː θ aː ɣ uː r a s
قنص	q a n a sˤ a
سريان	s a r a j aː n
طليعة	tˤ a l iː ʕ a
مجموع	m a d͡ʒ m uː ʕ
هذيان	h a ð a j aː n
عجب	ʕ a d͡ʒ a b
براين	b r aː j a n
فتخاء	f a t x aː ʔ
خلية	x a l i j j a
مروض	m u r a w w a dˤ
نفخ	n a f a x a
عرزال	ʕ i r z aː l
حظيرة	ħ a ðˤ iː r a
استجاب	i s t a d͡ʒ aː b a
فرضية	f a r a dˤ i j j a
باكستاني	b aː k i s t aː n i j j
تفاف	t i f aː f
صحرة	sˤ u ħ r a
عربز	ʕ a r b a z
دركي	d a r a k i j j
أساس	ʔ a s aː s
تخم	t a x m
الآخرة	a l ʔ aː x i r a
دقع	d a q i ʕ a
اقترح	i q t a r a ħ a
فاكرة	f aː k i r a
لهجة	l a h d͡ʒ a
نرويجية	n u r w iː d͡ʒ i j j a
أبد	ʔ a b a d
ملوكية	m u l uː k i j j a
كزبرة	k u z b a r a
صتع	sˤ a t a ʕ a
عقدة	ʕ u q d a
شليل	ʃ a l iː l
جندب	d͡ʒ u n d u b
سمن	s a m i n a
إرتريا	ʔ i r i t r i j aː
منفاخ	m i n f aː x
توجه	t a w a d͡ʒ d͡ʒ a h a
شلال	ʃ a l l aː l
صفد	sˤ a f a d
ظهر	ðˤ a h a r a
إهداء	ʔ i h d aː ʔ
مغرفة	m i ɣ r a f a
بريطاني	b a r iː tˤ aː n i j j
ذعن	ð a ʕ i n a
سكران	s a k r aː n
سلسل	s a l s a l a
جمجمة	d͡ʒ u m d͡ʒ u m a
بندق	b u n d u q
ذئب	ð i ʔ b
صحل	sˤ a ħ i l a
شاكرة	ʃ aː k i r a
جاورجيوس	d͡ʒ aː w u r d͡ʒ i j uː s
قلقطار	q a l q a tˤ aː r
استوقف	i s t a w q a f a
أدحوة	ʔ u d ħ u w w a
قروش	q u r uː ʃ
كاعب	k aː ʕ i b
ملجأ	m a l d͡ʒ a ʔ
بوذية	b uː ð i j j a
عانس	ʕ aː n i s
رجع	r a d͡ʒ a ʕ a
أعيا	ʔ a ʕ j aː
أحد	ʔ a ħ a d
جخى	d͡ʒ a x x aː
فراء	f a r aː ʔ
انجذاب	i n d͡ʒ i ð aː b
رأي	r a ʔ j
ظليم	ðˤ a l iː m
حدق	ħ a d a q a
سخيف	s a x iː f
مباراة	m u b aː r aː h
فالوذة	f aː l uː ð a
عدد	ʕ a d a d
قطران	q a tˤ a r aː n
نملة	n a m l a
فتح	f a t a ħ a
سيكولوجي	s a j k uː l uː d͡ʒ i j j
بعلة	b a ʕ l a
شارع	ʃ aː r i ʕ
ورشنوفة	w a r ʃ a n uː f a
جانرك	d͡ʒ aː n a r i k
احترق	i ħ t a r a q a
قرنبيط	q a r n a b iː tˤ
جدار	d͡ʒ i d aː r
رسغ	r u s ɣ
مئذنة	m i ʔ ð a n a
ساحة	s aː ħ a
كدس	k a d a s a
إشفى	ʔ i ʃ f aː
أنضج	ʔ a n dˤ a d͡ʒ a
إداري	ʔ i d aː r i j j
منتخب	m u n t a x a b
المريخ	a l m i r r iː x
جبان	d͡ʒ a b aː n
مريمية	m a r j a m i j j a
ردم	r a d a m a
مرددوش	m a r d a d uː ʃ
رابع	r aː b i ʕ
غمود	ɣ u m uː d
قاوون	q aː w uː n
زنباعة	z a n b aː ʕ a
أفغانستان	ʔ a f ɣ aː n i s t aː n
بهشية	b a h a ʃ i j j a
مصفاة	m i sˤ f aː h
استنتاج	i s t i n t aː d͡ʒ
اكترى	i k t a r aː
لاحم	l aː ħ i m
اتسم	i t t a s a m a
مثلث	m u θ a l l a θ
تضاد	t a dˤ aː d d a
إلكترونيات	ʔ i l i k t r uː n i j j aː t
فيج	f a j d͡ʒ
إفرند	ʔ i f r i n d
تراب	t u r aː b
سهول	s u h uː l
أبهج	ʔ a b h a d͡ʒ a
بلور	b i l l a w r
أرغان	ʔ a r ɣ aː n
تبغ	t a b ɣ
احتفال	i ħ t i f aː l
شنع	ʃ a n n a ʕ a
مرقد	m a r q a d
بهائي	b a h aː ʔ i j j
سقيفة	s a q iː f a
أرثوذكسي	ʔ u r θ uː ð u k s i j j
النيجر	a n n iː d͡ʒ a r
جبيز	d͡ʒ a b iː z
ذهب	ð a h a b
وقت	w a q a t
شهادة	ʃ a h aː d a
تمهيد	t a m h iː d
غافث	ɣ aː f a θ
مركب	m a r k a b
نعجة	n a ʕ d͡ʒ a
فقري	f i q r i j j
وقع	w a q a ʕ a
دراسي	d i r aː s i j j
محيط	m u ħ iː tˤ
لاءم	l aː ʔ a m a
ندم	n a d a m
