آئورت	ɑː ʔ o ɾ t
آب	ɑː b
آباد	ɑː b ɑː d
آبان	ɑː b ɑː n
آبدست	ɑː b d a s t
آبشار	ɑː b ʃ ɑː ɾ
آبلیمو	ɑː b l iː m uː
آبنوس	ɑː b n uː s
آبگینه	ʔ ɑː b ɡ iː n e
آبی	ɑː b iː
آتش	ɑː tʰ a ʃ
آتنا	ɑː t i n ɑː
آجر	ɑː d͡ʒ u ɾ
آجیل	ɑː d͡ʒ iː l
آخ	ɑː χ
آخر	ɑː x a ɾ
آخور	ʔ ɑː xʷ a ɾ
آخوند	ɑː x uː n d
آدرس	ɑː d ɾ e s
آدم	ɑː d a m
آدم‌ها	ɑː d a m h ɑː
آدینه	ɑː d iː n a
آذر	ɑː z a ɾ
آذربایجان	ɑː z a ɾ b ɑː j d͡ʒ ɑː n
آذرخش	ɑː ð a ɾ a x ʃ
آراستن	ɑː ɾ ɑː s t a n
آرام	ɑː ɾ ɑː m
آرامگاه	ɑː ɾ ɑː m ɡ ɑː h
آرامی	ɑː ɾ ɑː m iː
آرایش	ɑː ɾ ɑː j i ʃ
آرایشگاه	ɑː ɾ ɑː j i ʃ ɡ ɑː h
آرد	ɑː ɾ d
آرزو	ɑː ɾ i z uː
آرپا	ɑː ɾ p ɑː
آرژانتین	ɑː ɾ ʒ ɑː n t iː n
آری	ɑː ɾ eː
آزاد	ɑː z ɑː d
آزادی	ɑː z ɑː d iː
آزردن	ɑː z o ɾ d a n
آزمایش	ɑː z m ɑː j i ʃ
آزمایشگاه	ɑː z m ɑː j i ʃ ɡ ɑː h
آزمودن	ɑː z m uː d a n
آزموده	ɑː z m uː d a
آسام	ɑː s ɑː m
آسان	ɑː s ɑː n
آسانی	ɑː s ɑː n iː
آسایش	ɑː s ɑː j i ʃ
آستانه	ɑː s t ɑː n a
آستانه‌ای	ɑː s t ɑː n a iː
آسمان	ɑː s i m ɑː n
آسمانخراش	ɑː s m ɑː n x a ɾ ɑː ʃ
آسیا	ɑː s ɪ j ɑː
آسیاب	ɑː s i j ɑː b
آش	ʔ ɑː ʃ
آشتی	ɑː ʃ t iː
آشفته	ɑː ʃ u f t a
آشنا	ɑː ʃ i n ɑː
آشوب	ɑː ʃ oː b
آشوب‌ها	ɑː ʃ uː b h ɑː
آشپز	ɑː ʃ p a z
آشپزخانه	ɑː ʃ p a z x ɑː n a
آغا	ɑː ɣ ɑː
آغاز	ɑː ɣ ɑː z
آغوش	ɑː ɣ oː ʃ
آغیل	ɑː ɣ iː l
آفت	ɑː f a t
آفتاب	ɑː f t ɑː b
آفریدن	ɑː f a ɾ iː d a n
آفرین	ɑː f a ɾ iː n
آفرینش	ɑː f a ɾ iː n i ʃ
آفند	ɑː f a n d
آقا	ɑː q ɑː
آلاله	ɑː l ɑː l a
آلایش	ɑː l ɑː j i ʃ
آلت	ɑː l a t
آلرژی	ɑː l i ɾ ʒ iː
آلفته	ɑː l u f t a
آلمان	ɑː l m ɑː n
آلودن	ɑː l uː d a n
آمار	ɑː m ɑː ɾ
آمارگر	ɑː m ɑː ɾ ɡ a ɾ
آمد	ɑː m a d
آمدن	ɑː m a d a n
آمرزیدن	ɑː m u ɾ z iː d a n
آموختن	ɑː m oː x t a n
آموزش	ɑː m oː z i ʃ
آموزگار	ɑː m oː z ɡ ɑː ɾ
آمیتیست	ɑː m iː t iː s t
آمیختن	ɑː m eː x t a n
آمیزش	ɑː m iː z e ʃ
آن	ɑː n
آنجا	ɑː n d͡ʒ ɑː
آنغوزه	ɑː n ɣ u z a
آنقدر	ɑː n q a d ɾ
آنلاین	ɑː n l ɑː j n
آهار	ɑː h ɑː ɾ
آهسته	ɑː h i s t a
آهن	ɑː h a n
آهنگ	ɑː h a n ɡ
آهنین	ɑː h a n iː n
آوا	ɑː w ɑː
آواز	ɑː w ɑː z
آوازه	ɑː w ɑː z a
آویختن	ɑː w eː x t a n
آچار	ɑː t͡ʃ ɑː ɾ
آژیر	ɑː ʔ ʒ iː ɾ
آکندن	ʔ ɑː k a n d a n
آگاه	ɑː ɡ ɑː h
آیا	ɑː j ɑː
آیت‌الله	ɑː j a t u l l ɑː h
آینده	ɑː j a n d a
ائتلاف	e ʔ t e l ɑː f
ابتدا	e b t e d ɑː
ابتکار	e b t e k ɑː ɾ
ابد	a b a d
ابر	a b a ɾ
ابراهیم	e b ɾ ɑː h iː m
ابرش	a b ɾ a ʃ
ابرنواختر	a b a ɾ n a v a x t a ɾ
ابرو	a b ɾ u
ابری	ʔ a b ɾ iː
ابریشم	a b ɾ i ʃ a m
ابریق	e b ɾ iː ɢ
ابری‌ساز	ʔ a b ɾ iː s ɑː z
ابری‌سازی	ʔ a b ɾ iː s ɑː z iː
ابزار	a b z ɑː ɾ
ابلیس	e b l iː s
ابهام	e b h ɑː m
ابوبکر	a b u b a k ɾ
اتاق	o t ɑː ɢ
اتحاد	e t t e h ɑː d
اتحادیه	e t t e h ɑː d iː j e
اتراق	o t ɾ ɑː ɢ
اتصال	e t t e s ɑː l
اتفاق	e t t e f ɑː ɢ
اتفاقاً	e t t e f ɑː ɢ a n
اتلاف	e t l ɑː f
اتم	a t o m
اتمام	e t m ɑː m
اتم‌ها	a t o m h ɑː
اثاث	a s ɑː s
اثبات	e s b ɑː t
اثر	a s a ɾ
اجازه	e d͡ʒ ɑː z e
اجاق	o d͡ʒ ɑː ɢ
اجتماع	e d͡ʒ t e m ɑː ʔ
اجتماعی	e d͡ʒ t e m ɑː ʔ iː
احترام	e h t e ɾ ɑː m
احتمال	e h t e m ɑː l
احتیاج	e h t i j ɑː d͡ʒ
احساس	e h s ɑː s
احمدی‌نژاد	a h m a d i n i ʒ ɑː d
احمق	a h m a q
اخبار	a x b ɑː ɾ
اخترمار	a x t a ɾ m ɑː ɾ
اختصار	e x t e s ɑː ɾ
اختیار	e x t i j ɑː ɾ
اخذ	ʔ a x z
اخراج	e x ɾ ɑː d͡ʒ
اخیرا	a x i ɾ a n
ادا	a d ɑː
اداره	e d ɑː ɾ e
ادامه	e d ɑː m e
ادبیات	a d a b i j ɑː t
ادغام	e d ɢ ɑː m
ادویه	a d v i j a
ادیان	a d j ɑː n
اذان	a z ɑː n
اذیت	a z i j a t
ارادت	e ɾ ɑː d a t
اراده	e ɾ ɑː d e
ارتش	a ɾ t i ʃ
ارتعاش	e ɾ t e ʔ ɑː ʃ
ارده	a ɾ d a
اردو	o ɾ d uː
اردیبهشت	o ɾ d iː b e h e ʃ t
ارزان	a ɾ z ɑː n
ارزش	a ɾ z i ʃ
ارزشمند	a ɾ z i ʃ m a n d
ارزیدن	a ɾ z i d a n
ارس	a ɾ a s
ارسطو	a ɾ a s t u
ارشد	a ɾ ʃ a d
ارض	a ɾ z
ارغنون	a ɾ ɣ a n uː n
ارغوان	a ɾ ɣ a v ɑː n
ارغوانی	a ɾ ɣ a v ɑː n iː
ارمنستان	a ɾ m a n i s t ɑː n
ارگ	o ɾ ɡ
اریحا	a ɾ i h ɑː
از	a z
ازاله	e z ɑː l e
ازبکستان	o z b a k e s t ɑː n
ازدواج	e z d e v ɑː d͡ʒ
ازگیل	a z ɡ i l
اساتید	a s ɑː t iː d
اسب	a s b
اسبغول	e s b a ɢ uː l
استاد	o s t ɑː d
استادانه	ʔ o s tʰ ɑː d̪ ɑː n e
استان	o s t ɑː n
استاندار	o s tʰ uː n d ɑː ɾ
استخدام	e s t e x d ɑː m
استخوان	o s t o x ɑː n
استراتژی	ɛ s t ɾ ɑː t ɛ ʒ iː
استراحت	e s t e ɾ ɑː h a t
استعداد	e s t e ʔ d ɑː d
استقبال	e s t e ɢ b ɑː l
استقلال	e s t e ɢ l ɑː l
استیون	e s t iː v e n
اسطوره	o s t uː ɾ e
اسفرزه	e s f a ɾ z e
اسفناج	e s f e n ɑː d͡ʒ
اسفند	e s f a n d̪
اسلام	ʔ e s l ɑː m
اسلامی	e s l ɑː m iː
اسلام‌گرا	e s l ɑː m ɡ a ɾ ɑː
اسلوب	o s l uː b
اسلیمی	e s l iː m iː
اسم	e s m
اسپرزه	e s p a ɾ z e
اسپریس	ʔ e s p a ɾ eː s
اسپست	a s p i s t
اسپغول	e s p a ɢ uː l
اسپندان	e s p a n d ɑː n
اسپهسالار	ʔ e s p a h s ɑː l ɑː ɾ
اسکدار	a s k u d ɑː ɾ
اسکندر	e s k a n d a ɾ
اشتباه	e ʃ t e b ɑː h
اشتباهی	e ʃ t e b ɑː h iː
اشتر	ʔ o ʃ t o ɾ
اشتراک	e ʃ t e ɾ ɑː k
اشترخار	o ʃ t o ɾ x ɑː ɾ
اشترغار	o ʃ t o ɾ ɢ ɑː ɾ
اشرج	a ʃ r a d ʒ
اشک	a ʃ k
اشکال	a ʃ k ɑː l
اصطبل	e s t a b l
اصفهان	e s f a h ɑː n
اصفهانی	e s f a h ɑː n iː
اصل	a s l
اصلاح	e s l ɑː h
اصلاً	a s l a n
اصلی	a s l iː
اصول‌گرا	o s uː l ɡ a ɾ ɑː
اصیل	a s i l
اضافه	e z ɑː f e
اطمینان	e t m iː n ɑː n
اظهار	e z h ɑː ɾ
اعتدال	e ʔ t e d ɑː l
اعتقاد	e ʔ t e ɢ ɑː d
اعتماد	e ʔ t e m ɑː d
اعتیاد	e ʔ t i j ɑː d
اعدام	e ʔ d ɑː m
اعضا	a ʔ z ɑː
اعلام	e ʔ l ɑː m
اعنی	a ʔ n iː
اغلب	a ɣ l a b
اغوا	e ɢ v ɑː
افتادن	o f t ɑː d a n
افتخار	e f t e x ɑː ɾ
افرنگ	a f ɾ a n ɡ
افزایش	a f z ɑː j i ʃ
افزودن	a f z u d a n
افسانه	a f s ɑː n a
افسر	a f s a ɾ
افسردگی	a f s u ɾ d i ɡ iː
افسوس	a f s oː s
افسون	a f s oː n
افشاندن	a f ʃ ɑː n d a n
افشردن	a f ʃ o ɾ d a n
افطار	e f t ɑː ɾ
افغان	a f ɣ ɑː n
افغانستان	a f ɣ ɑː n i s t ɑː n
افغانی	a f ɣ ɑː n iː
افلاطون	a f l ɑː t uː n
افیون	ʔ a f j uː n
اقتصادی	e ɢ t e s ɑː d iː
اقرار	e ɢ ɾ ɑː ɾ
اقلا	a q a l l a n
اقلیت	a q a l l i j a t
اقلیم	e ɢ l iː m
اقلیم‌شناسی	e ɢ l iː m ʃ e n ɑː s iː
اقمار	a q m ɑː ɾ
اقیانوس	o ɢ j ɑː n uː s
الان	ʔ a l ʔ ɑː n
البته	a l b a t t a
البرز	ʔ a l b o ɾ z
الحاق	e l h ɑː ɢ
القاعده	a l q ɑː ʔ i d a
الله‌قلی	a l l ɑː h q u l iː
الماس	a l m ɑː s
الماس‌ها	a l m ɑː s h ɑː
المزده	a l a m z a d e
الموت	ʔ a l a m uː t
اله	e l ɑː h
الهام	e l h ɑː m
الهه	e l ɑː h e
ام	e m
امام	e m ɑː m
امامقلی	e m ɑː m ɢ o l iː
امت	o m m a t
امتحان	e m t e h ɑː n
امر	a m ɾ
امروز	e m ɾ uː z
امسال	e m s ɑː l
امشب	e m ʃ a b
امضاء	e m z ɑː
امکان	e m kʰ ɑː n
امید	o m iː d
امیدیار	ʔ o m iː d y ɑː ɾ
امین	a m iː n
امین‌ها	a m iː n h ɑː
ان	ɑː n
انار	a n ɑː ɾ
انبار	ʔ a m b ɑː ɾ
انتحار	e n t e h ɑː ɾ
انتخاب	e n t e x ɑː b
انتشار	e n t e ʃ ɑː ɾ
انتقاد	e n t e ɢ ɑː d
انتقام	e n t e ɢ ɑː m
انجام	a n d͡ʒ ɑː m
انجامیدن	a n d͡ʒ ɑː m iː d a n
انجمن	ʔ a n d͡ʒ o m a n
انداختن	a n d ɑː x t a n
اندازه	a n d ɑː z a
اندی	a n d eː
اندیشه	a n d e ʃ a
اندیشیدن	a n d e ʃ i d a n
انرژی	a n a ɾ ʒ iː
انزال	e n z ɑː l
انزروت	a n z a ɾ u t
انسان	e n s ɑː n
انطاکیه	a n t ɑː k i j a
انعکاس	e n ʔ e k ɑː s
انفجار	e n f e d͡ʒ ɑː ɾ
انقلاب	e n ɢ e l ɑː b
انقلابی	e n ɢ e l ɑː b iː
انه	ɑː n a
انکار	e n k ɑː ɾ
انگاشتن	a n ɡ ɑː ʃ t a n
انگبین	a n ɡ a b i n
انگشت	a n ɡ i ʃ t
انگشتر	a n ɡ u ʃ t a ɾ
انگلستان	e n ɡ e l e s t ɑː n
انگلیس	ʔ e ŋ ɡʲ e l iː s
انگور	a n ɡ u ɾ
انگیختن	a ŋ ɡ iː x t a n
انگیزه	a n ɡ e z a
ان‌شاءالله	e n ʃ ɑː ʔ a l l ɑː h
اهریمن	ʔ a h ɾ iː m a n
اهمیت	a h a m i j a t
اهواز	a h w ɑː z
اهورامزدا	a h u ɾ ɑː m a z d ɑː
او	oː
اورشلیم	ʔ o ɾ ʃ a l iː m
اورنگ	a v ɾ a n ɡ
اولی	a v v a l iː
اوکی	o kʰ e j
اوگاندا	u ɡ ɑː n d ɑː
اً	t a n v i n
اژدها	a ʒ d a h ɑː
اکثر	a k s a ɾ
اگرچه	a ɡ a ɾ t ʃ e
اگیر	a ɡ i ɾ
ای	e j
ایالت	i j ɑː l a t
ایام	ʔ a j j ɑː m
ایدون	e d u n
ایران	e ɾ ɑː n
ایرانشهر	e ɾ ɑː n ʃ a h ɾ
ایرانی	e ɾ ɑː n iː
ایرانیان	iː ɾ ɑː n i j ɑː n
ایران‌ویج	e ɾ ɑː n v e d͡ʒ
ایستادن	i s t ɑː d a n
ایستگاه	i s t ɡ ɑː h
ایشان	e ʃ ɑː n
ایمان	i m ɑː n
ایمان‌دار	i m ɑː n d ɑː ɾ
این	i n
ایوب	a j j u b
با	b ɑː
باب	b ɑː b
بابا	b ɑː b ɑː
بابل	b ɑː b i l
بابک	b ɑː b a k
باجی	b ɑː d ʒ iː
باحال‌تر	b ɑː h ɑː l t a ɾ
باحال‌ترین	b ɑː h ɑː l t a ɾ iː n
باد	b ɑː d
بادام	b ɑː d ɑː m
بادبانی	b ɑː d b ɑː n iː
بادبزن	b ɑː d b i z a n
بادرنگ	b ɑː d ɾ a n ɡ
بار	b ɑː ɾ
باران	b ɑː ɾ ɑː n
باردار	b ɑː ɾ d ɑː ɾ
بارداری	b ɑː ɾ d ɑː ɾ iː
بارش	b ɑː ɾ i ʃ
باره	b ɑː ɾ a
باروت	b ɑː ɾ uː t
بارود	b ɑː ɾ uː d
باریک	b ɑː ɾ iː k
باریک‌تر	b ɑː ɾ iː k t a ɾ
باریک‌ترین	b ɑː ɾ iː k t a ɾ iː n
باز	b ɑː z
بازار	b ɑː z ɑː ɾ
بازدید	b ɑː z d iː d
بازرگان	b ɑː z a ɾ ɡ ɑː n
بازنشسته	b ɑː z n i ʃ a s t a
بازنشستگی	b ɑː z n i ʃ a s t a ɡ iː
بازوبند	b ɑː z uː b a n d
بازیچه	b ɑː z iː t ʃʰ e
باستان	b ɑː s t ɑː n
باستانی	b ɑː s t ɑː n iː
باستان‌شناس	b ɑː s t ɑː n ʃ i n ɑː s
باسن	b ɑː s a n
باعث	b ɑː ʔ i s
باغ	b ɑː ɣ
باغات	b ɑː ɣ ɑː t̪
باغبان	b ɑː ɣ b ɑː n
باغ‌ها	b ɑː ɣ h ɑː
باف	b ɑː f
باقلوا	b ɑː q l a w ɑː
بال	b ɑː l
بالا	b ɑː l ɑː
بالاخره	b e l a x a ɾ e
بالغ	b ɑː l e ɣ
بام	b ɑː m
بامداد	b ɑː m d ɑː n
بامزه	b ɑː m a z e
بامزه‌تر	b ɑː m a z e t a ɾ
بامزه‌ترین	b ɑː m a z e t a ɾ iː n
بان	b ɑː n
بانو	b ɑː n uː
بانک	b ɑː n k
باهوش	b ɑː h uː ʃ
باور	b ɑː w a ɾ
باژ	b ɑː ʒ
باژدار	b ɑː ʒ d ɑː ɾ
باید	b ɑː j a d
بایست	b ɑː j e s t
بایستن	b ɑː j i s t a n
بایستی	b ɑː j a s t iː
ببر	b a b ɾ
بتکده	b o t k a d e
بحث	b a h s
بحر	b a h ɾ
بحران	b o h ɾ ɑː n
بحریه	b a h ɾ i j a
بخار	b o x ɑː ɾ
بخارا	b o x ɑː ɾ ɑː
بخاطر	b a x ɑː t i ɾ i
بختر	b e x t a ɾ
بختیار	b a x t i j ɑː ɾ
بخش	b a x ʃ
بخشش	b a x ʃ i ʃ
بخصوص	b a x u s u s
بخور	b o x uː ɾ
بد	b a d
بدبخت	b a d b a x t
بدرود	b e d ɾ uː d
بدن	b a d a n
بر	b a ɾ
برابر	b a ɾ ɑː b a ɾ
برادر	b a ɾ ɑː d a ɾ
برازیدن	b a ɾ ɑː z iː d a n
برای	b a ɾ ɑː j i
برجسته	b a ɾ d͡ʒ a s t a
برخوردار	b a ɾ x o ɾ d ɑː ɾ
برخی	b a r x iː
بردار	b a ɾ d ɑː ɾ
برداشتن	b a ɾ d ɑː ʃ t a n
بردن	b o ɾ d a n
برزیستن	b a r z iː s t a n
برس	b o ɾ s
برف	b a ɾ f
برنامه	b a ɾ n ɑː m a
برنز	b o ɾ o n z
برهمن	b a ɾ a h m a n
برهنه	b a ɾ a h n a
برهنه‌گرا	b a ɾ a h n a ɡ a ɾ ɑː
برهنگی	b a ɾ a h n a ɡ iː
برپا	b a ɾ p ɑː
برگ	b a ɾ ɡ
برگزیدن	b a ɾ ɡ u z i d a n
برگشتن	b a ɾ ɡ a ʃ t a n
بری	b e ɾ e j
بریدن	b o ɾ iː d a n
بز	b o z
بزاق	b o z ɑː ɣ
بزرگ	b o z o ɾ ɡ
بزرگ‌امید	b o z o ɾ ɡ ʔ o m iː d
بستن	b a s t a n
بسته	b a s t a
بسد	b e s a d
بسنده	b a s a n d e
بسیار	b e s j ɑː ɾ
بشقاب	b o ʃ ɢ ɑː b
بشکه	b o ʃ k e
بعث	b a ʔ s
بعد	b a ʔ d
بعدا	b a ʔ d a n
بعضی	b a ʔ z e
بعل	b a ʔ l
بعید	b a ʔ i d
بغداد	b a ɣ d ɑː d
بفرمایید	b e f a ɾ m ɑː j iː d
بلا	b e l ɑː
بلافاصله	b e l ɑː f ɑː s e l e
بلال	b a l ɑː l
بلاگ	b l ɑː ɡ
بلبل	b o l b o l
بلد	b a l a d
بلعیدن	b a l ʔ iː d a n
بلور	b ɪ l oː ɾ
بلوط	b a l u t
بلگ	b a l ɡ
بلی	b a l e
بم	b ə m
بنابراین	b e n ɑː b a ɾ iː n
بندر	b a n d a ɾ
بنگ	b a ŋ ɡ
بنگاه	b o n ɡ ɑː h
بنیاد	b o n j ɑː d
بنیادگرا	b o n j ɑː d ɡ a ɾ ɑː
بنین	b e n iː n
به	b a
بهاءالله	b a h ɑː ʔ u l l ɑː h
بهار	b a h ɑː ɾ
بهاری	b a h ɑː ɾ iː
بهبود	b e h b uː d
بهتان	b o h t u n
بهتر	b e h t a ɾ
بهترین	b e h t a ɾ i n
بهشت	b e h e ʃ t
بهمان	b a h m ɑː n
بهمن	b a h m a n
به‌آفرید	b e h ɑː f a ɾ iː d
بو	b oː
بوالعجب	b o l ʔ a d͡ʒ a b
بوته	b oː t a
بودن	b u d a n
بوران	b uː ɾ ɑ n
بوزه	b oː z a
بوستان	b oː s t ɑː n
بوسه	b oː s a
بوسیدن	b oː s iː d a n
بوقلمون	b u q a l a m u n
بوم	b u m
بون	b uː n
بوی	b oː j
بوییدن	b uː j iː d a n
بچه	b a t t͡ʃ a
بچگی	b a t t͡ʃ a ɡ iː
بژ	b e ʒ
بکارت	b a k ɑː ɾ a t
بگران	b a ɡ ɾ ɑː n
بی	b e
بیابان	b i j ɑː b ɑː n
بیان	b a j ɑː n
بیجاده	b i d͡ʒ ɑː d i
بیخودی	b i x u d iː
بیدادی	b eː d ɑː d iː
بیدار	b e d ɑː ɾ
بیرق	b a j ɾ a q
بیرون	b e ɾ u n
بیرونی	b eː ɾ uː n iː
بیش	b e ʃ
بیشتر	b e ʃ t a ɾ
بیشه	b e ʃ a
بیضه	b a j z a
بیل	b e l
بیمار	b e m ɑː ɾ
بیمارتر	b iː m ɑː ɾ t a ɾ
بیمارترین	b iː m ɑː ɾ t a ɾ iː n
بیمارستان	b e m ɑː ɾ i s t ɑː n
بیمناک	b i n m ɑː k
بیمه	b i m a
بین	b a j n
بینی	b i n iː
بین‌المللی	b a j n a l m i l a l iː
بیور	b eː w a ɾ
بیچاره	b e t͡ʃ ɑː ɾ a
بیژن	b eː ʒ a n
بیکار	b e k ɑː ɾ
بیگانه	b e ɡ ɑː n a
بی‌ستاره	b e s i t ɑː ɾ a
بی‌سواد	b e s a v ɑː d
بی‌سیم	b e s i m
بی‌شمار	b e ʃ u m ɑː ɾ
بی‌صدا	b e s a d ɑː
بی‌صراط	b e s i ɾ ɑː t
بی‌طرف	b e t a ɾ a f
بی‌عرضه	b e u ɾ z a
بی‌معنی	b e m a ʔ n iː
بی‌مغز	b e m a ɣ z
بی‌میل	b e m a j l
بی‌نظیر	b e n a z i ɾ
بی‌هوش	b e h ɵː ʃ
بی‌وفا	b e v a f ɑː
بی‌وقفه	b e v a q f a
بی‌پروا	b e p a ɾ v ɑː
بی‌گناه	b e ɡ u n ɑː h
بەت	b aː t
تأکید	t a ʔ k i d
تا	t ɑː
تابستان	t ɑː b i s t ɑː n
تابع	t ɑː b i ʔ
تاج	t ɑː d͡ʒ
تاجور	t ɑː d ʒ v a ɾ
تاجگذاری	t ɑː d͡ʒ ɡ u z ɑː ɾ iː
تاجیک	t ɑː d͡ʒ i k
تاجیکستان	t ɑː d͡ʒ iː k i s t ɑː n
تار	t ɑː ɾ
تاریخ	t ɑː ɾ iː x
تاریخچه	t ɑː ɾ iː x t͡ʃ a
تاریک‌تر	t ɑː ɾ iː k t a ɾ
تاریک‌ترین	t ɑː ɾ iː k t a ɾ iː n
تازه	t ɑː z a
تازه‌تر	t ɑː z e t a ɾ
تازه‌ترین	t ɑː z e t a ɾ iː n
تازگی	t ɑː z a ɡ iː
تاکنون	t ɑː k u n uː n
تب	t a b
تباه	t a b ɑː h
تبدیل	t a b d i l
تبر	t a b a ɾ
تبریک	t a b ɾ i k
تجربه	t a d͡ʒ ɾ i b a
تجربی	t a d ʒ ɾ o b iː
تحت	t a h t i
تحصیل	t a h s i l
تحفه	t o h f e
تحقیق	t a h q i q
تحویل	t a h v i l
تخت	t a x t
تختخواب	t a x t i x ɑː b
تخته	t a x t a
تخریب	t a x ɾ i b
تخم	t o x m
تدریج	t a d ɾ i d͡ʒ
تدریس	t a d ɾ i s
تذرو	t a z a ɾ v
ترازو	t a ɾ ɑː z uː
ترجمه	t a ɾ d͡ʒ u m a
ترساندن	t a ɾ s ɑː n d a n
ترسایی	t a ɾ s ɑː j iː
ترسیدن	t a ɾ s i d a n
ترش	t o ɾ ʃ
ترشه	t o ɾ ʃ e
ترشک	t o ɾ ʃ a k
ترشی	t o ɾ ʃ iː
ترنج	t o ɾ o n d͡ʒ
ترک	t a ɾ k
ترکیدن	t a ɾ a kʲ iː d a n
ترگمان	t a ɾ ɡ u m ɑː n
تزیین	t a z j i n
تسخیر	t a s x i ɾ
تسو	t a s u
تشریح	t a ʃ ɾ e h
تشکر	t a ʃ a k k u ɾ
تشکیل	t a ʃ k i l
تشکیلات	t a ʃ k i l ɑː t
تصادف	t a s ɑː d u f
تصحیح	t a s h e h
تصمیم	t a s m i m
تصویب	t a s v i b
تصویر	t a s v i ɾ
تعارف	t a ʔ ɑː ɾ u f
تعجب	t a ʔ a d d͡ʒ u b
تعداد	t e ʔ d ɑː d
تعریف	t a ʔ ɾ i f
تعظیم	t a ʔ z i m
تعلق	t a ʔ a l l u q
تعلیم	t a ʔ l i m
تغییر	t a ɣ j i ɾ
تغییرات	t a ɣ j iː ɾ ɑː t
تفاوت	t a f ɑː w u t
تفریح	t a f ɾ e h
تفسیدن	t a f s i d a n
تفلیس	t e f l iː s
تفنگ	t o f a ŋ ɡ
تقدیر	t a q d i ɾ
تقریبا	t a ɣ ɾ iː b a n
تقریباً	t a q ɾ i b a n
تقسیم	t a q s i m
تقصیر	t a ɣ s iː ɾ
تقوا	t a q v ɑː
تقویت	t a q v i j a t
تقویم	t a q v i m
تلاش	t a l ɑː ʃ
تلخ	t a l x
تلف	t a l a f
تلویحی	t a l v iː h iː
تمام	t a m ɑː m
تمبر	t a m b ɾ
تمثیل	t a m s i l
تمر	t a m u ɾ
تمرین	t a m ɾ i n
تمساح	t e m s ɑː h
تمیز	t a m i z
تمیزتر	t a m iː z t a ɾ
تمیزترین	t a m iː z t a ɾ iː n
تنبان	t o m b ɑ n
تنبسه	t a n b a s a
تنبور	t a n b u ɾ
تندیس	t a n d iː s
تنها	t a n h ɑː
تنیدن	t a n iː d a n
تنیسور	t e n iː s o ɾ
تنیس‌باز	t e n iː s b ɑː z
ته	t a h
تهدید	t a h d i d
تهران	t a h ɾ ɑː n
تهرون	t e h ɾ uː n
تهیه	t a h i j j a
تو	t o
توجه	t a v a d d͡ʒ ɵː h
تودری	t u d a ɾ iː
تور	t o w a ɾ
توریستی	t u ɾ i s t
توزیع	tʰ o ʊ̯ z iː ʔ
توسط	t a v a s u t i
توسعه	t a v s i ʔ a
توسی	t uː s iː
توصیه	t a v s i j a
توضیح	t a v z e h
توقع	t a v a q q ɵː ʔ
تولد	t a v a l l u d
تولید	t a v l i d
توپ	t oː p
توپولوژی	t o p o l o ʒ iː
توپچى	t oː p t͡ʃ iː
تک	t a k
تکرار	t a k ɾ ɑː ɾ
تکفور	t a k f uː ɾ
تکواژ	t a k v â ʒ
تکور	t a k v o ɾ
تکوک	t a k oː k
تکیدن	t a k i d a n
تکیه	t a k j a
تیرداد	t i ɾ d ɑː d
تیز	t e z
تیزاب	t e z ɑː b
تیله	t e l a
تیمارستان	t i m ɑː ɾ i s t ɑː n
تیهو	t i h ɵː
ثابت	s ɑː b e tʰ
ثابت‌ها	s ɑː b e tʰ h ɑː
ثانیه	s ɑː n i j a
ثبت	s a b t
ثروت	s a ɾ v a t
ثروتمند	s a ɾ v a t m a n d
ثنویت	s a n a v i j j a t
جا	d͡ʒ ɑː j
جادو	d͡ʒ ɑː d uː
جاذبه	d͡ʒ ɑː z i b a
جاری	d͡ʒ ɑː ɾ i
جام	d͡ʒ ɑː m
جامعه	d͡ʒ ɑː m i ʔ a
جامعه‌شناس	d͡ʒ ɑː m i ʔ a ʃ i n ɑː s
جامعه‌شناسی	d͡ʒ ɑː m i ʔ a ʃ i n ɑː s iː
جامه‌دان	d͡ʒ ɑː m i d ɑː n
جان	d͡ʒ uː n
جانباز	d͡ʒ ɑː m b ɑː z
جانور	d͡ʒ ɑː n w a ɾ
جانورشناسی	d͡ʒ ɑː n w a ɾ ʃ i n ɑː s iː
جاهل	d͡ʒ ɑː h i l
جاوید	d͡ʒ ɑː w eː d
جایزه	d͡ʒ ɑː j i z a
جایگاه	d͡ʒ ɑː j ɡ ɑː h
جبار	d ʒ a b ɑː ɾ
جبر	d͡ʒ a b ɾ
جبران	d͡ʒ o b ɾ ɑː n
جبهه	d͡ʒ e b h e
جدا	d͡ʒ e d d a n
جدایی	d͡ʒ o d ɑː j iː
جدول	d͡ʒ a d v a l
جدید	d͡ʒ a d i d
جذاب	d͡ʒ a z z ɑː b
جرم	d͡ʒ e ɾ m
جریان	d͡ʒ a ɾ a j ɑː n
جزدان	d͡ʒ o z d ɑː n
جزیره	d͡ʒ a z i ɾ a
جزیه	d͡ʒ e z j e
جستجو	d͡ʒ o s t o d͡ʒ uː j
جستن	d͡ʒ a s t a n
جسور	d͡ʒ a s u ɾ
جشن	d͡ʒ a ʃ n
جعبه	d͡ʒ a ʔ b a
جعفر	d͡ʒ a ʔ f a r
جعفری	d͡ʒ a ʔ f a ɾ iː
جفت	d͡ʒ o f t
جلسه	d͡ʒ a l a s a
جلو	d͡ʒ e l o w
جلوگیری	d͡ʒ e l o w ɡ iː ɾ iː
جماعت	d͡ʒ a m ɑː ʔ a t
جمال	d͡ʒ a m ɑː l
جمشید	d͡ʒ a m ʃ e d
جمعاً	d͡ʒ a m ʔ a n
جمعه	d͡ʒ o m e
جمعیت	d͡ʒ a m ʔ i j j a t
جمله	d͡ʒ o m l e
جمهوری	d͡ʒ o m h uː ɾ iː
جنس	d͡ʒ e n s
جنسی	d͡ʒ e n s iː
جنوب	d͡ʒ a n u b
جنون	d ʒ o n uː n
جنگ	d͡ʒ a ŋ ɡ
جنگجو	d͡ʒ a n ɡ d͡ʒ u
جنگل	d ʒ a n ɡ a l
جهاد	d͡ʒ e h ɑː d
جهان	d͡ʒ a h ɑː n
جهانگیر	d͡ʒ a h ɑː n ɡ iː ɾ
جو	d͡ʒ a v
جواب	d͡ʒ a v ɑː b
جواب‌ها	d ʒ a v ɑː b h ɑː
جواری	d͡ʒ o v ɑː ɾ iː
جوان	d͡ʒ a v ɑː n
جوانی	d͡ʒ a v ɑː n iː
جودر	d͡ʒ a v d a ɾ
جور	d͡ʒ u ɾ
جوراب	d ʒ oː ɾ ɑː b
جوره	d͡ʒ oː ɾ a
جوهر	d͡ʒ a v h a ɾ
جوگی	d͡ʒ oː ɡ iː
جویبار	d͡ʒ oː j b ɑː ɾ
جویدن	d͡ʒ a v i d a n
جگر	d ʒ e ɡ a ɾ
جیب	d͡ʒ e b
حاجت	h ɑː d͡ʒ a t
حاد	h ɑː d
حادثه	h ɑː d i s a
حاشیه	h ɑː ʃ i j a
حاصل	h ɑː s i l
حافظ	h ɑː f e z
حالا	h ɑː l ɑː
حاکم	h ɑː k i m
حتما	h a t m a n
حتی	h a t t ɑː
حج	h a d d͡ʒ
حجاب	h e d͡ʒ ɑː b
حجره	h o d͡ʒ ɾ e
حدادی	h a dː ɑː d iː
حداکثر	h a d d i a k s a ɾ
حدس	h a d s
حدیث	h a d i s
حرب	h a ɾ b
حرص	h e ɾ s
حرف	h a ɾ f
حرفه	h e ɾ f e
حرکت	h a ɾ a k a t
حساب	h e s ɑː b
حسن	h a s a n
حسود	h a s u d
حسینقلی	h o s e j n ɢ o l iː
حشیش	h a ʃ i ʃ
حضور	h o z uː ɾ
حفاظت	h e f ɑː z a t
حق	h a q q
حقوق	h o q u q
حقیقت	h a q i q a t
حقیقی	h a q i q iː
حلال	h a l ɑː l
حلقه	h a l q a
حلوا	h a l v ɑː
حماس	h a m ɑː s
حمام	h a m m ɑː m
حمایت	h e m ɑː j a t
حمله	h a m l a
حکایت	h e k ɑː j a t
حکم	h o k m
حکومت	h o k uː m a t
حیات	h a j ɑː t
حیران	h a i ɾ ɑː n
حیوان	h a j v ɑː n
خات	x ɑː t
خاتم	x ɑː t a m
خاتمه	x ɑː t i m a
خاتون	x ɑː t uː n
خاده	x ɑː d a
خار	x ɑː ɾ
خارج	x ɑː ɾ i d͡ʒ
خارجه	x ɑː ɾ i d͡ʒ a
خارجی	x ɑː ɾ i d͡ʒ iː
خارگیل	x ɑː ɾ ɡ iː l
خاستن	x ɑː s t a n
خاص	x ɑː s
خاص‌تر	x ɑː s tʰ a ɾ
خاص‌ترین	x ɑː s tʰ a ɾ iː n
خاطب	x ɑː t i b
خاطر	x ɑː t i ɾ
خاطره	x ɑː t i ɾ a
خاقان	x ɑː q ɑː n
خال	x ɑː l
خالق	x ɑː l i q
خاله	x ɑː l a
خالو	x ɑː l uː
خالی	x ɑː l iː
خام	x ɑː m
خامه	x ɑː m a
خاموش	x ɑː m oː ʃ
خاموشی	x ɑː m oː ʃ iː
خان	x ɑː n
خاندان	x ɑː n d ɑː n
خانقاه	x ɑː n q ɑː h
خانه	x ɑː n a
خانواده	x ɑː n a w ɑː d a
خانوادگی	x ɑː n a w ɑː d a ɡ iː
خانگی	x ɑː n a ʔ ɡ iː
خاور	x ɑː w a ɾ
خاویار	x ɑː v i j ɑː ɾ
خاژغان	x ɑː ʒ ɣ ɑː n
خاک	x ɑː k
خاکروبه	x ɑː k ɾ oː b a
خاکستر	x ɑː k i s t a ɾ
خاکستری	x ɑː k i s t a ɾ iː
خایه	x â j a
خباره	x a b ɑː ɾ a
خباز	x a b b ɑː z
خبر	x a b a ɾ
خبره	x e b ɾ e
خبری	x a b a ɾ j a
ختم	x a t m
ختنه	x a tʰ n e
ختنه‌گاه	x a t n a ɡ ɑː h
ختو	x o t uː
خجالت	x e d͡ʒ ɑː l a t
خجالتی	x e d͡ʒ ɑː l a t iː
خدا	x o d ɑː
خداحافظ	x o d ɑː h ɑː f e z
خدای	x o d ɑː j
خدایی	x o d ɑː j iː
خدشه	x a d ʃ a
خدمت	x e d m a t
خدنگ	x a d a n ɡ
خدیو	x a d e v
خر	x a ɾ
خراب	x a ɾ ɑː b
خراسان	x o ɾ ɑː s ɑː n
خراسانی	x o ɾ ɑː s ɑː n iː
خرامیدن	x e ɾ ɑː m iː d a n
خربز	x a ɾ b u z
خربزه	x a ɾ b u z a
خربوزه	x a ɾ b u z a
خرد	x e ɾ a d
خرداد	x o ɾ d̪ ɑː d̪
خردل	x a ɾ d a l
خرس	x e ɾ s
خرم	x o ɾː a m
خرما	x o ɾ m ɑː
خروس	x o ɾ uː s
خروشیدن	x o ɾ uː ʃ iː d a n
خرگوش	x a ɾ ɡ oː ʃ
خرید	h a ɾ i d
خریدن	x a ɾ i d a n
خریطه	x a ɾ i t a
خز	x a z
خزاعی	x a z ɑː ʔ iː
خزان	x a z ɑː n
خزنده	x a z a n d e
خزندگان	x a z a n d e ɡ ɑː n
خزیدن	x a z i d a n
خزینه	x a z i n a
خسته	x a s t a
خسته‌خانه	x a s t a x ɑː n a
خستگی	x a s t i ɡ iː
خسران	x o s ɾ ɑː n
خسروانی	x o s ɾ a v ɑː n iː
خسیس	x a s i s
خشاب	x e ʃ ɑː b
خشم	x i ʃ m
خشمگین	x a ʃ m ɡ i n
خشونت	x o ʃ uː n a t
خشک	x o ʃ k
خشکاندن	x o ʃ k ɑː n d a n
خشکوندن	x o ʃ k uː n d a n
خصم	x a s m
خصوصا	x o s uː s a n
خصومت	x o s uː m a t
خط	x a t
خطا	x a t ɑː
خطر	x a t a ɾ
خطه	x a t t a
خف	x o f
خفگی	x a f i ɡ iː
خلاف	x e l ɑː f
خلوت	x a l v a t
خلیج	x a l i d͡ʒ
خلیفه	x a l i f a
خنجر	x a n d͡ʒ a ɾ
خندان	x a n d ɑ n
خنداندن	x a n d ɑː n d a n
خندق	x a n d a q
خنده	x a n d a
خندون	x a n d uː n
خندیدن	x a n d i d a n
خنیا	x o n i j ɑː
خو	x o
خواب	x ɑː b
خوابگاه	x ɑː b ɡ ɑː h
خوابیدن	x ɑː b iː d a n
خواجه	x ɑː d͡ʒ a
خوار	x ɑː ɾ
خوارزم	x ɑː ɾ a z m
خواستار	x ɑː s t̪ ɑː ɾ
خواستن	x ɑː s t a n
خوان	x ɑː n
خواندن	x ɑː n d a n
خوانش	x ɑː n e ʃ
خواننده	x ɑː n a n d a
خوانندگان	x ɑː n a n d e ɡ ɑː n
خواه	x ɑː h
خواهر	x ɑː h a ɾ
خواهش	x ɑː h e ʃ
خوب	x u b
خوبانی	x u b ɑː n iː
خود	x o d
خودرو	x o d ɾ o w
خودنویس	x o d n e v iː s
خودکار	x o d k ɑː ɾ
خودکشی	x o d k o ʃ iː
خور	x o ɾ
خوراندن	x o ɾ ɑː n d a n
خوراک	x o ɾ ɑː k
خوردن	x o ɾ d a n
خورشید	x o ɾ ʃ iː d
خوره	x o rː a h
خوش	x o ʃ
خوشاب	x u ʃ ɑː b
خوشبخت	x o ʃ b a x t
خوشبو	x o ʃ b uː j
خوشحال	x o ʃ h ɑː l
خوشنویس	x o ʃ n e v iː s
خوشنویسی	x o ʃ n e v iː s iː
خوشه	x oː ʃ a
خوشگل	x o ʃ ɡ e l
خوشگل‌تر	x o ʃ ɡ e l t a ɾ
خوشگل‌ترین	x o ʃ ɡ e l t a ɾ iː n
خوشی	x o ʃ iː
خوف	x a v f
خوفناک	x a v f n ɑː k
خون	x u n
خونریزی	x u n ɾ e z iː
خونه	x oː n a
خونین	x u n i n
خون‌شناسی	x u n ʃ i n ɑː s iː
خوک	x uː k
خویش	x e ʃ
خیابان	x i j ɑː b ɑː n
خیار	x i j ɑː ɾ
خیال	x a j ɑː l
خیر	x a j ɾ
خیریه	x a j ɾ i j j a
خیز	x e z
خیس	x iː s
خیلی	x a j l e
خیم	x iː m
خەر	x aː ɾ
داخل	d ɑː x i l i
داد	d ɑː d
دادار	d ɑː d ɑː r
دادن	d ɑː d a n
دادگاه	d ɑː d ɡ ɑː h
دارد	d ɑː ɾ a d
دارفلفل	d ɑː ɾ f i l f i l
دارم	d ɑː ɾ a m
دارو	d ɑː ɾ uː
داروساز	d ɑː ɾ uː s ɑː z
داروسازی	d ɑː ɾ uː s ɑː z iː
داروشناس	d ɑː ɾ uː ʃ i n ɑː s
داستان	d ɑː s t ɑː n
داشتن	d ɑː ʃ t a n
داغ	d ɑː ɣ
داماد	d uː m ɑː d
دانستن	d uː n e s t a n
دانش	d ɑː n i ʃ
دانشجو	d ɑː n i ʃ d͡ʒ uː j
دانشمند	d ɑː n i ʃ m a n d
دانشکده	d ɑː n i ʃ k a d a
دانشگاه	d ɑː n i ʃ ɡ ɑː h
داوود	d ɑː v uː d
دبیرستان	d a b i ɾ i s tʰ ɑː n
دجله	d e d͡ʒ l e
دختر	d o x d e ɾ
در	d a ɾ
درآمد	d a ɾ ɑː m a d
درآوردن	d a ɾ ɑː w a ɾ d a n
دراز	d a ɾ ɑː z
دراییدن	d a ɾ ɑː j iː d a n
دربار	d a ɾ b ɑː ɾ
درباره	d a ɾ b ɑː ɾ a j i
دربان	d a ɾ b ɑː n
درجه	d a ɾ a d͡ʒ a
درخت	d a ɾ a x t
درخواست	d a ɾ x ɑː s t
درد	d a ɾ d
دردمند	d a ɾ d m a n d
دردناک	d a ɾ d n ɑː k
درزی	d a ɾ z iː
درس	d a ɾ s
درست	d o ɾ o s
درشت	d o ɾ o ʃ t
درفش	d a ɾ a f ʃ
درمان	d a ɾ m ɑː n
درمانگاه	d a ɾ m ɑː n ɡ ɑː h
درمنه	d e ɾ m a n e
درنده	d a ɾ a n d a
درنگ	d e ɾ a n ɡ
درها	d a ɾ h ɑː
درود	d a ɾ oː d
درودن	d o ɾ uː d a n
دروغ	d o ɾ uː ɢ
دروغ‌ها	d o ɾ uː ɣ h ɑː
درویش	d a ɾ v e ʃ
درگاه	d a ɾ ɡ ɑː h
دری	d a ɾ iː
دریا	d a ɾ j ɑː
دریافت	d a ɾ j ɑː f t
دریدن	d a ɾ i d a n
دزد	d o z d
دس	d a s
دست	d a s t
دستار	d a s t ɑː ɾ
دستاویز	d a s t ɑː w eː z
دستمال	d a s t m ɑː l
دستور	d a s t u ɾ
دستکند	d a s t k a n d
دستگاه	d a s t ɡ ɑː h
دست‌نماز	d a s t n a m ɑː z
دشنام	d o ʃ n ɑː m
دشوار	d o ʃ v ɑː ɾ
دعا	d o ʔ ɑː
دعوت	d a ʔ v a t
دفاع	d e f ɑː ʔ
دفتر	d a f t a r
دفعه	d a f ʔ a
دقت	d e ɢ ɢ a t
دقیقه	d a q i q a
دل	d e l
دلال	d a l l ɑː l
دلاور	d e l ɑː v a ɾ
دلبستگی	d e l b a s t e ɡ iː
دلسوز	d̪ i l s oː z
دلفین	d o l f iː n
دلگیر	d e l ɡ iː ɾ
دلگیری	d e l ɡ iː ɾ iː
دلیل	d a l i l
دم	d a m
دما	d a m ɑː
دماسنج	d a m ɑː s a n d͡ʒ
دماغ	d a m ɑː ɣ
دمبک	d o m b a k
دنب	d o n b
دندان	d a n d ɑː n
دنیا	d o n j ɑː
دنیدن	d a n iː d a n
دنیوی	d o n j a v e
ده	d a h
دهان	d a h ɑː n
دهستان	d e h e s t ɑː n
دهقان	d e h q ɑː n
دهلی	d e h l iː
دهیار	d e h j ɑː ɾ
دو	d o
دوجنس‌گرا	d o d͡ʒ e n s ɡ a ɾ ɑː
دودل	d o d e l
دودمان	d u d m ɑː n
دور	d a v ɾ
دوران	d a w a ɾ ɑː n
دوره	d a v ɾ a
دوزخ	d oː z a x
دوست	d oː s t
دوش	d oː ʃ
دوغ	d oː ɣ
دول	d oː l
دولت	d a v l a t
دویدن	d a v i d a n
دپارتمان	d e p ɑ r tʰ e m ɑ n
دچار	d o t͡ʃ ɑː ɾ
دژ	d e ʒ
دگر	d e ɡ a ɾ
دگرجنس‌گرا	d e ɡ a ɾ d͡ʒ e n s ɡ a ɾ ɑː
دیدن	d i d a n
دیدگاه	d i d ɡ ɑː h
دیر	d a j ɾ
دیروز	d i ɾ ɵː z
دیس	d e s
دیسال	d i s ɑː l
دیسک	d iː s k
دیسک‌ها	d iː s k h ɑː
دیشب	d i ʃ a b
دیم	d e m
دین‌داری	d i n d ɑː ɾ iː
دیو	d e v
دیوان	d e v ɑː n
دیوانه	d e v ɑː n a
دیوشناسی	d e v ʃ i n ɑː s iː
دیگ	d e ɡ
دیگدان	d e ɡ d ɑː n
دیگر	d i ɡ a ɾ
ذات	z ɑː t
ذاتی	z ɑː t iː
ذبح	z e b h
ذرت	z o rː a t
ذره	z a r r a
ذهن	z e h n
ذکر	z a k a ɾ
رأی	ɾ a ʔ j
را	ɾ ɑː
رابط	ɾ ɑː b i t
رابطه	ɾ ɑː b i t a
راجستان	ɾ ɑː d͡ʒ a s t a n
راحت	ɾ ɑː h a t
رازی	ɾ ɑː z iː
راسته	ɾ ɑː s t a
راستگو	ɾ ɑː s t ɡ uː
رام	ɾ ɑː m
ران	ɾ ɑː n
راهب	ɾ ɑː h i b
رایانه	ɾ ɑː j ɑː n a
رایگان	ɾ ɑː j i ɡ ɑː n
رب	ɾ a bː
رباعی	ɾ o b ɑː ʔ iː
ربع	ɾ o b ʔ
رتیل	ɾ o t e j l
رحیم	r a h iː m
رخ	r o x
رخام	ɾ o x ɑː m
رخت	ɾ a x t
رختن	r e x t a n
رد	ɾ a d d
رده	ɾ a d a
رسانیدن	ɾ a s ɑː n iː d a n
رستم	ɾ o s t a m
رستن	ɾ o s t a n
رستوران	r e s t o ɾ ɑː n
رستوران‌ها	r e s t o ɾ ɑː n h ɑː
رسم	ɾ a s m
رسمی	ɾ a s m iː
رسیدن	ɾ a s i d a n
رشت	r o ʃ t
رشد	ɾ o ʃ d
رضا	ɾ e z ɑː
رعایت	ɾ e ʔ ɑː j a t
رعد	ɾ a ʔ d
رعنا	ɾ a ʔ n ɑː
رغبت	r a ɣ b a t
رفتار	ɾ a f t ɑː ɾ
رفدن	ɾ a f d a n
رقص	ɾ a q s
رم	ɾ a m
رمضان	ɾ a m a z ɑː n
رنده	ɾ a n d a
رندیدن	ɾ a n d i d a n
رنگ	ɾ a ŋ ɡ
رنگارنگ	ɾ a ŋ ɡ ɑː ɾ a ŋ ɡ
رنگین	ɾ a n ɡ i n
ره	r a h
رهبر	ɾ a h b a ɾ
رواج	r a v ɑː d͡ʒ
روادید	r a v ɑː d̪ iː d̪
رواق	ɾ e v ɑː ɢ
روان‌شناس	ɾ a v ɑː n ʃ i n ɑː s
روباه	ɾ oː b ɑː h
روح	ɾ uː h
روحانی	r o ʊ h ɑː n iː
رود	ɾ oː d
رودابه	ɾ uː d ɑː b e
رودخانه	ɾ oː d x ɑː n a
روز	ɾ oː z
روزنامه	ɾ oː z n ɑː m a
روزها	ɾ oː z h ɑː
روزگار	ɾ oː z i ɡ ɑː ɾ
روس	ɾ u s
روستا	ɾ oː s t ɑː
روسی	ɾ u s iː
روسیه	ɾ u s i j a
روش	ɾ a v i ʃ
روشن	ɾ a v ʃ a n
روشنگری	ɾ a v ʃ a n ɡ a ɾ iː
روشنی	ɾ a v ʃ a n iː
روغن	ɾ a v ɣ a n
رومی	ɾ oː m iː
روند	ɾ a v a n d
رونق	ɾ a v n a q
رژیمان	ɾ e ʒ i m ɑ n
رکورد	ɾ e k o w ɾ d
ریختن	ɾ e x t a n
ریدک	r e j d a k
ریز	ɾ e z
ریش	ɾ e ʃ
ریشه	ɾ e ʃ a
ریشه‌شناسی	ɾ e ʃ a ʃ i n ɑː s iː
ریگ	ɾ e ɡ
ریگستان	ɾ e ɡ i s t ɑː n
زئوس	z e uː s
زائر	z ɑː ʔ i ɾ
زاده	z ɑː d a
زافه	z â f a
زال	z ɑː l
زان	z ɑː n
زانو	z ɑː n uː
زاوش	z ɑː w u ʃ
زبان	z a b ɑː n
زبان‌ها	z a b ɑː n h ɑː
زحمت	z a h m a t
زدن	z a d a n
زر	z a ɾ
زراوند	z a ɾ ɑː w a n d
زرشک	z e ɾ e ʃ k
زرشکی	z e ɾ e ʃ k iː
زرناپا	z u r n ɑː p ɑː
زره	z e ɾ e h
زرین	z a ɾ ɾ i n
زشت	z e ʃ t
زشتی	z e ʃ t iː
زغال	z o ɢ ɑː l
زقاق	z o ɢ ɑː ɢ
زلیخا	z o l e j x ɑː
زمان	z a m ɑː n
زمستان	z e m e s t ɑː n
زمی	z m iː
زمین	z a m i n
زمین‌شناسی	z a m i n ʃ i n ɑː s iː
زنانه	z a n ɑː n a
زنانگی	z a n ɑː n a ɡ iː
زنبق	z a m b a q
زنبور	z a m b u ɾ
زنجبیل	z a n d͡ʒ a b iː l
زنخ	z a n a x
زندان	z e n d ɑː n
زندانی	z e n d ɑː n iː
زنده	z e n d e
زندگی	z e n d e ɡ iː
زهر	z a h ɾ
زهره	z o h ɾ e
زوال	z a v ɑː l
زوبین	z oː b iː n
زوج	z a v d͡ʒ
زوجیت	z a v d͡ʒ i j a t
زود	z u d
زور	z a v ɾ
زورخانه	z oː ɾ x ɑː n a
زورق	z o w ɾ a q
زورمند	z oː ɾ m a n d
زوش	z u ʃ
زوو	z v oː
زیاد	z i j ɑː d
زیبا	z e b ɑː
زیباتر	z iː b ɑː t a ɾ
زیباترین	z iː b ɑː t a ɾ iː n
زیبیدن	z e b i d a n
زیر	z e ɾ
زیرزمین	z iː ɾ z a m iː n
زیرسیگاری	z iː ɾ s iː ɡ ɑː ɾ iː
زیره	z iː ɾ e
زیرک	z i ɾ a k
زیستن	z i s t a n
زیست‌شناس	z iː s t ʃ e n ɑː s
زیست‌شناسی	z iː s t ʃ e n ɑː s iː
زین	z i n
زیویدن	z iː v iː d a n
زیگ	z iː ɡ
سؤال	s o ɑː l
سابق	s ɑː b i q
ساحل	s ɑː h i l
ساختار	s ɑː x t ɑː ɾ
ساختمان	s ɑː x t i m ɑː n
ساختن	s ɑː x t a n
ساده	s ɑː d a
ساده‌تر	s ɑː d e t a ɾ
ساده‌ترین	s ɑː d e t a ɾ iː n
سادگی	s ɑː d a ɡ iː
ساز	s ɑː z
سازش	s ɑː z i ʃ
سازمان	s ɑː z i m ɑː n
ساعت	s ɑː ʔ a t
سال	s ɑː l
سالار	s ɑː l ɑː ɾ
سالم	s ɑː l i m
سالن	s ɑː l o n
سالگرد	s ɑː l ɡ a ɾ d
سالگی	s ɑː l a ɡ iː
سامان	s ɑː m ɑː n
سامانه	s ɑː m ɑː n a
سامانه‌ها	s ɑː m ɑː n e h ɑː
ساکاستان	s ɑː k ɑː s t ɑː n
سایه	s ɑː j a
سبد	s a b a d
سبز	s a b z
سبزه	s e b z a
سبزی	s a b z iː
سبک	s a b k
ستاره	s e t ɑː ɾ e
ستاره‌شناس	s e t ɑː ɾ e ʃ e n ɑː s
ستان	e s t ɑː n
ستبر	s e tʰ a b ɾ
ستوان	s o t v ɑː n
ستور	s o t uː ɾ
ستون	s ʊ t uː n
سجستان	s a d͡ʒ a s t ɑː n
سحر	s a h a ɾ
سخت	s a x t
سختن	s o x t a n
سخن	s o x a n
سخنرانی	s o x a n ɾ ɑː n iː
سخنگو	s o x a n ɡ uː
سده	s a d a
سر	s a ɾ
سرانجام	s a ɾ a n d͡ʒ ɑː m
سرای	s a ɾ ɑː j
سرب	s o ɾ b
سرباز	s a ɾ b ɑː z
سرجوخه	s a ɾ d͡ʒ u x a
سرحد	s a ɾ h a d
سرخ	s o ɾ x
سرخوش	s a ɾ x u ʃ
سرد	s a ɾ d
سرداب	s a ɾ d ɑː b
سردار	s a ɾ d ɑː ɾ
سرطان	s a ɾ a t ɑː n
سرعت	s o ɾ ʔ a t
سرفراز	s a ɾ f a ɾ ɑː z
سرمایه	s a ɾ m ɑː j a
سرمه	s a ɾ m a
سرندیپ	s a r a n d iː p
سرنشین	s a ɾ n i ʃ i n
سرنوشت	s a ɾ n a v i ʃ t
سرهنگ	s a ɾ h a n ɡ
سرو	s a ɾ v
سرودن	s o ɾ uː d a n
سرور	s a ɾ v a ɾ
سرپرستی	s a ɾ p a ɾ a s t iː
سرپوش	s a ɾ p oː ʃ
سرچشمه	s a ɾ t͡ʃ a ʃ m a
سرکار	s a ɾ k ɑː ɾ
سرکه	s e ɾ k e
سرگرمی	s a ɾ ɡ a ɾ m iː
سرگیجه	s a ɾ ɡ i d͡ʒ a
سری	s a ɾ iː
سریانی	s o ɾ j ɑː n iː
سریدن	s o ɾ iː d a n
سرین	s o ɾ iː n
سطح	s a t h
سعادت	s a ʔ ɑː d a t
سعی	s a ʔ j
سعید	s a ʔ i d
سفارش	s e f ɑː ɾ e ʃ
سفارشی	s e f ɑː ɾ e ʃ iː
سفر	s a f a ɾ
سفره	s o f ɾ e
سفید	s a f e d
سفیر	s a f i ɾ
سفینه	s a f i n a
سقراط	s o ɢ ɾ ɑː t
سقرلات	s a q i ɾ l ɑː t
سقف	s a q f
سقوط	s o ɢ uː t
سلاح	s e l ɑː h
سلام	s a l ɑː m
سلجوق	s a l d͡ʒ u q
سلجوقی	s a l d͡ʒ u q iː
سلسله	s e l s e l e
سلماس	s a l m ɑː s
سلیمان	s o l e j m ɑː n
سلیمانی	s o l e j m ɑː n iː
سمت	s a m t
سمع	s a m ʔ
سمفونی	s a m f oː n iː
سمند	s a m a n d
سمور	s a m oː ɾ
سمیعی	s a m iː ʔ iː
سن	s e n
سنان	s e n ɑː n
سنبل	s o m b o l
سنبه	s o m b e
سنبوسه	s a m b oː s a
سنت‌ها	s o n a t h ɑː
سنجاب	s a n d͡ʒ ɑː b
سند	s e n d
سنگ	s a ŋ ɡ
سنگاپور	s a n ɡ ɑː pʰ uː ɾ
سنگسار	s a n ɡ s ɑː ɾ
سنگواره	s a n ɡ v ɑː ɾ a
سنگین	s a n ɡ i n
سه	s e
سهراب	s o h ɾ ɑː b
سهل	s a h l
سهم	s a h m
سهمگین	s a h m ɡ i n
سه‌بعدی	s e b o ʔ d iː
سه‌شنبه	s e ʃ a n b e
سوت	s oː t
سوخ	s oː x
سوختن	s oː x t a n
سوخته	s uː x t e
سوداگر	s a v d ɑː ɡ a ɾ
سورپرایز	s u r p e ɾ ɑ j z
سورپریز	s u r p i ɾ i z
سوریه	s uː ɾ i j e
سوز	s oː z
سوزش	s oː z i ʃ
سوزن	s u z a n
سوسمار	s uː s m ɑː r
سوسن	s oː s a n
سوغات	s a v ɣ ɑː t
سوگ	s oː ɡ
سوگند	s a v ɡ a n d
سوی	s oː j
سپاه	s e p ɑː h
سپاهی	s e p ɑː h iː
سپر	s e p a ɾ
سپندان	s e p a n d ɑː n
سپهسالار	s e p a h s ɑː l ɑː ɾ
سپوختن	s e p uː x t a n
سکه	s e kː e
سگ	s a ɡ
سگالیدن	s e ɡ ɑː l iː d a n
سیاح	s a j j ɑː h
سیاره‌ها	s a j ɑː ɾ e h ɑː
سیاست	s i j ɑː s a t
سیاسی	s i j ɑː s iː
سیاه	s i j ɑː h
سیاه‌گوش	s i j ɑː h ɡ oː ʃ
سیب	s e b
سیبویه	s i b u j a
سید	s a j j i d
سیر	s e ɾ
سیزده	s e n z d a h
سیستم	s iː s tʰ e m
سیل	s a j l
سیلاب	s a j l ɑː b
سیلابی	s a j l ɑː b eː
سیلاس	s iː l ɑː s
سیلو	s i l u
سیم	s e j o m
سیماب	s i m ɑː b
سیمرغ	s i m u ɾ ɣ
سینا	s iː n ɑː
سینه	s i n a
شات	ʃ ɑː t
شاخ	ʃ ɑ x
شاخه	ʃ ɑː x e
شاد	ʃ ɑː d
شاداب	ʃ ɑː d ɑː b
شادمان	ʃ ɑː d m ɑː n
شاذ	ʃ ɑː z
شاریدن	ʃ ɑː ɾ iː d a n
شاعر	ʃ ɑː ʔ i ɾ
شال	ʃ ɑː l
شام	ʃ ɑː m
شامل	ʃ ɑː m i l
شانزده	ʃ uː n z d a h
شانه	ʃ ɑː n a
شاه	ʃ ɑː h
شاهان	ʃ ɑː h ɑː n
شاهانشاه	ʃ ɑː h ɑː n ʃ ɑː h
شاهانه	ʃ ɑː h ɑː n a
شاهد	ʃ ɑː h i d
شاهدخت	ʃ ɑː h d u x t
شاهزاده	ʃ ɑː h z ɑː d a
شاهزادگان	ʃ ɑː h z ɑː d e ɡ ɑː n
شاهقلی	ʃ ɑː h q u l iː
شاهنامه	ʃ ɑː h n ɑː m a
شاهنشاه	ʃ ɑː h a n ʃ ɑː h
شاهکار	ʃ ɑː h k ɑː ɾ
شاهین	ʃ ɑː h iː n
شاه‌دانه	ʃ ɑː h d ɑː n a
شاپور	ʃ ɑː p uː ɾ
شاگرد	ʃ ɑː ɡ i ɾ d̪
شاید	ʃ ɑː j a d
شایعه	ʃ ɑː j i ʔ a
شب	ʃ a b
شبانه	ʃ a b ɑː n a
شباهت	ʃ a b ɑː h a t
شبح	ʃ a b a h
شبنم	ʃ a b n a m
شبیه	ʃ a b e h
شب‌بو	ʃ a b b oː
شب‌بوی	ʃ a b b oː j
شترخار	ʃ o t o ɾ x ɑː ɾ
شترغار	ʃ o t o ɾ ɢ ɑː ɾ
شترمرغ	ʃ o t o ɾ m o ɾ ɢ
شترگاوپلنگ	ʃ o t o ɾ ɡ ɑː v p a l a n ɡ
شجاع	ʃ o d͡ʒ ɑː ʔ
شجاعت	ʃ a d͡ʒ ɑ ʔ a t
شجر	ʃ a d ʒ a r
شخص	ʃ a x s
شخصیت	ʃ a x s i j a t
شد	ʃ o d
شدن	ʃ o d a n
شدنی	ʃ o d a n iː
شدید	ʃ a d i d
شراب	ʃ a ɾ ɑː b
شرط	ʃ a ɾ t
شروع	ʃ o r uː ʔ
شرک	ʃ e ɾ e k
شرکت	ʃ e ɾ k a t
شریک	ʃ a ɾ i k
شستن	ʃ o s t a n
شش	ʃ a ʃ
شطرنج‌باز	ʃ a t ɾ a n d͡ʒ b ɑː z
شعب	ʃ o ʔ a b
شعبه	ʃ o ʔ b e
شعر	ʃ e ʔ ɾ
شعله	ʃ o ʔ l e
شغال	ʃ o ɣ ɑː l
شغال‌ها	ʃ o ɣ ɑː l ɑː
شغل	ʃ o ɢ l
شفقت	ʃ a f a q a t
شلغم	ʃ a l ɣ a m
شلوار	ʃ a l v ɑː ɾ
شلوغ	ʃ o l uː ɣ
شلوغ‌تر	ʃ o l uː ɣ t a ɾ
شلوغ‌ترین	ʃ o l uː ɣ t a ɾ iː n
شما	ʃ o m ɑː
شماره	ʃ o m ɑː ɾ e
شماریدن	ʃ o m ɑː ɾ iː d a n
شمال	ʃ o m ɑː l
شمردن	ʃ e m o ɾ d a n
شمسی	ʃ a m s iː
شمع	ʃ a m ʔ
شمعدان	ʃ a m ʔ d ɑː n
شناختن	ʃ e n ɑː x t a n
شناسی	ʃ e n ɑː s iː
شنبلیله	ʃ a m b a l iː l e
شنبه	ʃ a n b a
شنفتن	ʃ e n o f t a n
شنگار	ʃ a n ɡ ɑː ɾ
شنیدن	ʃ e n iː d a n
شهادت	ʃ a h ɑː d̪ a t̪
شهد	ʃ a h d
شهر	ʃ a h ɾ
شهرت	ʃ o h ɾ a t
شهرزاد	ʃ a h ɾ z ɑː d
شهری	ʃ a h ɾ iː
شهریور	ʃ a h ɾ iː v a ɾ
شهلا	ʃ a h l ɑː
شهنشاه	ʃ a h a n ʃ ɑː h
شهوت	ʃ a h v a t
شهوتی	ʃ a h v a t iː
شهود	ʃ o h uː d
شو	ʃ o w
شوخی	ʃ oː x iː
شور	ʃ oː ɾ
شورا	ʃ o ʊ̯ ɾ ɑː
شوربا	ʃ oː ɾ b ɑː
شورش	ʃ u ɾ i ʃ
شوره	ʃ oː ɾ e
شوروی	ʃ uː ɾ a v iː
شوریدن	ʃ oː ɾ iː d a n
شوق	ʃ a v q
شوهر	ʃ a v h a ɾ
شوکران	ʃ a v k a ɾ ɑː n
شوید	ʃ e v iː d
شپش	ʃ e p e ʃ
شپش‌ها	ʃ e p e ʃ h ɑː
شک	ʃ ɑː k k
شکافتن	ʃ e k ɑː f t a n
شکال	ʃ e k ɑː l
شکایت	ʃ e k ɑː j a t
شکست	ʃ e k a s t
شکستن	ʃ e kʲ a s t̪ʰ a n
شکستنی	ʃ i k a s t̪ a n iː
شکسته	ʃ e k a s t e
شکسته‌نستعلیق	ʃ e k a s t e n a s t a ʔ l iː ɢ
شکلاتی	ʃ o kʰ o l ɑ tʰ i
شکم	ʃ e k a m
شکوفه	ʃ e k uː f e
شکیفتن	ʃ e k iː f t a n
شگرد	ʃ e ɡ e ɾ d
شگفت	ʃ e ɡ e f t
شیء	ʃ a j ʔ
شیدا	ʃ e j d ɑː
شیر	ʃ e ɾ
شیراز	ʃ e ɾ ɑː z
شیردال	ʃ e ɾ d ɑː l
شیرین	ʃ i ɾ i n
شیرین‌تر	ʃ iː ɾ iː n t a ɾ
شیرین‌ترین	ʃ iː ɾ iː n t a ɾ iː n
شیشه	ʃ i ʃ a
شیطان	ʃ a j t ɑː n
شیطانی	ʃ a j t ɑː n iː
شیمی	ʃ iː m iː
شینواری	ʃ iː n v ɑː ɾ iː
شیوا	ʃ eː w ɑː
شیک	ʃ iː k
صابون	s ɑː b uː n
صاحب	s ɑː h i b
صادق	s ɑː d i q
صاعقه	s ɑː ʔ i q a
صبحانه	s o b h ɑː n e
صبور	s a b u ɾ
صحبت	s o h b a t
صحرا	s a h ɾ ɑː
صحنه	s a h n e
صحیح	s a h e h
صدا	s a d ɑː
صدمه	s a d a m a
صرع	s a ɾ ʔ
صرف	s e ɾ f
صفت	s e f a t
صفحه	s a f h a
صفحه‌کلید	s a f h a k a l i d
صلح	s u l h
صمیمی	s a m i m iː
صندلی	s a n d a l iː
صندوق	s a n d u q
صنعت	s a n ʔ a t
صنعتی	s a n ʔ a t iː
صنف	s a n f
صنم	s a n a m
صنوبر	s a n a v b a ɾ
صهیون	s a h j u n
صهیونی	s a h j u n iː
صهیونیسم	s a h j u n i s m
صوت	s a v t
صورت	s u ɾ a t
صورتى	s u ɾ a t iː
صورتی	s uː ɾ a tʰ iː
صیغه	s iː ɣ a
ضخیم	z a x iː m
ضد	z e d
ضربان	z a ɾ a b ɑː n
ضربه	z a ɾ b a
ضعف	z a ʔ f
ضعیف	z a ʔ i f
ضلع	z e l ʔ
ضمیر	z a m i ɾ
طاس	t ɑː s
طاقت	t ɑː q a t
طاووس	t ɑː w uː s
طب	t e bː
طبق	t a b a q
طبقه	t a b a q a
طراح	t a ɾ ɑː h
طرح	t a ɾ h
طرف	t a ɾ a f
طرفدار	t a ɾ a f d ɑː ɾ
طعم	t a ʔ m
طلا	t e l ɑː
طلاق	t a l ɑː q
طلایی	t a l ɑː j iː
طمطراق	t o m t o ɾ ɑː ɢ
طور	t a v ɾ
طوفان	t u f ɑː n
طول	t u l
طیاره	t a j j ɑː ɾ a
ظاهر	z ɑː h i ɾ
ظرف	z a ɾ f
ظرفی	z a ɾ f iː
ظهر	z o h ɾ
ظهور	z o h uː ɾ
عادت	ʔ ɑː d a t
عادل	ɑː d i l
عادی	ʔ ɑː d iː
عاشق	ɑː ʃ i q
عاصی	ʔ ɑː s iː
عالم	ɑː l a m
عالی	ɑː l iː
عام‌المنفعه	ʔ ɑː m o l m a n f a ʔ e
عباء	a b ɑː
عباسی	ʔ a b b ɑː s iː
عثمان	o s m ɑː n
عجان	ʔ e d ʒ ɑː n
عجب	ʔ a d͡ʒ a b
عجیب‌تر	a d ʒ iː b t a ɾ
عجیب‌ترین	a d ʒ iː b t a ɾ iː n
عدد	ʔ a d a d
عدس	ʔ a d a s
عراقچی	a ɾ ɑː q t͡ʃ iː
عربستان	a ɾ a b i s t ɑː n
عربی	ʔ a ɾ a b iː
عرض	a ɾ a z
عرفان	ʔ e ɾ f ɑː n
عروس	ʔ a ɾ u s
عسل	a s a l
عشق	e ʃ ɢ
عشق‌آباد	e ʃ ɢ ɑː b ɑː d
عصبانی	a s a b ɑː n iː
عصر	ʔ a s ɾ
عصمت	e s m a t
عضو	o z v
عضوها	o z v h ɑ
عطر	ʔ e t ɾ
عفت	ʔ e f f a t
عفو	ʔ a f v
عقرب	ʔ a ɣ ɾ a b
عقل	a q l
علاءالدین	a l ɑː ʔ u d d ī n
علاقه	a l ɑː q a
علاوه	a l ɑː w a
علت	e l l a t
علف	ʔ a l a f
علم	a l a m
علمی	e l m iː
عمر	o m a ɾ
عمق	o m ɢ
عمو	a m u
عموما	o m uː m a n
عمیق	a m iː q
عنابی	a n ɑː b iː
عنایت	ʔ e n ɑː j a t
عنصر	o n s o ɾ
عنوان	o n v ɑː n
عوض	i w a z
عکس	a k s
عیب	a j b
غار	ɢ ɑː ɾ
غارت	ɢ ɑː ɾ a t
غاز	ɢ ɑː z
غافت	ɢ ɑː f e t
غافث	ɢ ɑː f e s
غالب	ɢ ɑː l e b
غایب	ɢ ɑː j e b
غذا	ɢ e z ɑː
غرق	ɣ a ɾ ɣ
غره	ɢ a ɾ ɾ e
غریب	ɢ a ɾ iː b
غزال	ɢ a z ɑː l
غسل	ɢ o s l
غصه	ɢ o s s e
غلام	ɢ o l ɑː m
غلامی	ɢ o l ɑː m iː
غلط	ɢ a l a t
غم	ɢ a m
غمناک	ɢ a m n ɑː k
غمگین	ɢ a m ɡ iː n
غمگینی	ɢ a m ɡ iː n iː
غنی	ɢ a n iː
غور	ɢ o w ɾ
غژب	ɢ o ʒ b
غیر	ɢ e j ɾ
غیرت	ɢ e j ɾ a t
غیور	ɣ a j u ɾ
ـی	e
ـیسم	i s m
فائده	f ɑː ʔ e d e
فاحش	f ɑː h e ʃ
فاخره	f ɑː x i ɾ a
فارسی	f ɑː ɾ s iː
فارغ	f ɑː ɾ i ɣ
فاس	f ɑː s
فاصله	f ɑː s i l a
فاعل	f ɑː ʔ i l
فامیل	f ɑː m iː l
فانوس	f ɑː n uː s
فانی	f ɑː n iː
فاک	f ɑː k
فایده	f ɑː j i d a
فحش	f o h ʃ
فر	f o ɾ
فرآیند	f a ɾ ɑː j a n d
فرارود	f a ɾ ɑː ɾ uː d
فرازمینی	f a ɾ ɑː z a m iː n iː
فراصوت	f a ɾ ɑː s a w t
فراموش	f a ɾ ɑː m oː ʃ
فراموشی	f a ɾ ɑː m oː ʃ iː
فراموشیدن	f a ɾ ɑː m uː ʃ iː d̪ a n
فرانسه	f a ɾ ɑː n s a
فرانسوی	f a ɾ ɑː n s a w iː
فرانک	f a ɾ ɑː n a k
فرج	f a ɾ d͡ʒ
فرد	f a ɾ d
فردا	f a ɾ d ɑː
فردوس	f e ɾ d o w s
فرزندخوانده	f a ɾ z a n d x ɑː n d a
فرستادن	f e ɾ e s t ɑː d a n
فرشته	f a ɾ i ʃ t a
فرق	f a ɾ q
فرمان	f a ɾ m ɑː n
فرمانده	f a ɾ m ɑː n d i h
فرمایش	f a ɾ m ɑː j i ʃ
فرمودن	f a ɾ m u d a n
فرهنگ	f a ɾ h a n ɡ
فروختن	f o ɾ uː x t a n
فرودگاه	f o ɾ uː d ɡ ɑː h
فروردین	f a ɾ v a ɾ d̪ iː n
فروش	f o ɾ uː ʃ
فروغ	f o ɾ uː ɢ
فروهر	f o ɾ uː h a ɾ
فریب	f a ɾ e b
فریبا	f a ɾ e b ɑː
فریدون	f e ɾ e i̯ d uː n
فریفتن	f a ɾ e f t a n
فسیل	f o s iː l
فشار	f e ʃ ɑː ɾ
فشردن	f e ʃ o ɾ d a n
فشنگ	f e ʃ a n ɡ
فصح	f e s h
فصل	f a s l
فصیح	f a s e h
فضا	f a z ɑː
فضازمان	f a z ɑː z a m ɑː n
فضاپیما	f a z ɑː p a j m ɑː
فضایی	f a z ɑː j iː
فعال	f a ʔ ɑː l
فعالیت	f a ʔ ɑː l i j j a t
فعل	f e ʔ l
فعلا	f e ʔ l a n
فغفور	f a ɣ f uː ɾ
فقر	f a q ɾ
فقرا	f o ɢ a ɾ ɑː
فقط	f a q a t
فقیر	f a q i ɾ
فلاخن	f a l ɑː x a n
فن	f a n
فنجان	f e n d͡ʒ uː n
فهرست	f e h ɾ e s t
فهم	f a h m
فهماندن	f a h m ɑː n d a n
فهمیدن	f a h m i d a n
فوت	f a v t
فوج	f a v d͡ʒ
فوق‌العاده	f a w q o l ʔ ɑ d a
فولاد	f oː l ɑː d
فک	f a k
فکاهی	f o k ɑː h iː
فکر	f e k
فیروزه	f i ɾ u z a
فیض	f a j z
فیلیپ	f i l i p
قابل	q ɑː b i l
قاتل	q ɑː t i l
قاره	q ɑː ɾ a
قاسم	ɢ ɑː s e m
قاشق	q ɑː ʃ u q
قاصدک	q ɑː s i d a k
قاضی	q ɑː z iː
قاطر	q ɑː t i ɾ
قاعده	q ɑː ʔ i d a
قاقم	ɢ ɑː ɢ o m
قالب	q ɑː l i b
قاموس	q ɑː m uː s
قانون	q ɑː n uː n
قانونی	q ɑː n uː n iː
قاچاق	q ɑː t͡ʃ ɑː q
قاچاقچی	q ɑː t͡ʃ ɑː q t͡ʃ iː
قایق	ɢ ɑː j e ɣ
قبر	q a b ɾ
قبرستان	q a b ɾ i s t ɑː n
قبض	ɢ a b z
قبلا	q a b l a n
قبول	q a b u l
قبیح	q a b e h
قدر	q a d a ɾ
قدرت	q u d ɾ a t
قدرتمند	q u d ɾ a t m a n d
قدمت	q i d m a t
قدومه	q u d u m a
قدیمی	q a d i m iː
قرآن	q u ɾ ʔ ɑː n
قرار	q a ɾ ɑː ɾ
قربک	q o ɾ b a k
قرعه‌کشی	q u ɾ ʔ a k a ʃ iː
قرغیزستان	q ɪ ɾ ɣ iː z ɪ s t ɑː n
قرمز	q i ɾ m i z
قرمزی	q i ɾ m i z iː
قرن	q a ɾ n
قرنفل	q a ɾ a n f u l
قزاق	q a z z ɑː q
قزوین	q a z v i n
قسطنطنیه	q u s t a n t a n i j a
قسم	q a s a m
قسمت	q i s m a t
قشنگ	ɢ e ʃ a ŋ ɡ
قشنگی	q a ʃ a n ɡ iː
قصد	q a s d
قصه	q i s s a
قطار	q a t ɑː ɾ
قطر	q a t a ɾ
قطره	q a t ɾ a
قطع	q a t ʔ
قفس	q a f a s
قفسه	ɢ a f a s e
قفل	q u f l
ققنس	q u q n u s
ققنوس	q u q n u s
قلاوز	q u l ɑː w u z
قلاووز	q u l ɑː w uː z
قلب	q a l b
قلبی	q a l b iː
قلع	q a l ʔ
قلعه	q a l ʔ a
قلم	q a l a m
قلمدان	q a l a m d ɑː n
قلیان	q a l j ɑː n
قمر	q a m a ɾ
قند	q a n d
قندهار	q a n d a h ɑː ɾ
قندوز	q o n d uː z
قهرمان	q a h ɾ a m ɑː n
قهوه	q a h v a
قهوه‌ای	q a h v a ʔ iː
قهوه‌خانه	q a h v a x ɑː n a
قو	q u
قوت	q u v v a t
قول	q a v l
قوم	q a v m
قونیه	q u n i j a
قوی	q a v iː
قید	ɢ e j d
قیصر	q a j s a ɾ
قیمت	q a j m a t
قیمتی	q a j m a t iː
قیمه	q a j m a
قیچی	q a j t͡ʃ iː
كنج	k o n d͡ʒ
لابد	l ɑː b u d
لات	l ɑː t
لازم	l ɑː z i m
لاعلاج	l ɑː ʔ i l ɑː d͡ʒ
لاغر	l ɑː ɣ a ɾ
لاف	l ɑː f
لاله	l ɑː l e
لایه	l ɑː j e
لب	l a b
لبخند	l a b x a n d
لبی	l a b iː
لثه	l a s e
لجن	l a d͡ʒ a n
لحظه	l a h z a
لزوماً	l o z uː m a n
لسان	l e s ɑː n
لشکر	l a ʃ k a ɾ
لعل	l a ʔ l
لغت	l o ɢ a t
لقب	l a q a b
لله	l a l a
لندن	l a n d a n
لنگر	l a n ɡ a ɾ
لنگرگاه	l a n ɡ a ɾ ɡ ɑː h
لهجه	l a h d͡ʒ a
لهذا	l e h ɑː z ɑː
لهستان	l a h i s t ɑː n
لو	l o w
لوبیا	l oː b i i̯ ɑː
لوترا	l u t a ɾ ɑː
لوخن	l oː x a n
لوز	l a v z
لوله	l uː l e
لک	l a k
لی	l iː
لیمو	l i m u
لیو	l e v
لیوان	l iː v ɑː n
لیک	l iː k
مؤثر	m o ʔ a s s e ɾ
مؤدب	m o ʔ a d d e b
مؤسسه	m o ʔ a s s a s e
مؤمن	m o ʔ m e n
ما	m ɑː
ماجرا	m ɑː d͡ʒ a ɾ ɑː
مادر	m ɑː d a ɾ
مادرانه	m ɑː d a ɾ ɑː n a
مادربزرگ	m ɑː d a ɾ b u z u ɾ ɡ
مادیان	m ɑː d i i̯ ɑː n
مار	m ɑː ɾ
مارس	m ɑː ɾ s
مارمولک	m ɑː ɾ m uː l a k
ماز	m ɑː z
مازریون	m ɑː z a ɾ j oː n
مازندرانی	m ɑː z a n d a ɾ ɑː n iː
مازو	m ɑː z uː
مازوج	m ɑː z uː d͡ʒ
ماساژ	m ɑː s ɑː ʒ
ماست	m ɑː s t
ماشین	m ɑː ʃ iː n
ماله	m ɑː l a
مالک	m ɑː l i k
مالی	m ɑː l iː
مالیات	m ɑː l iː j ɑː t
مامانی	m ɑː m ɑː n iː
ماموت	m ɑː m uː t
ماندن	m ɑː n d a n
مانند	m ɑː n a n d i
ماه	m ɑː h
ماهر	m ɑː h i ɾ
ماهواره	m ɑː h w ɑː ɾ a
ماهور	m ɑː h uː ɾ
ماهی	m ɑː h iː
ماوراءالنهر	m ɑː w a ɾ ɑː ʔ u n n a h ɾ
ماک	m ɑː k
مایه	m ɑː j a
مبارزه	m o b ɑː ɾ a z e
مبهم	m o b h a m
متحد	m o t t a h e d
متخصص	m o t a x a sː e s
متخلف	m o t a x a l l e f
مترجم	m o t a ɾ d͡ʒ e m
متضاد	m o t a z ɑː d
متعلق	m o t a ʔ a l l e ɢ
متفاوت	m o t a f ɑː v e t
متن	m a t n
متوجه	m o t a v a d d͡ʒ e h
متوسط	m o t a v a s s e t
مثال	m e s ɑː l
مثل	m a s a l
مثلا	m a s a l a n
مجازات	m o d ʒ ɑː z ɑː t
مجازات‌ها	m o d ʒ ɑː z ɑː t h ɑː
مجبور	m a d͡ʒ b u ɾ
مجرد	m o d͡ʒ a ɾ ɾ a d
مجروح	m a d͡ʒ ɾ uː h
مجسمه	m o d͡ʒ a s s a m e
مجلس	m a d͡ʒ l i s
مجموعه	m a d͡ʒ m u ʔ a
مجید	m a d͡ʒ iː d
محافظه‌کار	m o h ɑː f e z e k ɑː ɾ
محبت	m a h a b b a t
محبوب	m a h b u b
محسن	m o h s e n
محقق	m o h a ɣ ɣ e ɣ
محل	m a h a l l
محلی	m a h a l l iː
محمد	m o h a m m a d
محمدقلی	m o h a m m a d ɢ o l iː
محنت	m e h n a t
محکمه	m a h k a m a
محیط	m o h iː t
مخاطب	m o x ɑː t a b
مخالف	m o x ɑː l e f
مختار	m o x t ɑː ɾ
مختل	m o x t a l
مختلط	m o x t a l e t
مختلف	m o x t a l e f
مخرج	m a x ɾ a d͡ʒ
مخصوص	m a x s u s
مخمل	m a x m a l
مد	m o d
مدت	m o d d a t
مدرسه	m a d ɾ a s a
مدرنیزه	m o d e ɾ n iː z e
مدهوش	m a d h u ʃ
مدیر	m o d iː ɾ
مذهبی	m a z h a b iː
مراسم	m a ɾ ɑː s i m
مراقب	m o ɾ ɑː ɢ e b
مراکش	m a ɾ ɑː k i ʃ
مربا	m o r a b b ɑ
مربوط	m a ɾ b u t
مرتب	m o ɾ a t t a b
مرتبه	m a ɾ t a b a
مرجان	m a ɾ d͡ʒ ɑː n
مرحله	m a ɾ h a l a
مرخ	m a ɾ x
مرد	m a ɾ d
مرداد	m o ɾ d̪ ɑː d̪
مردان	m a ɾ d ɑː n
مردانه	m a ɾ d ɑː n a
مردانگی	m a ɾ d ɑː n a ɡ iː
مردم	m a ɾ d u m
مردم‌سالاری	m a ɾ d u m s ɑː l ɑː ɾ iː
مردم‌شناس	m a ɾ d u m ʃ i n ɑː s
مردن	m o ɾ d a n
مردها	m a ɾ d h ɑː
مرز	m a ɾ z
مرشدقلی	m o ɾ ʃ e d ɢ o l iː
مرغ	m o ɾ ɢ
مرغاب	m o ɾ ɢ ɑː b
مرغان	m o ɾ ɣ ɑː n
مرغ‌ها	m o ɾ ɣ h ɑː
مرمر	m a ɾ m a ɾ
مرمی	m a r m iː
مرند	m a ɾ a n d
مرو	m a ɾ v
مروارید	m o ɾ v ɑː ɾ iː d
مروزی	m a ɾ v e z iː
مرچ	m o ɾ t ʃ
مرکب	m o ɾ a k k a b
مرکزی	m a ɾ k a z iː
مرگ	m a ɾ ɡ
مریض	m a ɾ i z
مریضی	m a ɾ iː z iː
مزنه	m o z n e
مزه	m a z z a
مس	m e s
مسئول	m a s ʔ u l
مسافت	m a s ɑː f a t
مسافر	m o s ɑː f e ɾ
مسافرت	m o s ɑː f e ɾ a t
مساوی	m o s ɑː v iː
مستعمره	m o s t a ʔ m a ɾ e
مستقیم	m o s t a ɢ iː m
مسجد	m a s d͡ʒ i d
مسجدها	m a s d ʒ e d h ɑː
مسخره	m a s x a ɾ a
مسعود	m a s ʔ uː d
مسلحانه	m o s a l l a h ɑː n e
مسلمان	m o s a l m ɑː n
مسلمون	m o s a l m uː n
مسکه	m a s k a
مسیح	m a s e h
مسیحی	m a s i h iː
مشابه	m o ʃ ɑː b e
مشارکت	m o ʃ ɑː ɾ e k a t
مشاهده	m o ʃ ɑː h a d e
مشاور	m o ʃ ɑː v e ɾ
مشتق	m o ʃ t a ɢ
مشرقی	m a ʃ ɾ i q iː
مشرک	m o ʃ ɾ e k
مشعل	m a ʃ ʔ a l
مشغول	m a ʃ ɣ u l
مشق	m a ʃ ɢ
مشهور	m a ʃ h u ɾ
مشکل	m u ʃ k i l
مشکل‌تر	m o ʃ k e l t a ɾ
مشکل‌ترین	m o ʃ k e l t a ɾ iː n
مشکل‌ها	m o ʃ k e l h ɑː
مشکی	m e ʃ kʰ iː
مصدر	m a s d a ɾ
مصر	m e s ɾ
مصنوعی	m a s n u ʔ iː
مصون	m a s uː n
مضحک	m o z h e k
مطبوعات	m a t b u ʔ ɑː t
مطلب	m a t l a b
مظهر	m a z h a ɾ
معادل	m o ʔ ɑː d e l
معالجه	m o ʔ ɑː l e d͡ʒ e
معاون	m o ʔ ɑː v e n
معبد	m a ʔ b a d
معتدل	m o ʔ t a d e l
معجزه	m o ʔ d͡ʒ e z e
معدنی	m a ʔ d a n iː
معده	m e ʔ d a
معراج	m e ʔ ɾ ɑː d͡ʒ
معروف	m a ʔ ɾ u f
معشوق	m a ʔ ʃ u q
معلم	m o ʔ a l l e m
معلوم	m a ʔ l u m
معمار	m e ʔ m ɑː ɾ
معماری	m e ʔ m ɑː ɾ iː
معمول	m a ʔ m u l
معمولا	m a ʔ m u l a n
معنوی	m a ʔ n a v iː
معنی	m a ʔ n iː
مغ	m a ɣ
مغازه	m a ɣ ɑː z a
مغرب	m a ɣ ɾ i b
مغرور	m a ɣ ɾ uː ɾ
مغز	m a ɣ z
مفتی	m o f t iː
مفرط	m o f ɾ e t
مفعول	m a f ʔ u l
مقاله	m a q ɑː l a
مقاومت	m o ɢ ɑː v e m a t
مقداد	m e ɣ d ɑː d
مقدار	m e ɢ d ɑː ɾ
مقدس	m o ɢ a d d a s
مقدماتی	m o ɢ a d d a m ɑː t iː
مقصد	m a q s a d
مقطع	m a q t a ʔ
مقعد	m a q ʔ a d
مقعدی	m a q ʔ a d iː
ملا	m o lː ɑː
ملاقات	m o l ɑː ɢ ɑː t
ملت	m e l l a t
مله	m a l a
ملکه	m a l i k a
ملی	m e l l iː
ملیت	m e l l i j a t
مملکت	m a m l a k a t
ممنوع	m a m n uː ʔ
ممنون	m a m n u n
ممکن	m o m k e n
من	m a n
منابع	m a n ɑː b i ʔ
منازل	m a n ɑː z i l
مناسب	m o n ɑː s e b
مناسبت	m o n ɑː s e b a t
منبع	m a n b a ʔ
منتظر	m o n t a z e ɾ
منتقد	m o n t a ɢ e d
مند	m a n d
منزل	m a n z i l
منشار	m e n ʃ ɑː ɾ
منشی	m u n ʃ iː
منطقه	m i n t a q a
منظور	m a n z u ɾ
منظومه	m a n z u m a
منع	m a n ʔ
منفور	m a n f u ɾ
منفی	m a n f iː
منوچهر	m a n u t͡ʃ e h ɾ
منگنه	m a ŋ ɡ a n a
منیژه	m a n iː ʒ a
مه	m a h
مهاجر	m o h ɑː d͡ʒ e ɾ
مهارت	m a h ɑː ɾ a t
مهبل	m a h b a l
مهر	m a h ɾ
مهربان	m e h ɾ a b ɑː n
مهربانی	m e h ɾ a b ɑː n iː
مهرداد	m e h ɾ d ɑː d
مهره	m o h ɾ e
مهم	m o h e m m
مهمان	m e h m ɑː n
مهندسی	m o h a n d e s iː
مو	m o
مواظب	m o v ɑː z e b
موافق	m o v ɑː f e ɣ
موتر	m oː t a ɾ
موج	m a v d͡ʒ
موجود	m a v d͡ʒ u d
موحش	m u h i ʃ
مورچه	m oː ɾ t͡ʃ a
موز	m a v z
موزه	m oː z a
موسم	m a v s i m
موسیقی	m u s i q iː
موسیقی‌شناسی	m u s i q i ʃ i n ɑː s iː
موضوع	m a v z ɵː ʔ
موفق	m o v a fː a ɢ
موفقیت	m o v a f f a ɢ iː j a t
موقع	m a v q e ʔ
موقعیت	m a v q i ʔ i j a t
مولانا	m o w l ɑː n ɑː
موم	m uː m
مومیا	m oː m i j ɑː
مومیایی	m oː m i j ɑː j iː
موی	m uː j
مژده	m o ʒ d e
مژه	m e ʒ e
مک	m a k
مکانیک	m e k ɑː n iː k
مکتب	m a k t a b
می	m a j
میان	m i j ɑː n
میانجیگری	m i j ɑː n d͡ʒ i ɡ a ɾ iː
میخانه	m a j x ɑː n a
میخی	m iː x iː
میدان	m a j d ɑː n
میرزا	m e ɾ z ɑː
میرزاخانی	m i ɾ z ɑː x ɑː n iː
میرنده	m i ɾ a n d a
میز	m e z
میزان	m i z ɑ n
میشین	m e ʃ i n
میغ	m eː ɣ
میلاد	m e l ɑː d
میلادی	m iː l ɑː d iː
مین	m iː n
مینو	m i n ɵː
میهن	m e h a n
میهن‌پرست	m i h a n p a ɾ a s t
میوه	m e v a
می‌خواهم	m iː x ɑː h a m
می‌دوم	m i d a v a m
می‌گم	m iː ɡ a m
نااهل	n ɑː ʔ a h l
ناتمام	n ɑː t a m ɑː m
ناتوان	n ɑː t a w ɑː n
ناخدا	n ɑː x u d̪ ɑː
ناخن	n ɑː x u n
ناخواسته	n ɑː xʷ ɑː s t a
نادان	n ɑː d ɑː n
نار	n ɑː ɾ
ناراحت	n ɑː ɾ ɑː h a t
نارسنگ	n ɑː ɾ s a n ɡ
نارنج	n ɑː ɾ a n d͡ʒ
نارنجک	n ɑː ɾ a n d͡ʒ a k
نارنجی	n ɑː ɾ a n d͡ʒ iː
نارون	n ɑː ɾ w a n
نارگیله	n ɑː ɾ ɡ iː l a
ناز	n ɑː z
نازک	n ɑː z u k
نازی	n ɑː z iː
ناشنوا	n ɑː ʃ i n a w ɑː
ناف	n ɑː f
نافرمان	n ɑː f a ɾ m ɑː n
ناقص	n ɑː q i s
نالان	n ɑː l ɑː n
نالون	n ɑː l uː n
نام	n ɑː m
نامه	n ɑː m a
نامور	n ɑː m w a ɾ
نامیدن	n ɑː m iː d a n
نان	n ɑː n
نانوائی	n ɑː n w ɑː j eː
نانوشته	n ɑː n i w i ʃ t a
ناهید	n ɑː h iː d
ناو	n ɑː w
ناوخدا	n ɑː v x o d ɑː
ناپاز	n ɑː p ɑː z
ناپدید	n ɑː p a d iː d
ناپسند	n ɑː p a s a n d
ناچار	n ɑː t͡ʃ ɑː ɾ
ناژو	n ɑː ʒ uː
ناک	n ɑː k
نبض	n a b z
نتیجه	n a t i d͡ʒ a
نجس	n a d ʒ e s
نجس‌تر	n a d ʒ a s t a ɾ
نجس‌ترین	n a d ʒ a s t a ɾ iː n
نجومی	n o d͡ʒ uː m iː
نحو	n a h v
نخیر	n a x a j ɾ
ندا	n e d ɑː
ندارد	n a d ɑː ɾ a d
نده	a n d a
نذل	n a z l
نر	n a ɾ
نریمان	n a ɾ eː m ɑː n
نزد	n a z d
نزدیک	n a z d i k
نزدیک‌تر	n a z d iː k t a ɾ
نزدیک‌ترین	n a z d iː k t a ɾ iː n
نستعلیق	n a s t a ʔ l i q
نسخه	n o s x e
نسرین	n a s ɾ iː n
نسک	n a s k
نسیم	n a s i m
نشاط	n e ʃ ɑː t
نشان	n e ʃ ɑː n
نشاندن	n e ʃ ɑː n d a n
نشدنی	n a ʃ o d a n i
نشستن	n e ʃ a s t a n
نشلیدن	n e ʃ e l iː d a n
نشور	n o ʃ uː ɾ
نصف	n e s f
نصیحت	n a s i h a t
نظام	n e z ɑː m
نظر	n a z a ɾ
نعناع	n a ʔ n ɑː ʔ
نعوظ	n o ʔ uː z
نغز	n a ɣ z
نغمه	n a ɣ m a
نفت	n a f t
نفر	n a f a ɾ
نفرت	n a f ɾ a t
نفرین	n e f ɾ iː n
نقاب	n e ɢ ɑː b
نقاش	n a q q ɑː ʃ
نقاشی	n a q q ɑː ʃ iː
نقد	n a q d
نقره	n o ɢ ɾ e
نقشه	n a q ʃ a
نقطه	n o ɢ t e
نماز	n a m ɑː z
نمایان	n e m ɑː j ɑː n
نمایش	n a m ɑː j i ʃ
نماینده	n a m ɑː j a n d e
نمایندگان	n a m ɑː j a n d e ɡ ɑː n
نمایه	n a m ɑː j e
نمودار	n e m u d ɑː ɾ
نمودن	n a m u d a n
نمونه	n a m u n a
نمک	n e m e k
نمکدان	n a m a k d ɑː n
نمکین	n a m a k i n
ننه	n a n e
نه	n o h
نهادن	n i h ɑː d a n
نهادی	n a h ɑː d iː
نهج	n a h a d͡ʒ
نهر	n a h ɾ
نهفتن	n a h o f t a n
نهور	n o h uː ɾ
نو	n a v
نواختر	n a v a x t a ɾ
نواختن	n a v ɑː x t a n
نور	n u ɾ
نورانی	n u ɾ ɑː n iː
نوروز	n a v ɾ ɵː z
نوروزی	n a v ɾ ɵː z iː
نوزده	n u z d a h
نوشتن	n a v i ʃ t a n
نوشیدن	n oː ʃ iː d a n
نوشیدنی	n u ʃ i d a n iː
نوع	n a v ʔ
نوم	n oː m
نومد	n o w m a d
نوک	n v a k
نوکر	n a w k a r
نویسه‌گردانی	n e v iː s e ɡ a ɾ d ɑː n iː
نوین	n a v i n
نژادها	n e ʒ ɑː d h ɑː
نژادپرست	n e ʒ ɑː d p a ɾ a s t
نژادی	n e ʒ ɑː d iː
نکاح	n e k ɑː h
نکونام	n e k uː n ɑː m
نگار	n e ɡ ɑː ɾ
نگهداری	n e ɡ a h d ɑː ɾ iː
نیاز	n i j ɑː z
نیازها	n iː j ɑː z h ɑː
نیایش	n i j ɑː j i ʃ
نیرو	n e ɾ ɵː
نیرومند	n iː ɾ uː m a n d̪
نیروگاه	n i ɾ u ɡ ɑː h
نیز	n e z
نیزه	n e i̯ z e
نیست	n e s t
نیفه	n e f a
نیم	n i m
نیمروز	n e m ɾ ɵː z
نیو	n e v
نیوشا	n i j oː ʃ ɑː
نیک	n e k
هامون	h ɑː m uː n
هجده	h a d͡ʒ d a h
هجران	h i d͡ʒ ɾ ɑː n
هخامنش	h a x ɑː m a n i ʃ
هدیه	h a d i j a
هر	h a ɾ
هرات	h a ɾ ɑː t
هرتز	h e ɾ t z
هرزگی	h a ɾ z a ɡ iː
هرمز	h o ɾ m o z
هرچه	h a ɾ t͡ʃ i
هرکس	h a r k a s
هرگز	h a ɾ ɡ i z
هزار	h a z ɑː ɾ
هزینه	h a z e n a
هشت	h a ʃ t
هشتن	h e ʃ t a n
هفت	h a f t
هفته	a f t a
هفته‌ها	h a f t e h ɑː
هفده	h a b d a h
هل	h e l
هلو	h o l uː
هم	h a m
همبازی	h a m b ɑː z iː
همجنس‌گراهراس	h a m d͡ʒ i n s ɡ a ɾ ɑː h a ɾ ɑː s
همدم	h a m d a m
همراه	h a m ɾ ɑː h
همساده	h o m s ɑː d e
همسایه	h a m s ɑː j a
همسده	h a m s e d a
همنوع‌خواری	h a m n a v ʔ x ɑː ɾ iː
همه	h a m e
همچنان	h a m t ʃ e n ɑː n
همچنین	h a m t͡ʃ a n i n
همیشه	h a m e ʃ a
هم‌جنس‌گرا	h a m d͡ʒ i n s ɡ a ɾ ɑː
هند	h e n d
هندو	h e n d uː
هندوانه	h e n d e v ɑː n e
هندوستان	h e n d uː s t ɑː n
هندی	h e n d iː
هنر	h o n a ɾ
هنرپیشه	h o n a ɾ p iː ʃ e
هنوز	h a n oː z
هنگ	h a n ɡ
هنی	h a n iː
هواپیما	h a v ɑː p a j m ɑː
هوتن	h uː t a n
هوش	h oː ʃ
هوشیار	h oː ʃ j ɑː ɾ
هول	h a v l
هی	h e j
هیئت	h a j ʔ a t
هیزم	h e z u m
هیس	sː
هیچ	h e t͡ʃ
هیچ‌وقت	eː t͡ʃ w a q t
هیچ‌کدام	h e t͡ʃ k u d ɑː m
واج	v ɑː d͡ʒ
وارث	v ɑː ɾ e s
وارد	v ɑː ɾ e d
واش	v ɑ ʃ
واقعا	v ɑː ɣ e ʔ a n
والا	v a e l l ɑː
والله	v a l l ɑː h
وام	v ɑː m
واژه	v ɑː ʒ e
واژه‌نامه	v ɑː ʒ e n ɑː m e
واژه‌ها	v ɑː ʒ e h ɑː
واژگان	v ɑː ʒ e ɡ ɑː n
واکسن	v ɑ k s a n
وای	v ɑː j
وج	v a d͡ʒ
وجود	v o d͡ʒ uː d
وجودی	v o d͡ʒ uː d iː
وحشی	v a h ʃ iː
وحی	v a h j
ورد	v a ɾ d
ورز	v a ɾ z
وروجک	v o ɾ uː d͡ʒ a kʲ
وزارت	v a z ɑː ɾ a t
وزغ	v a z a ɣ
وزن	v a z n
وزیدن	v a z iː d a n
وسط	v a s a t
وسیع	v a s e ʔ
وشم	v a ʃ m
وصل	v a s l
وضع	v a z ʔ
وضعیت	v a z ʔ i j j a t
وضوح	v o z uː h
وطن	v a t a n
وطن‌پرست	v a t a n p a ɾ a s t
وظیفه	v a z i f a
وعده	v a ʔ d a
وفات	v a f ɑː t
وقت	v a q t
وقتی	v a q t e
ول	v e l
ولایت	v e l ɑː j a t
ونوس	v e n uː s
وهم	v a h m
وکالت	v e k ɑː l a t
وکیل	v a k i l
ویدیو	v iː d iː j o
ویر	v i ɾ
ویرانه	v e ɾ ɑː n a
ویرایش	v i ɾ ɑː j i ʃ
ویس	v i s
ویستا	v i s t ɑ
ویه	uː j e
ویژه	v e ʒ a
ویژگی	v i ʒ a ɡ iː
ویژگی‌ها	v iː ʒ e ɡ iː h ɑː
پا	p ɑː
پاداش	pʰ ɑː d̪ ɑː ʃ
پادشاه	p ɑː d i ʃ ɑː h
پارسال	p ɑː ɾ s ɑː l
پارسه	p ɑː ɾ s e
پاره	p ɑː ɾ a
پاریس	pʰ ɑː ɾ iː s
پاستا	p ɑː s t ɑː
پاسخ	p ɑː s u x
پاشنه	p ɑː ʃ n a
پاشیدن	p ɑː ʃ iː d a n
پالایش	p ɑː l ɑː j i ʃ
پالایشگاه	p ɑː l ɑː j i ʃ ɡ ɑː h
پانزده	p uː n z d a h
پاپ	p ɑː p
پاپوش	p ɑː p oː ʃ
پاک	p ɑː k
پاکستان	p ɑː k i s t ɑː n
پاکستانی	p ɑː k i s t ɑː n iː
پایتخت	p ɑː j t a x t
پایه	p ɑː j a
پایگاه	p ɑː j i ɡ ɑː h
پاییز	p ɑː iː z
پتک	p o t k
پختن	p o x t a n
پدافند	p a d ɑː f a n d
پدر	p e d e ɾ
پدرام	p a d ɾ ɑː m
پدیدار	p a d i d ɑː ɾ
پذیرفتن	p a z i ɾ u f t a n
پر	p o ɾ
پرانتز	p a ɾ ɑː n t i z
پراندن	p a ɾ ɑː n d a n
پراکندگی	p a ɾ ɑː k a n d a ɡ iː
پرتو	p a ɾ t a v
پرتوقع	p o ɾ t a v a ɢ ɢ o ʔ
پرتگاه	p a ɾ t ɡ ɑː h
پرداختن	p a ɾ d ɑː x t a n
پردیس	p a ɾ d e s
پررونق	p o ɾ ɾ o w n a ɢ
پرس	p o ɾ s
پرستار	p a ɾ a s t ɑː ɾ
پرسش	p o ɾ s e ʃ
پرسمان	p o r s e m ɑː n
پرسیدن	p o ɾ s iː d a n
پرشور	p o ɾ ʃ uː ɾ
پرطرفدار	p o ɾ t a ɾ a f d ɑː ɾ
پرنده	p a ɾ a n d a
پرندوش	p a ɾ a n d oː ʃ
پرندگان	p a ɾ a n d a ɡ ɑː n
پرنگ	p e ɾ e n ɡ
پرهیز	p a ɾ h e z
پرواز	p a ɾ v ɑː z
پرورش	p a ɾ v a ɾ i ʃ
پروسه	p e ɾ o s e
پروژه	p e ɾ o ʒ e
پروگرام	p e ɾ o ɡ e ɾ ɑː m
پرویز	p a ɾ v iː z
پرچم	p a ɾ t͡ʃ a m
پرکار	p o ɾ k ɑː ɾ
پرگار	p a ɾ ɡ ɑː ɾ
پری	p a ɾ iː
پریدن	p a ɾ i d a n
پریستان	p a ɾ i j i s t ɑː n
پریشان	p a ɾ e ʃ ɑː n
پزشک	p e z e ʃ k
پس	p a s
پستان	p e s t ɑː n
پسر	p a s a ɾ
پسوند	p a s v a n d
پسی	p o s eː
پش	p a ʃ
پشت	p o ʃ t e
پشتون	p a ʃ t uː n
پشمین	p a ʃ m iː n
پشه	p a ʃ e
پشیمان	p a ʃ iː m ɑː n
پل	p o l
پلاستیک	p e l ɑː s t iː k
پلان	p e l ɑː n
پلاک	p e l ɑː k
پلخته	p a l a x t a
پله	pʰ e l l e
پناهنده	p a n ɑː h a n d e
پناهندگان	p a n ɑː h a n d e ɡ ɑː n
پناهگاه	p a n ɑː h ɡ ɑː h
پنبه	p a m b e
پنج	p a n d͡ʒ
پنجره	p a n d͡ʒ a ɾ a
پنجشیر	p a n d͡ʒ ʃ e ɾ
پنجه	p a n d͡ʒ a
پنهان	p e n h uː n
پنگان	p e n ɡ ɑː n
پنیر	p a n i ɾ
پهلوان	p a h l a v ɑː n
پودنه	p u d i n a
پوده	p uː d a
پودینه	p u d i n a
پور	p u ɾ
پوزخند	p uː z x a n d
پوست	p oː s t
پوست‌شناسی	p oː s t ʃ i n ɑː s iː
پوشاک	p oː ʃ ɑː k
پوشیدن	p oː ʃ iː d a n
پول	p u l
پولدار	p u l d ɑː ɾ
پوهنتون	p oː h a n t uː n
پوپک	p oː p a k
پوییدن	p u j i d a n
پژوهش	p a ʒ u h i ʃ
پی	p e j
پیاده	p i j ɑː d a
پیادگان	p iː j ɑː d e ɡ ɑː n
پیاله	p i j ɑː l a
پیامبر	p a j ɑː m b a ɾ
پیامک	p a j ɑː m a k
پیر	p i j a ɾ
پیرتر	p iː ɾ t a ɾ
پیرترین	p iː ɾ t a ɾ iː n
پیروز	p i ɾ ɵː z
پیروزی	p e ɾ ɵː z iː
پیسه	p a j s a
پیش	p e ʃ
پیشانی	p e ʃ ɑː n iː
پیشتاز	p e ʃ t ɑː z
پیشمرگه	p e ʃ m a ɾ ɡ e
پیشنهاد	p e ʃ n i h ɑː d
پیشه	p e ʃ a
پیشوا	p e ʃ v ɑ
پیشوند	p e ʃ v a n d
پیشگیر	p e ʃ ɡ i ɾ
پیغامبر	p a j ɣ ɑː m b a ɾ
پیمودن	p a j m u d a n
پیوسیدن	p a j oː s iː d a n
پیچ	p e t͡ʃ
پیچیدن	p e t͡ʃ i d a
پیکار	p a j k ɑː ɾ
پیکر	p a j k a ɾ
چا	t ʃʰ ɑː
چاشت	t ʃʰ ɑː ʃ tʰ
چاشنی	t ʃʰ ɑː ʃ n iː
چاق	t͡ʃ ɑː q
چاقو	t͡ʃ ɑː q uː
چامه	t͡ʃ ɑː m a
چامه‌سرایی	t͡ʃ ɑː m a s a ɾ ɑː j iː
چاه‌کور	t͡ʃ ɑː h k a w ɾ
چاپگر	t͡ʃ ɑː p ɡ a ɾ
چای	t͡ʃ ɑː j
چایخانه	t͡ʃ ɑː j x ɑː n a
چایدان	t͡ʃ ɑː j d ɑː n
چتر	t͡ʃ a t ɾ
چرا	t ʃ a ɾ ɑː
چراغ	t͡ʃ a ɾ ɑː ɣ
چربی	t͡ʃ a ɾ b iː
چرخ	t͡ʃ a ɾ x
چرخه	t͡ʃ a ɾ x a
چرخیدن	t ʃ e ɾ x i d̪ a n
چرمه	t͡ʃ a ɾ m a
چرک	t ʃ e ɾ k
چریک	t͡ʃ a ɾ i k
چشم	t͡ʃ a ʃ m
چشمان	t ʃʰ e ʃ m ɑː
چشمه	t͡ʃ a ʃ m a
چطور	t͡ʃ e t o w ɾ
چغندر	t͡ʃ o ɢ o n d a ɾ
چقدر	t͡ʃ e ɢ a d a ɾ
چل	t ʃʰ e l
چلنگر	t͡ʃ e l e n ɡ a ɾ
چله	t ʃʰ e l e
چلوکباب	t͡ʃ e l o w k a b ɑː b
چم	t͡ʃ a m
چمدان	t͡ʃ a m i d ɑː n
چمن	t͡ʃ a m a n
چمیدن	t͡ʃ a m i d a n
چنان	t ʃ o n ɑː n
چنانکه	t͡ʃ o n ɑː n k e
چنبره	t͡ʃ a m b a ɾ a
چند	t͡ʃ a n d
چندان	t͡ʃ a n d ɑː n
چندین	t͡ʃ a n d i n
چنگال	t͡ʃ a n ɡ ɑː l
چنین	t ʃ o n iː n
چه	t͡ʃ a
چهار	t͡ʃ a h ɑː ɾ
چهارده	t͡ʃ a h ɑː ɾ d a h
چهارشنبه	t͡ʃ a h ɑː ɾ ʃ a n b a
چهره	t͡ʃ e h ɾ a
چهل	t͡ʃ e h e l
چو	t ʃ o w
چوب	t͡ʃ oː b
چون	t͡ʃ oː n
چوپ	t͡ʃ oː p
چوپان	t͡ʃ u p ɑː n
چوکی	t ʃ a w k iː
چپ	t ʃ a p
چکش	t͡ʃ a k u ʃ
چکمه	t͡ʃ a k m a
چکیدن	t͡ʃ a k i d a n
چگونه	t͡ʃ e ɡ uː n e
چی	t͡ʃ e
چیدن	t͡ʃ i d a n
چیزی	t͡ʃ i z e
چیست	t͡ʃ i s t
چیش	t ʃ i ʃ
چین	t͡ʃ i n
چینی	t͡ʃ i n iː
ژاله	ʒ ɑː l a
ژامبون	ʒ ɑː m b o n
ژاندرم	ʒ ɑː n d a r m
ژاپن	ʒ ɑː p u n
ژاپنی	ʒ ɑː p u n iː
ژاژ	ʒ ɑː ʒ
ژرف	ʒ a ɾ f
ژرفا	ʒ a ɾ f ɑː
ژرفی	ʒ a ɾ f iː
ژرف‌تر	ʒ a ɾ f t a ɾ
ژرف‌ترین	ʒ a ɾ f t a ɾ iː n
ژغار	ʒ a ɣ ɑː ɾ
ژم	ʒ a m
ژنو	ʒ e n e v
ژولیدن	ʒ uː l iː d a n
ژوپیتر	ʒ u p i t e ɾ
ژوژ	ʒ oː ʒ
ژکفر	ʒ a k f a ɾ
ژکفری	ʒ a k f a ɾ iː
ژیرش	ʒ i ɾ i ʃ
کابل	k ɑː b u l
کابلی	k ɑː b u l iː
کاخ	k ɑː x
کادو	k ɑː d u
کار	k ɑː ɾ
کارخانه	k ɑː ɾ x ɑː n a
کارزار	k ɑː ɾ z ɑː ɾ
کارمند	k ɑː ɾ m a n d
کاروان	k ɑː ɾ w ɑː n
کارواژه‌ها	k ɑː r v ɑː ʒ e h ɑː
کارواژگان	k ɑː r v ɑː ʒ e ɡ ɑː n
کارورزی	k ɑː ɾ v a ɾ z iː
کارگاه	k ɑː ɾ ɡ ɑː h
کاریز	k ɑː ɾ eː z
کاسب	k ɑː s i b
کاسه	k ɑː s e
کاغد	k ɑː ɣ a d
کاغذ	k ɑː ɣ a ð
کاغذها	k ɑː ɣ a z h ɑː
کافر	k ɑː f e r
کافی	k ɑː f iː
کالب	k ɑː l e b
کالبد	k ɑː l b u d
کالیفرنیا	k ɑː l iː f o r n i j ɑː
کاهش	k ɑː h i ʃ
کاکوتی	k ɑː k uː t iː
کباب	k a b ɑː b
کبریت	kʰ e b ɾ iː t
کبوتر	k a b oː t a ɾ
کبود	k a b oː d
کتاب	k e t ɑː b
کتب	k o t o b
کتی	k a t iː
کثیف	k a s i f
کجا	k o d͡ʒ ɑː
کر	k a ɾ
کرامت	k a ɾ ɑː m a t
کرایه	k i ɾ ɑː j a
کردار	k e ɾ d ɑː ɾ
کردن	k a d a n
کردی	k o ɾ d iː
کرس	k e ɾ s
کرشن	k ɾ i ʃ n
کرفس	k a ɾ a f s
کره	k a ɾ a
کریمه	k e ɾ iː m e
کس	k a s
کسشعر	k o s e ʃ e ɾ
کسی	k a s e
کشتار	k o ʃ t ɑː ɾ
کشتن	k e ʃ t a n
کشتگی	k o ʃ t a ɡ iː
کشتی‌گیر	k o ʃ t iː ɡ iː ɾ
کشکول	k a ʃ k uː l
کشیدن	k a ʃ i d a n
کشیش	k a ʃ i ʃ
کفاش	k a f f ɑ ʃ
کفتر	k e f t a ɾ
کفش	k a f ʃ
کفن	k a f a n
کفگیر	k a f ɡ i ɾ
کلاس	k e l ɑː s
کلاغ	k a l ɑː ɣ
کلان	k a l ɑː n
کلفخشنگ	k a l a f a x ʃ a n ɡ
کلمه	k a l a m a
کلنگ	k o l o ŋ ɡ
کله	k a l l a
کلپ	k l a p
کلید	k a l i d
کلیچه	k o l iː t͡ʃ e
کم	k a m
کماشیر	k a m ɑː ʃ eː ɾ
کمان	k a m ɑː n
کمانچه	k a m ɑː n t͡ʃ a
کمتر	k a m t a ɾ
کمزور	k a m z oː ɾ
کمند	k a m a n d
کمو	k a m uː
کمک	k o m a k
کم‌مایه	k a m m ɑː j a
کم‌کم	k a m k a m
کن	k e n
کنار	k a n ɑː ɾ
کنجکاو	k o n d͡ʒ k ɑː v
کندن	k a n d a n
کنده	k a n d a
کنسرت	k o n s e ɾ t
کنشت	k e n e ʃ t
کنشگر	k o n e ʃ ɡ a ɾ
کنعان	k a n ʔ ɑː n
کنفرانس	k o n f e ɾ ɑː n s
کنونی	k o n uː n iː
کنکور	k o ŋ k uː r
کنگره	k o n ɡ r e
کنیسه	k a n i s a
که	k e
کهر	k a h a ɾ
کهف	k a h f
کهنه	k o h n e
کهکشان	k a h k a ʃ ɑː n
کهکشان‌ها	k a h k a ʃ ɑː n h ɑː
کو	k oː
کوتاه	k oː t ɑː h
کوتاهی	k u t ɑː h iː
کوتاه‌تر	k uː t ɑː h t a ɾ
کوتاه‌ترین	k uː t ɑː h t a ɾ iː n
کود	k oː d
کودکان	k uː d a k ɑː n
کودکی	k oː d a k iː
کوره	k oː ɾ a
کوزه	k u z a
کوشش	k oː ʃ i ʃ
کوشک	k oː ʃ k
کوفته	k oː f t a
کون	kʰ u n
کونی	k u n iː
کوه	k oː h
کوهستان	k oː h i s t ɑː n
کوچه	k oː t͡ʃ a
کوچک‌تر	k uː t ʃ e k t a ɾ
کوچک‌ترین	k uː t ʃ e k t a ɾ iː n
کوکب	k a v k a b
کویت	k o v e j t
کی	k a j
کیر	k e ɾ
کیمیا	k iː m i j ɑː
کین	k iː n
کینه	k iː n e
کیهان	k a j h ɑː n
کیهانی	k a j h ɑː n iː
کیچه	kʰ iː t͡ʃʰ e
گا	ɡ ɑː
گائیدن	ɡ ɑː j iː d a n
گاب	ɡ ɑː b
گاراژ	ɡ ɑː ɾ ɑː ʒ
گاری	ɡ ɑː ɾ iː
گاز	ɡ ɑː z
گاش	ɡ ɑː ʃ
گام	ɡ ɑː m
گان	ɡ ɑː n
گاه	ɡ ɑː h
گاهی	ɡ ɑː h iː
گاه‌شماری	ɡ ɑː h ʃ u m ɑː ɾ iː
گاو	ɡ o ʊ
گاومیش	ɡ ɑː w m eː ʃ
گجرات	ɡ o d͡ʒ a ɾ ɑː t
گدازه	ɡ o d ɑː z e
گذاشتن	ɡ o z ɑː ʃ t a n
گذراندن	ɡ o z a ɾ ɑː n d a n
گذشتن	ɡ o z a ʃ t a n
گذشته	ɡ o z a ʃ t e
گرا	ɡ a ɾ ɑː
گراز	ɡ o ɾ ɑː z
گران	ɡ a ɾ ɑː n
گربسن	ɡ e r b e s a n
گربه	ɡ o ɾ b e
گرختن	ɡ o ɾ eː x t a n
گردن	ɡ a ɾ d a n
گردنبند	ɡ a ɾ d a n b a n d
گردون	ɡ a ɾ d u n
گردیدن	ɡ a ɾ d i d a n
گرزمان	ɡ a ɾ a z m ɑː n
گرزه	ɡ o ɾ z e
گرسنه	ɡ o ɾ o s n e
گرسنگی	ɡ o ɾ o s n e ɡ iː
گرفت	ɡ e ɾ e f t
گرفتن	ɡ e ɾ e f t a n
گرم	ɡ a ɾ m
گرمابه	ɡ a ɾ m ɑː b a
گره	ɡ e r e h
گروه	ɡ o ɾ uː h
گرچه	ɡ a ɾ t͡ʃ a
گرگ	ɡ o ɾ ɡ
گریختن	ɡ o ɾ iː x t a n
گریستن	ɡ e ɾ iː s t a n
گریه	ɡ e ɾ j e
گز	ɡ a z
گزاردن	ɡ o z ɑː ɾ d a n
گزارش	ɡ o z ɑː ɾ e ʃ
گزاف	ɡ a z ɑː f
گزاف‌تر	ɡ a z ɑː f t a ɾ
گزاف‌ترین	ɡ a z ɑː f t a ɾ iː n
گزیدن	ɡ a z i d a n
گزینش	ɡ o z iː n e ʃ
گستاخ	ɡ o s t ɑː x
گستردن	ɡ o s t a ɾ d a n
گسترده	ɡ o s t a ɾ d e
گسستن	ɡ o s a s t a n
گشاد	ɡ o ʃ ɑː d
گشادن	ɡ o ʃ ɑː d a n
گشادی	ɡ o ʃ ɑː d iː
گشتن	ɡ a ʃ t a n
گشنیز	ɡ e ʃ n iː z
گشودن	ɡ o ʃ uː d a n
گفتار	ɡ o f t ɑː ɾ
گفتن	ɡ o f t a n
گفتگو	ɡ o f t o ɡ uː j
گل	ɡ e l
گلاب	ɡ o l ɑː b
گلابی	ɡ o l ɑː b iː
گلدان	ɡ o l d ɑː n
گلستان	ɡ o l e s t ɑː n
گلف	ɡ o l f
گلو	ɡ a l oː
گلپر	ɡ o l p a ɾ
گلچه	ɡ o l t͡ʃ e
گلی	ɡ o l iː
گم	ɡ o m
گماشتن	ɡ o m ɑː ʃ t a n
گمست	ɡ a m a s t
گناه	ɡ o n ɑː h
گنبد	ɡ o m b a d
گنجشک	ɡ o n d͡ʒ e ʃ k
گنجور	ɡ a n d͡ʒ u ɾ
گنجینه	ɡ a n d͡ʒ i n a
گندم	ɡ a n d u m
گنده	ɡ a n d a
گنم	ɡ e n o m
گهواره	ɡʲ a h v ɑː ɾ a
گو	ɡ o w
گواشتن	ɡ o v ɑː ʃ t a n
گواه	ɡ o v ɑː h
گوجه	ɡ a v d͡ʒ a
گودر	ɡ oː d a ɾ
گودرز	ɡ oː d a ɾ z
گور	ɡ oː ɾ
گورخر	ɡ oː ɾ x a ɾ
گورستان	ɡ oː ɾ i s t ɑː n
گوز	ɡ a v z
گوساله	ɡ uː s ɑː l e
گوسفند	ɡ oː s f a n d
گوش	ɡ oː ʃ
گوشت	ɡ oː ʃ t
گوشه	ɡ oː ʃ a
گوشواره	ɡ oː ʃ w ɑː ɾ a
گون	ɡ oː n
گوناگون	ɡ u n ɑː ɡ u n
گونه	ɡ oː n a
گوهر	ɡ a v h a ɾ
گوگرد	ɡ oː ɡ ɪ ɾ d
گوی	ɡ uː
گویش	ɡ oː j i ʃ
گچ	ɡ a t͡ʃ
گی	a ɡ iː
گیاخن	ɡ o j ɑː x a n
گیان	ɡ o j ɑː n
گیتا	ɡ iː t ɑː
گیتی	ɡ eː t iː
گیس	ɡ e s
گیسو	ɡ e s u
گیلاس	ɡ e l ɑː s
گین	ɡ i n
گیک	ɡ iː k
یا	j ɑː
یائسگی	j ɑː ʔ i s a ɡ iː
یاب	j ɑː b
یاد	j ɑː d
یار	j ɑː ɾ
یازده	j ɑː z d a h
یاسا	j ɑː s ɑː
یاساء	j ɑː s ɑː ʔ
یاساق	j ɑː s ɑː q
یاسمن	j ɑː s a m a n
یافتن	j ɑː f t a n
یاقوت	j ɑː q u t
یاور	j ɑː v a ɾ
یاکند	j ɑː k a n d
یتیم	j a t i m
یخ	j a x
یخچال	j a x t͡ʃ ɑː l
یراق	j a ɾ ɑː ɣ
یزد	j a z d
یزدان	j a z d ɑː n
یشم	j a ʃ m
یعنی	j a ʔ n iː
یلدا	j a l d ɑ
یم	j a m
یمن	j a m a n
ین	eː n
یه	j e
یهود	j a h u d
یهودی	j a h u d iː
یواش	j a v ɑː ʃ
یونانی	j u n ɑː n iː
یونجه	j oː n d͡ʒ a
یپک	j e p a k
یک	j a k
یکا	j a k ɑː
یگانه	j a ɡ ɑː n a
یی	j iː
ییلاق	j a j l ɑː q
