binasa	b i ˈn a s a
retraksiyon	ɾ e t ɾ a k s i ˈo n
balita	b a ˈl i t a ʔ
tinikling	t i n i k ˈl i ŋ
instituto	ʔ i n s t i ˈt u t o
doktora	d o k ˈt o ɾ a
lahi	ˈl a h i ʔ
Abarca	ʔ a ˈb a ɾ k a
magulo	m a ɡ u ˈl o
angkan	ʔ a ŋ ˈk a n
akrostik	ʔ a k ˈɾ o s t i k
Barayuga	b a ɾ a ˈj u ɡ a
singsing	s i ŋ ˈs i ŋ
dating	d a ˈt i ŋ
bilyon	b i l ˈj o n
ritrato	ɾ i t ˈɾ a t o
samo	ˈs a m o ʔ
ahon	ˈʔ a h o n
Korean	k o ˈɾ i a n
magaan	m a ɡ a ˈʔ a n
Z	z i
kupo	ˈk u p o ʔ
tsokolate	t͡ʃ o k o ˈl a t e
Ruedas	ɾ u ˈe d a s
siklo	ˈs i k l o
Bulan	ˈb u l a n
Lupa	ˈl u p a ʔ
es	ʔ e s
magpaliwanag	m a ɡ p a l i ˈw a n a ɡ
kalumbahin	k a l u m b a ˈh i n
tahure	ˈt a h u ɾ e
lalamunan	l a l a ˈm u n a n
magsuot	m a ɡ s u ˈʔ o t
maselan	m a ˈs e l a n
kapsula	ˈk a p s u l a
lamasin	l a ˈm a s i n
tagapamagitan	t a ɡ a p a m a ˈɡ i t a n
sinsay	s i n ˈs a j
mangagat	m a ŋ a ˈɡ a t
emyenda	ʔ e m ˈj e n d a
rambol	ˈɾ a m b o l
haro	ˈh a ɾ o
kuha	ˈk u h a
Manahan	m a ˈn a h a n
taklip	t a k ˈl i p
daungan	ˌd a ˈʔ u ŋ a n
masikip	m a s i ˈk i p
kalahok	k a l a ˈh o k
purgatoryo	p u ɾ ɡ a ˈt o ɾ j o
Hamayka	h a ˈm a j k a
tsang	ˈt͡ʃ a ŋ
sutla	s u t ˈl a ʔ
Singapura	s i ŋ a ˈp u ɾ a
wiski	ˈw i s k i
anislag	ʔ a ˈn i s l a ɡ
Rodrigo	ɾ o d ˈɾ i ɡ o
Odeste	ʔ o ˈd e s t e
lindayag	l i n ˈd a j a ɡ
tanawan	t a ˈn a w a n
Masilungan	m a s i ˈl u ŋ a n
kasoy	k a ˈs o j
Corazon	k o ɾ a ˈz o n
asinan	ʔ a ˈs i n a n
magsimba	m a ɡ s i m ˈb a
ruwina	ɾ u ˈi n a
botelya	b o ˈt e l j a
bituka	b i ˈt u k a
pupu	ˈp u p u ʔ
Tupa	ˈt u p a
initsupil	ˌʔ i n i t ˈs u p i l
pakialam	p a k i ʔ a ˈl a m
dengge	ˈd e ŋ ɡ e
ditablo	d i t a b ˈl o
pisikalan	ˌp i s i ˈk a l a n
kalumbaba	k a l u m ˈb a b a ʔ
tanghal	t a ŋ ˈh a l
suminga	s u m i ˈŋ a
paniniwala	p a n i n i ˈw a l a ʔ
deskripsiyon	d e s k ɾ i p s i ˈo n
masuwerte	m a s u ˈe ɾ t e
alitaptap	ʔ a l i t a p ˈt a p
hangganan	h a ŋ ˈɡ a n a n
ohetes	ʔ o ˈh e t e s
gulat	ˈɡ u l a t
magyaya	m a ɡ ˈj a j a ʔ
tsireta	t͡ʃ i ˈɾ e t a
Saog	ˈs a ʔ o ɡ
solipsismo	s o l i p ˈs i s m o
Ann	ˈʔ a n
dismayado	d i s m a ˈj a d o
Tauro	ˈt a w ɾ o
kasal	k a ˈs a l
balana	ˈb a l a n a
nagpapaubaya	n a ɡ p a p a ʔ u ˈb a j a ʔ
Salva	ˈs a l v a
budots	b u ˈd o t s
dalahik	d a ˈl a h i k
takatak	t a k a ˈt a k
lantutay	l a n ˈt u t a j
lodi	ˈl o d i
mo	m o
okultismo	ʔ o k u l ˈt i s m o
tinik	t i ˈn i k
Aplasca	ʔ a p ˈl a s k a
bumigay	b u m i ˈɡ a j
sapantaha	s a p a n ˈt a h a ʔ
Cacao	k a ˈk a w
dado	ˈd a d o
tigmata	t i ɡ m a ˈt a
kontralason	k o n t ɾ a ˈl a s o n
tauhan	t a ˈʔ u h a n
bahid	ˈb a h i d
timbanin	t i m ˈb a n i n
alipunga	ʔ a l i p u ˈŋ a
libra	ˈl i b ɾ a
lithaw	l i t ˈh a w
Eukaristiya	j u k a ɾ i s ˈt i a
magkuwenta	m a ɡ k u ˈe n t a
uraw	ʔ u ˈɾ a w
Cajucom	k a ˈh u k o m
Agusan	ʔ a ˈɡ u s a n
tiyope	t i ˈo p e ʔ
maleta	m a ˈl e t a
ortograpiya	ʔ o ɾ t o ɡ ɾ a ˈp i a
tinedyer	t i ˈn e d j e ɾ
kuwento	k u ˈe n t o
asupre	ʔ a ˈs u p ɾ e
Isko	ʔ i s ˈk o ʔ
pinapagtalunan	p i ˌn a p a ɡ t a ˈl u n a n
ganire	ɡ a n i ˈɾ e
eskarlata	ʔ e s k a ɾ ˈl a t a
inaanak	ʔ i ˌn a ʔ a ˈn a k
kakabig	k a ˈk a b i ɡ
Cueto	k u ˈe t o
redaksiyon	ɾ e d a k s i ˈo n
Quintos	ˈk i n t o s
kawingan	k a ˈw i ŋ a n
punongkahoy	ˌp u n o ŋ ˈk a h o j
datung	d a ˈt u ŋ
Arnaiz	ʔ a ɾ ˈn a ʔ i s
barker	ˈb a ɾ k e ɾ
tangke	t a ŋ ˈk e
mababangis	m a b a b a ˈŋ i s
Megumi	m e ˈɡ u m i
Diaz	ˈd i a s
tapas	ˈt a p a s
giwa	ˈɡ i w a ʔ
muyangit	m u ˈj a ŋ i t
lirika	ˈl i ɾ i k a
pinabubulaanan	p i n a b u b u l a ˈʔ a n a n
sibasib	s i ˈb a s i b
pamilyado	p a m i l ˈj a d o
nagaganap	n a ɡ a ɡ a ˈn a p
kutya	k u t ˈj a ʔ
sasakyan	s a s a k ˈj a n
beses	ˈb e s e s
balo	ˈb a l o
lunday	l u n ˈd a j
pasipismo	p a s i ˈp i s m o
Aleman	ʔ a l e ˈm a n
Arevalo	ʔ a ˈɾ e v a l o
gikla	ɡ i k ˈl a ʔ
guyabano	ɡ u j a ˈb a n o
Macalalad	m a k a ˈl a l a d
sisihin	s i ˈs i h i n
bulalayak	ˌb u l a l a ˈj a k
maliw	ˈm a l i w
karangalan	k a ɾ a ˈŋ a l a n
alkatsopas	ʔ a l k a ˈt͡ʃ o p a s
garya	ˈɡ a ɾ j a ʔ
maawain	m a ʔ a w a ˈʔ i n
krimen	ˈk ɾ i m e n
salakay	s a ˈl a k a j
tagapagmana	t a ɡ a ˌp a ɡ ˈm a n a
ulbo	ʔ u l ˈb o ʔ
hagak	ˈh a ɡ a k
hardin	h a ɾ ˈd i n
salalay	s a ˈl a l a j
arsobispo	ʔ a ɾ s o ˈb i s p o
iho	ˈʔ i h o
ebakwasyon	ʔ e b a k w a s ˈj o n
parol	p a ˈɾ o l
abuhin	ʔ a b u ˈh i n
manghihipo	m a ŋ h i ˈh i p o ʔ
taympers	ˈt a j m p e ɾ s
sindakin	s i n d a ˈk i n
piyudalismo	p i u d a ˈl i s m o
Arabe	ʔ a ɾ a ˈb e
miklawas	m i k ˈl a w a s
anghang	ʔ a ŋ ˈh a ŋ
kumbinsido	k u m b i n ˈs i d o
Escuadro	ʔ e s k u ˈa d ɾ o
aktibista	ʔ a k t i ˈb i s t a
erehiya	ʔ e ɾ e ˈh i a
lumipad	l u m i ˈp a d
kabutihan	k a b u ˈt i h a n
par	ˈp a ɾ
rehistro	ɾ e ˈh i s t ɾ o
singki	s i ŋ ˈk i ʔ
iha	ˈʔ i h a
umawat	ʔ u ˈm a w a t
lasinggera	l a s i ŋ ˈɡ e ɾ a
sebekoy	ˌs e ˈb e k o j
lantong	l a n ˈt o ŋ
pakyaw	p a k ˈj a w
empirisismo	ˌʔ e m p i ɾ i ˈs i s m o
akwaryum	ʔ a k ˈw a ɾ j u m
biyudo	b i ˈu d o
inyo	ʔ i n ˈj o
okasyon	ʔ o k a s ˈj o n
mangomisyon	m a ŋ o m i s ˈj o n
bungkos	b u ŋ ˈk o s
uyad	ˈʔ u j a d
hapay	h a ˈp a j
Igorot	ʔ i ɡ o ˈɾ o t
sapak	s a ˈp a k
kamandag	k a m a n ˈd a ɡ
tarik	t a ˈɾ i k
suspensiyon	s u s p e n s i ˈo n
magbabaon	m a ɡ b a ˈb a ʔ o n
alamang	ʔ a l a ˈm a ŋ
alak	ˈʔ a l a k
Godiñez	ɡ o ˈd i ɲ e s
tayamutam	t a j a ˈm u t a m
lata	ˈl a t a
makuha	m a ˈk u h a
burara	b u ɾ a ˈɾ a ʔ
silam	ˈs i l a m
baka	ˈb a k a
eskultor	ʔ e s k u l ˈt o ɾ
tatagukan	t a t a ɡ u ˈk a n
alahado	ʔ a l a ˈh a d o
isangkot	ʔ i s a ŋ ˈk o t
marungis	m a ˈɾ u ŋ i s
ani	ˈʔ a n i
eskandalosa	ʔ e s k a n d a ˈl o s a
manulat	m a ˈn u l a t
enerhiya	ʔ e n e ɾ ˈh i a
Ricafrente	ɾ i k a ˈf ɾ e n t e
detalye	d e ˈt a l j e
polo	ˈp o l o
endyi	ˈʔ e n d j i
hilaga	h i ˈl a ɡ a ʔ
maski	m a s ˈk i
bihilante	b i h i ˈl a n t e
sorbetes	s o ɾ ˈb e t e s
tema	ˈt e m a
organismo	ʔ o ɾ ɡ a ˈn i s m o
pulburon	p u l b u ˈɾ o n
mahahapdi	m a h a h a p ˈd i ʔ
kita	k i ˈt a
Pekto	ˈp e k t o
Salgado	s a l ˈɡ a d o
alibutran	ʔ a l i b u t ˈɾ a n
bolta	ˈb o l t a
kaligkig	k a l i ɡ ˈk i ɡ
Aranda	ʔ a ˈɾ a n d a
lingming	l i ŋ ˈm i ŋ
sagubang	s a ɡ u ˈb a ŋ
wawa	ˈw a w a ʔ
kadyos	k a d ˈj o s
oktaba	ʔ o k ˈt a b a
ulol	ʔ u ˈl o l
eksihensiya	ʔ e k s i ˈh e n s j a
kakampink	k a k a m ˈp i n k
gabay	ɡ a ˈb a j
eskapularyo	ʔ e s k a p u ˈl a ɾ j o
Closa	ˈk l o s a
Shohei	ˈs j o h e j
pinirmahan	p i n i ɾ m a ˈh a n
destornilyador	d e s t o ɾ n i l j a ˈd o ɾ
bulyaw	b u l ˈj a w
ewan	ˈʔ e w a n
panganan	p a ˈŋ a n a n
Anor	ʔ a ˈn o ɾ
timbulog	t i m ˈb u l o ɡ
Marquez	m a ɾ ˈk e s
nanamantala	n a n a m a n t a ˈl a
bitiw	b i ˈt i w
Malaluan	m a l a ˈl u ʔ a n
medalya	m e ˈd a l j a
pagnanakaw	p a ɡ n a ˈn a k a w
rakitis	ɾ a ˈk i t i s
buwagin	b u a ˈɡ i n
yaya	ˈj a j a
Mangalindan	m a ŋ a l i n ˈd a n
tanggap	t a ŋ ˈɡ a p
laklak	l a k ˈl a k
kuwako	k u ˈa k o
adres	ˈʔ a d ɾ e s
halihaw	h a ˈl i h a w
dupa	d u ˈp a ʔ
ardilya	ʔ a ɾ ˈd i l j a
kloropormo	k l o ɾ o ˈp o ɾ m o
adisyonal	ʔ a d i s j o ˈn a l
bangkiling	b a ŋ k i ˈl i ŋ
pating	p a ˈt i ŋ
Maranaw	m a ɾ a ˈn a w
matapunan	m a t a ˈp u n a n
arsilya	ʔ a ɾ ˈs i l j a
kasapuwego	k a s a p u ˈe ɡ o
bulsa	b u l ˈs a
sining	ˈs i n i ŋ
kilogramo	k i l o ˈɡ ɾ a m o
anino	ʔ a ˈn i n o
petisyon	p e t i s ˈj o n
siit	s i ˈʔ i t
manawagan	m a n a ˈw a ɡ a n
siklab	s i k ˈl a b
husto	h u s ˈt o
konsumido	k o n s u ˈm i d o
buang	b u ˈʔ a ŋ
julalay	d͡ʒ u ˈl a l a j
bilaw	b i ˈl a w
malakas	m a l a ˈk a s
talos	t a ˈl o s
pudpod	p u d ˈp o d
Castañeda	k a s t a ˈɲ e d a
tulad	ˈt u l a d
paminta	p a m i n ˈt a
diyosesis	d i o ˈs e s i s
ra	ɾ a
korea	k o ˈɾ e a
tributaryo	t ɾ i b u ˈt a ɾ j o
Mañalac	m a ˈɲ a l a k
dedikasyon	d e d i k a s ˈj o n
ligwan	l i ɡ ˈw a n
paksa	p a k ˈs a ʔ
mabunutan	m a b u ˈn u t a n
sentimo	ˌs e n t i ˈm o
peklat	ˈp e k l a t
magmadali	m a ɡ m a d a ˈl i ʔ
Mandaluyong	m a n d a ˈl u j o ŋ
patipati	p a t i ˈp a t i
kutong	ˈk u t o ŋ
humagulhol	h u m a ɡ u l ˈh o l
Dimapilis	d i m a ˈp i l i s
turong	ˈt u ɾ o ŋ
ligta	l i ɡ ˈt a ʔ
Asyano	ʔ a s ˈj a n o
prangko	ˈp ɾ a ŋ k o
baliwag	b a ˈl i w a ɡ
gulang	ˈɡ u l a ŋ
asawa	ʔ a ˈs a w a
makaramdam	m a k a ɾ a m ˈd a m
gagad	ɡ a ˈɡ a d
betis	ˈb e t i s
kabit	k a ˈb i t
magkausap	m a ɡ k a ˈʔ u s a p
sipot	s i ˈp o t
satelayt	ˈs a t e l a j t
Hehoba	h e ˈh o b a
gasera	ɡ a ˈs e ɾ a
palamura	p a l a m u ˈɾ a
masiyasip	m a s i ˈa s i p
gumawa	ɡ u m a ˈw a ʔ
ibenta	ʔ i ˈb e n t a
sahod	ˈs a h o d
magwahil	m a ɡ w a ˈh i l
kandidatura	k a n d i d a ˈt u ɾ a
maalamat	m a ʔ a l a ˈm a t
Vizconde	v i s ˈk o n d e
abiso	ʔ a ˈb i s o
Silayan	s i ˈl a j a n
kuwenta	k u ˈe n t a
kamatis	k a ˈm a t i s
tiyahin	t i ˈa h i n
iskul	ʔ i s ˈk u l
perspektiba	p e ɾ s p e k ˈt i b a
makipagtalik	m a k i p a ɡ ˈt a l i k
lentehas	l e n ˈt e h a s
tinga	t i ˈŋ a
landi	l a n ˈd i ʔ
magjakol	m a ɡ d͡ʒ a ˈk o l
koral	k o ˈɾ a l
katay	ˈk a t a j
estranghero	ʔ e s t ɾ a ŋ ˈh e ɾ o
depensibo	d e p e n ˈs i b o
Jaramillo	h a ɾ a ˈm i l j o
Borlaza	b o ɾ ˈl a z a
pinuno	p i ˈn u n o ʔ
lawulta	l a w u l ˈt a
labaha	l a ˈb a h a
bentaha	b e n ˈt a h a
inugsukat	ʔ i n u ɡ ˈs u k a t
lakre	ˈl a k ɾ e
gunimbilang	ɡ u n i m ˈb i l a ŋ
ibinigay	ʔ i b i n i ˈɡ a j
tambling	ˈt a m b l i ŋ
lapastanganin	l a p a s t a ˈŋ a n i n
dalubguro	d a ˌl u b ˈɡ u ɾ o ʔ
Mamburao	m a m b u ˈɾ a w
heko	ˈh e k o
Manilenya	m a n i ˈl e n j a
Tupas	ˈt u p a s
hungkag	h u ŋ ˈk a ɡ
kukis	ˈk u k i s
hawsyaw	ˈh a w s j a w
soberano	s o b e ˈɾ a n o
palaba	p a l a ˈb a
takuri	t a k u ˈɾ i ʔ
samain	s a m a ˈʔ i n
ngani	ˈŋ a n i ʔ
utas	ʔ u ˈt a s
BSP	ˌb i ʔ e s ˈp i
Baquiran	b a ˈk i ɾ a n
kritiko	ˈk ɾ i t i k o
ka	k a
Montaño	m o n ˈt a ɲ o
alipin	ʔ a ˈl i p i n
asapran	ʔ a s a p ˈɾ a n
liwayway	l i w a j ˈw a j
reportahe	ɾ e p o ɾ ˈt a h e
Espino	ʔ e s ˈp i n o
iring	ˈʔ i ɾ i ŋ
atrebida	ʔ a t ɾ e ˈb i d a
propesora	p ɾ o p e ˈs o ɾ a
samid	s a ˈm i d
lubang	ˈl u b a ŋ
ᜊ	b a ˈb a ʔ
putak	p u ˈt a k
Samantha	s a ˈm a n t a
anib	ˈʔ a n i b
linga	l i ˈŋ a
mawala	m a w a ˈl a ʔ
iskolarsyip	ʔ i s ˈk o l a ɾ s j i p
maghinala	m a ɡ h i ˈn a l a ʔ
agwamarina	ʔ a ɡ w a m a ˈɾ i n a
saysay	s a j ˈs a j
saks	ˈs a k s
radikal	ɾ a d i ˈk a l
eskala	ʔ e s ˈk a l a
misis	ˈm i s i s
kinakastigo	k i n a k a s ˈt i ɡ o
salapid	s a l a ˈp i d
seradura	s e ɾ a ˈd u ɾ a
malisya	m a ˈl i s j a
nobyo	ˈn o b j o
hinliliit	h i n l i l i ˈʔ i t
sepelin	ˈs e p e l i n
pinabulaanan	p i n a b u l a ˈʔ a n a n
pagpapatiwakal	p a ɡ p a p a t i w a ˈk a l
Hinduismo	h i n d u ˈi s m o
Islam	ʔ i s ˈl a m
Sanchez	ˈs a n t͡ʃ e s
akbay	ʔ a k ˈb a j
lilok	ˈl i l o k
kongreso	k o n ˈɡ ɾ e s o
paligsa	p a l i ɡ ˈs a
depinisyon	d e p i n i s ˈj o n
senadora	s e n a ˈd o ɾ a
Yabut	ˈj a b u t
tagalinang	t a ɡ a l i ˈn a ŋ
yaon	j a ˈʔ o n
palaso	p a l a ˈs o ʔ
makipagbati	m a k i p a ɡ b a ˈt i ʔ
maging	m a ˈɡ i ŋ
saksakin	s a k s a ˈk i n
Hagonoy	h a ˈɡ o n o j
sandal	s a n ˈd a l
Litwanya	l i t ˈw a n j a
oso	ˈʔ o s o
agnas	ʔ a ɡ ˈn a s
Chedeng	ˈt͡ʃ e d e ŋ
umulit	ʔ u ˈm u l i t
kilos	ˈk i l o s
bigla	b i ɡ ˈl a ʔ
makita	m a ˈk i t a ʔ
humba	h u m ˈb a ʔ
ineng	ʔ i ˈn e ŋ
biyaya	b i ˈa j a ʔ
manigo	m a ˈn i ɡ o ʔ
kapre	ˈk a p ɾ e
Malanday	m a l a n ˈd a j
imperatibo	ʔ i m p e ɾ a ˈt i b o
lamon	ˈl a m o n
tulod	ˈt u l o d
hinang	ˈh i n a ŋ
lungaw	l u ˈŋ a w
sapalaran	ˈs a p a l a ɾ a n
utilitarismo	ʔ u t i l i t a ˈɾ i s m o
ma	m a
arok	ʔ a ˈɾ o k
magkautang	m a ɡ k a ˈʔ u t a ŋ
gadgaran	ɡ a d ˈɡ a ɾ a n
gusilaw	ɡ u ˈs i l a w
kahero	k a ˈh e ɾ o
matitibay	m a t i ˈt i b a j
blangko	ˈb l a ŋ k o
diyan	d i ˈa n
panuruan	ˈp a n u ɾ u ʔ a n
payak	p a ˈj a k
kakawati	k a k a ˈw a t i
palso	p a l ˈs o
Arcillas	ʔ a ɾ ˈs i l j a s
Tarnate	t a ɾ ˈn a t e
magatas	m a ˈɡ a t a s
pasukan	p a s u ˈk a n
dagdag	d a ɡ ˈd a ɡ
matraka	m a t ˈɾ a k a
manahimik	m a n a ˈh i m i k
Ebanghelyo	ʔ e b a ŋ ˈh e l j o
Gonzales	ɡ o n ˈz a l e s
damuho	d a ˈm u h o ʔ
kapagka	k a p a ɡ ˈk a ʔ
maghuramentado	m a ɡ h u ɾ a m e n ˈt a d o
baitang	b a ʔ i ˈt a ŋ
Katigbak	k a t i ɡ ˈb a k
eksaherado	ʔ e k s a h e ˈɾ a d o
peseta	p e ˈs e t a
ospitalidad	ʔ o s p i t a l i ˈd a d
sibsib	s i b ˈs i b
bitamina	b i t a ˈm i n a
silidkaphay	s i l i d k a p ˈh a j
alangan	ʔ a l a ˈŋ a n
maglaway	m a ɡ l a ˈw a j
mambuwisit	m a m b u ˈi s i t
mabulas	m a ˈb u l a s
sulapid	s u ˈl a p i d
udon	ˈʔ u d o n
rin	ˈɾ i n
Saavedra	s a ʔ a ˈv e d ɾ a
lagap	l a ˈɡ a p
omsim	ˈʔ o m s i m
jontis	ˈd͡ʒ o n t i s
ingreso	ʔ i ŋ ˈɡ ɾ e s o
Jaro	ˈh a ɾ o
tamales	t a ˈm a l e s
Namayan	n a ˈm a j a n
Guillermo	ɡ i l ˈj e ɾ m o
dukwangin	d u k w a ˈŋ i n
ᜐ	s a ˈs a ʔ
mesa	ˈm e s a
Tamiko	t a ˈm i k o
taklab	t a k ˈl a b
tsarera	t͡ʃ a ˈɾ e ɾ a
sambalilo	s a m b a ˈl i l o
tsispa	ˈt͡ʃ i s p a
agam	ˈʔ a ɡ a m
simulasyon	s i m u l a s ˈj o n
Ragudo	ɾ a ˈɡ u d o
kabila	k a b i ˈl a ʔ
lubo	ˈl u b o ʔ
sumunod	s u m u ˈn o d
tsumaka	t͡ʃ u ˈm a k a
Balmes	ˈb a l m e s
tagaangkat	t a ɡ a ʔ a ŋ ˈk a t
kuyakoy	k u ˈj a k o j
lagpas	l a ɡ ˈp a s
inggit	ʔ i ŋ ˈɡ i t
Caluya	k a ˈl u j a
Pansol	p a n ˈs o l
silbiro	s i l ˈb i ɾ o
magyasyas	m a ɡ j a s ˈj a s
lawlaw	l a w ˈl a w
bigo	b i ˈɡ o ʔ
probinsiyana	p ɾ o b i n s i ˈa n a
labandera	l a b a n ˈd e ɾ a
siyesta	s i ˈe s t a
bisyo	ˈb i s j o
pagsasaka	p a ɡ s a ˈs a k a
anek	ʔ a ˈn e k
bigasan	ˌb i ˈɡ a s a n
Rajah	ˈɾ a h a
uom	ʔ u ˈʔ o m
Domantay	d o m a n ˈt a j
yate	ˈj a t e
nakayukyok	n a k a j u k ˈj o k
tiwali	t i w a ˈl i ʔ
tekas	ˈt e k a s
maggantsilyo	m a ɡ ɡ a n ˈt͡ʃ i l j o
kategorikal	k a t e ɡ o ɾ i ˈk a l
tutubi	t u t u ˈb i
Enero	ʔ e ˈn e ɾ o
bilugan	b i l u ˈɡ a n
turista	t u ˈɾ i s t a
dara	d a ˈɾ a
saloy	ˈs a l o j
esmeralda	ʔ e s m e ˈɾ a l d a
Fariñas	f a ˈɾ i ɲ a s
magtapat	m a ɡ t a ˈp a t
determinismo	d e t e ɾ m i ˈn i s m o
kustomer	ˈk u s t o m e ɾ
sikologo	s i ˈk o l o ɡ o
sikolohiya	s i k o l o ˈh i a
mawsoleo	m a w s o ˈl e o
estapa	ʔ e s ˈt a p a
matinis	m a ˈt i n i s
lumboy	l u m ˈb o j
Keiko	ˈk e j k o
kabinet	ˈk a b i n e t
lagim	l a ˈɡ i m
Gascon	ɡ a s ˈk o n
amaranto	ʔ a m a ˈɾ a n t o
kunsumido	k u n s u ˈm i d o
detalyado	d e t a l ˈj a d o
lubaw	ˈl u b a w
pasigan	p a ˈs i ɡ a n
teritoryo	t e ɾ i ˈt o ɾ j o
helikopter	h e l i ˈk o p t e ɾ
batad	b a ˈt a d
nagnanakaw	n a ɡ n a ˈn a k a w
ikaanim	ʔ i k a ˈʔ a n i m
orasyon	ʔ o ɾ a s ˈj o n
tayabutab	t a j a ˈb u t a b
sepilyo	s e ˈp i l j o
Corcuera	k o ɾ k u ˈe ɾ a
burges	b u ɾ ˈɡ e s
uwak	ʔ u ˈa k
tilandoy	t i l a n ˈd o j
hayahay	h a ˈj a h a j
TNT	ˈt i ʔ e n t i
paepek	p a ʔ e ˈp e k
lingkod	l i ŋ ˈk o d
magat	ˈm a ɡ a t
Ablog	ʔ a b ˈl o ɡ
presko	ˈp ɾ e s k o
pinapagtawanan	p i ˌn a p a ɡ t a w a ˈn a n
kabata	k a ˈb a t a ʔ
bungkugan	b u ŋ ˈk u ɡ a n
pagkaigkasin	p a ɡ k a ʔ i ɡ ˈk a s i n
mahistrado	m a h i s ˈt ɾ a d o
patalim	p a t a ˈl i m
lapit	ˈl a p i t
Fukien	ˈf u k j e n
bilao	b i ˈl a ʔ o
konyak	k o n ˈj a k
aaaban	ʔ a ʔ a ʔ a ˈb a n
gilid	ˈɡ i l i d
magbababoy	m a ɡ b a b a ˈb o j
pamahaw	p a ˈm a h a w
Bermudez	b e ɾ ˈm u d e s
sanaysay	s a n a j ˈs a j
ermita	ʔ e ɾ ˈm i t a
Corpus	ˈk o ɾ p u s
korupsiyon	k o ɾ u p s i ˈo n
bubuweltahan	b u b u ˌe l t a ˈh a n
slang	ˈs l a ŋ
tumangkad	t u m a ŋ ˈk a d
batchoy	b a ˈt͡ʃ o j
badap	b a ˈd a p
irekomenda	ʔ i ɾ e k o m e n ˈd a
espantaho	ʔ e s p a n ˈt a h o
kontento	k o n ˈt e n t o
bihod	ˈb i h o d
agwa	ˈʔ a ɡ w a
Jurado	h u ˈɾ a d o
gusali	ɡ u ˈs a l i ʔ
Uganda	ʔ u ˈɡ a n d a
komplikasyon	k o m p l i k a s ˈj o n
hati	ˈh a t i ʔ
magigi	m a ˈɡ i ɡ i ʔ
lakwatsera	l a k w a ˈt͡ʃ e ɾ a
tuma	ˈt u m a
anis	ʔ a ˈn i s
sigsa	s i ɡ ˈs a
talupak	t a ˈl u p a k
kalinggalan	k a l i ŋ ɡ a ˈl a n
platon	p l a ˈt o n
walo	w a ˈl o
bago	ˈb a ɡ o
Bascoguin	b a s ˈk o ɡ i n
guham	ɡ u ˈh a m
tabon	ˈt a b o n
seksi	ˈs e k s i
Caguiat	ˈk a ɡ j a t
'ka	ˈk a ʔ
dabdab	d a b ˈd a b
pangkagawaran	p a ŋ k a ɡ a w a ˈɾ a n
gumimik	ɡ u ˈm i m i k
Roxas	ˈɾ o h a s
Audrey	ˈʔ o d ɾ i
espesyalista	ʔ e s p e s j a ˈl i s t a
danumnayan	d a n u m ˈn a j a n
tingting	t i ŋ ˈt i ŋ
bra	ˈb ɾ a
erpats	ˈʔ e ɾ p a t s
Barangka	b a ɾ a ŋ ˈk a ʔ
inhenyeriya	ʔ i n h e n j e ˈɾ i a
pararayos	ˌp a ɾ a ˈɾ a j o s
letrina	l e t ˈɾ i n a
alahero	ʔ a l a ˈh e ɾ o
destabilisasyon	d e s t a b i l i s a s ˈj o n
pambihira	p a m b i ˈh i ɾ a ʔ
bunso	b u n ˈs o ʔ
obligasyon	ʔ o b l i ɡ a s ˈj o n
Kurisma	k u ˈɾ i s m a
madamo	m a d a ˈm o
pakielam	p a k i ˈʔ e l a m
sangkatutak	s a ŋ k a ˈt u t a k
palaisipan	p a ˌl a ʔ i s i ˈp a n
na	n a
paboritismo	p a b o ɾ i ˈt i s m o
taluiryap	t a l u ʔ i ɾ ˈj a p
mabalasik	m a b a ˈl a s i k
abyugin	ʔ a b j u ˈɡ i n
silab	s i ˈl a b
katukayo	k a t u ˈk a j o
yamo	ˈj a m o ʔ
asnan	ʔ a s ˈn a n
polbo	ˈp o l b o
pantomina	ˌp a n t o ˈm i n a
baranggay	b a ɾ a ŋ ˈɡ a j
usngal	ʔ u s ˈŋ a l
kwenta	ˈk w e n t a
halumigmig	h a l u m i ɡ ˈm i ɡ
mantala	m a n t a ˈl a
Turkmenistan	t u ɾ k m e n i s ˈt a n
Lumad	ˈl u m a d
manukan	m a ˈn u k a n
labadora	l a b a ˈd o ɾ a
sabunin	s a b u ˈn i n
layo	ˈl a j o ʔ
Malicdem	m a l i k ˈd e m
gansal	ɡ a n ˈs a l
Jocson	ˈh o k s o n
bukadkad	b u k a d ˈk a d
Indiyano	ʔ i n d i ˈa n o
talangka	t a l a ŋ ˈk a ʔ
obserbatoryo	ʔ o b s e ɾ b a ˈt o ɾ j o
paraiso	p a ɾ a ˈʔ i s o
palasimba	p a l a s i m ˈb a
kaberdehan	k a ˈb e ɾ d e h a n
Banaag	b a ˈn a ʔ a ɡ
apostol	ʔ a p o s ˈt o l
limusina	l i m u ˈs i n a
dobolyu	ˈd o b o l j u
Siason	ˈs j a s o n
Datu	ˈd a t u
balikatin	b a l i ˈk a t i n
pagbabalik	p a ɡ b a b a ˈl i k
ayoko	ʔ a ˈj o k o
balon	b a ˈl o n
karelyebo	k a ɾ e l ˈj e b o
bagalan	b a ˈɡ a l a n
cato	k a ˈt o
muwi	ˈm u i ʔ
Villamayor	v i l j a m a ˈj o ɾ
kurakot	k u ˈɾ a k o t
sanke	s a n ˈk e ʔ
lingguhan	l i ŋ ˈɡ u h a n
ugaga	ʔ u ˈɡ a ɡ a ʔ
okey	ˈʔ o k e j
bilauo	b i ˈl a w o
Ty	t i
mangjumbag	m a ŋ ˈd͡ʒ u m b a ɡ
leksikograpiko	l e k s i k o ɡ ˌɾ a p i ˈk o
palaman	p a l a ˈm a n
suwerte	s u ˈe ɾ t e
ll	ˈʔ e l j e
tulog	ˈt u l o ɡ
lumakas	l u m a ˈk a s
bisa	ˈb i s a ʔ
notaryo	n o ˈt a ɾ j o
kabibili	k a b i b i ˈl i
Cabasag	k a ˈb a s a ɡ
durog	d u ˈɾ o ɡ
salap	ˈs a l a p
Villablanca	v i l j a ˈb l a n k a
balse	ˈb a l s e
kuwela	k u ˈe l a
asam	ʔ a ˈs a m
teista	t e ˈi s t a
Pagdanganan	p a ɡ d a ˈŋ a n a n
plantsa	ˈp l a n t͡ʃ a
danumsigwasan	d a n u m s i ɡ ˈw a s a n
akit	ˈʔ a k i t
Gamiao	ˈɡ a m j a w
peryodista	p e ɾ j o ˈd i s t a
Remulla	ɾ e ˈm u l j a
panahinga	p a n a ˈh i ŋ a
halari	h a ˈl a ɾ i ʔ
diyesmo	d i ˈe s m o
karta	ˈk a ɾ t a
isaisip	ʔ i s a ˈʔ i s i p
limampu	l i m a m ˈp u ʔ
bolera	b o ˈl e ɾ a
maghasik	m a ɡ h a ˈs i k
mangmang	m a ŋ ˈm a ŋ
retirada	ɾ e t i ˈɾ a d a
balipik	b a ˈl i p i k
mayaman	m a ˈj a m a n
soltada	s o l ˈt a d a
magluto	m a ɡ ˈl u t o ʔ
hadlang	h a d ˈl a ŋ
mahalaga	m a h a l a ˈɡ a
mikroorganismo	m i k ɾ o ʔ o ɾ ɡ a ˈn i s m o
Magsayo	m a ɡ ˈs a j o
mestiso	m e s ˈt i s o
pundasyon	p u n d a s ˈj o n
tambuli	t a m ˈb u l i ʔ
Alvaro	ˈʔ a l v a ɾ o
bingwit	b i ŋ ˈw i t
Eloriaga	ʔ e l o ɾ ˈj a ɡ a
singa	s i ˈŋ a
Laylo	ˈl a j l o
ene	ˈʔ e n e
intriga	ʔ i n ˈt ɾ i ɡ a
mami	ˈm a m i
maimbot	m a ʔ i m ˈb o t
agwahas	ʔ a ɡ ˈw a h a s
maagap	m a ˈʔ a ɡ a p
uway	ʔ u ˈa j
Lucero	l u ˈs e ɾ o
pakikipagchat	p a k i k i p a ɡ ˈt͡ʃ a t
golpe	ˈɡ o l p e
dunong	ˈd u n o ŋ
Paligsahan	p a l i ɡ ˈs a h a n
linisan	l i ˈn i s a n
tanghali	t a ŋ ˈh a l i ʔ
Orendain	ʔ o ɾ e n d a ˈʔ i n
anubing	ʔ a ˈn u b i ŋ
silidlawas	s i ˌl i d ˈl a w a s
reptil	ɾ e p ˈt i l
hanip	ˈh a n i p
Pagaspas	p a ɡ a s ˈp a s
sirkito	ˈs i ɾ k i t o
kurot	k u ˈɾ o t
bisyon	b i s ˈj o n
bagsakan	b a ɡ ˈs a k a n
tiyobibo	t i o ˈb i b o
gulumihan	ɡ u l u ˈm i h a n
makalima	m a ˈk a l i m a
taltak	t a l ˈt a k
Alabat	ʔ a l a ˈb a t
korido	k o ˈɾ i d o
kargamento	k a ɾ ɡ a ˈm e n t o
maglustay	m a ɡ l u s ˈt a j
yumurak	j u ˈm u ɾ a k
tarang	t a ˈɾ a ŋ
maulanan	m a ʔ u l a ˈn a n
kuwitis	k u ˈi t i s
aninag	ʔ a ˈn i n a ɡ
nanananghalian	n a n a n a ŋ h a ˈl i ʔ a n
alimuran	ʔ a l i m u ˈɾ a n
kutsukutso	k u ˌt͡ʃ u k u ˈt͡ʃ o
bati	b a ˈt i ʔ
entremetido	ʔ e n t ɾ e m e ˈt i d o
sapupuhin	s a p u ˈp u h i n
madiwa	m a ˈd i w a ʔ
dalubtao	d a ˌl u b ˈt a ʔ o
kandaro	k a n ˈd a ɾ o
bangkuro	b a ŋ ˈk u ɾ o
karisma	k a ˈɾ i s m a
sisid	ˈs i s i d
Nicolas	n i k o ˈl a s
inupas	ʔ i ˈn u p a s
inskripsiyon	ʔ i n s k ɾ i p s i ˈo n
tuyo	t u ˈj o ʔ
dipterya	d i p ˈt e ɾ j a
ostrasismo	ʔ o s t ɾ a ˈs i s m o
daos	ˈd a ʔ o s
s	ʔ e s
bilang	ˈb i l a ŋ
balde	b a l ˈd e
labakara	l a b a ˈk a ɾ a
tibag	t i ˈb a ɡ
usisain	ʔ u s i ˈs a ʔ i n
praning	p ɾ a ˈn i ŋ
ipatong	ʔ i ˈp a t o ŋ
hamak	ˈh a m a k
dalubwikaan	d a ˌl u b w i ˈk a ʔ a n
labaw	ˈl a b a w
akompanya	ʔ a k o m p a n ˈj a
tiboom	t i ˈb u m
wangis	ˈw a ŋ i s
alaman	ʔ a ˈl a m a n
malasado	m a l a ˈs a d o
bako	b a ˈk o ʔ
iso	ˈʔ i s o
umiintindi	ʔ u m i ʔ i n t i n ˈd i
biguin	b i ɡ u ˈʔ i n
pagkabigo	p a ɡ k a b i ˈɡ o ʔ
tampay	t a m ˈp a j
Montemayor	m o n t e m a ˈj o ɾ
kusim	k u ˈs i m
tabak	t a ˈb a k
lambing	l a m ˈb i ŋ
mabilis	m a b i ˈl i s
nagdedeliryo	n a ɡ d e d e ˈl i ɾ j o
Falcon	f a l ˈk o n
pilibustero	p i l i b u s ˈt e ɾ o
Adlawan	ʔ a d ˈl a w a n
tanggi	t a ŋ ˈɡ i
Munsayac	m u n s a ˈj a k
estandarte	ʔ e s t a n ˈd a ɾ t e
lang	ˈl a ŋ
sambong	s a m ˈb o ŋ
malutong	m a l u ˈt o ŋ
retratista	ɾ e t ɾ a ˈt i s t a
datiles	ˌd a t i ˈl e s
samay	ˈs a m a j
santol	s a n ˈt o l
Cortez	k o ɾ ˈt e s
gumising	ɡ u ˈm i s i ŋ
obsesyon	ʔ o b s e s ˈj o n
masalimuot	m a s a l i ˈm u ʔ o t
lityo	ˈl i t j o
lubak	l u ˈb a k
sawing	s a ˈw i ŋ
ow	ˈʔ o w
maanak	m a ʔ a ˈn a k
Layco	ˈl a j k o
SK	ˈʔ e s k e j
Gatchalian	ɡ a t͡ʃ a l ˈj a n
propesyonalismo	p ɾ o p e s j o n a ˈl i s m o
alalahanin	ʔ a l a l a ˈh a n i n
duwende	d u ˈe n d e
singaw	s i ˈŋ a w
kundena	k u n d e ˈn a
higliknayan	h i ɡ l i k ˈn a j a n
minsanan	m i n ˈs a n a n
Maala	m a ˈʔ a l a
labis	ˈl a b i s
tosino	t o ˈs i n o
utitab	ʔ u ˈt i t a b
kantutin	k a n t u ˈt i n
laga	ˈl a ɡ a ʔ
gumaling	ɡ u m a ˈl i ŋ
polaynas	p o ˈl a j n a s
adiksiyon	ʔ a d i k s ˈj o n
admisyon	ʔ a d m i s ˈj o n
tikim	t i ˈk i m
resitasyon	ɾ e s i t a s ˈj o n
patola	p a ˈt o l a
mas	ˈm a s
Cayabyab	k a j a b ˈj a b
labawliknayan	l a b a w l i k ˈn a j a n
Malaruhatan	m a l a ɾ u h a ˈt a n
Kawi	ˈk a w i
bahagdan	b a h a ɡ ˈd a n
entero	ʔ e n ˈt e ɾ o
astropisika	ʔ a s t ɾ o ˈp i s i k a
nagagandahan	n a ɡ a ɡ a n d a ˈh a n
kuwa	k u ˈa ʔ
kumpiyansa	k u m p i ˈa n s a
dalubituinan	d a ˌl u b i t u ʔ i ˈn a n
kaniyugan	k a n i ˈu ɡ a n
gusgos	ɡ u s ˈɡ o s
gilib	ɡ i ˈl i b
kampanaryo	k a m p a ˈn a ɾ j o
etika	ˈʔ e t i k a
siyete	s i ˈe t e
Baluyot	b a ˈl u j o t
ariangaw	ʔ a ɾ i ˈʔ a ŋ a w
timpi	t i m ˈp i ʔ
sakol	ˈs a k o l
Tagaytay	t a ɡ a j ˈt a j
Esperanto	ʔ e s p e ˈɾ a n t o
utot	ʔ u ˈt o t
katastrope	k a ˈt a s t ɾ o p e
N	ʔ e n
magkatay	m a ɡ ˈk a t a j
pagong	p a ˈɡ o ŋ
aktwal	ʔ a k ˈt w a l
sinehan	s i n e ˈh a n
apoy	ʔ a ˈp o j
kliyente	k l i ˈe n t e
giwang	ˈɡ i w a ŋ
pananampalataya	p a n a n a m p a l a ˈt a j a
ibabaw	ʔ i ˈb a b a w
basar	b a ˈs a ɾ
hunyango	h u n ˈj a ŋ o ʔ
sikreto	s i k ˈɾ e t o
sandaigdigan	s a n d a ʔ i ɡ ˈd i ɡ a n
desilitro	d e s i ˈl i t ɾ o
suhol	ˈs u h o l
ugaw	ʔ u ˈɡ a w
Ubalde	ʔ u ˈb a l d e
Imperial	ʔ i m p e ɾ ˈj a l
peyneta	p e j ˈn e t a
abla	ˈʔ a b l a
siyampu	s i ˈa m p u
Magbuhos	m a ɡ ˈb u h o s
santa	ˈs a n t a
mapansin	m a p a n ˈs i n
kalimbahin	k a l i m b a ˈh i n
Ayako	ʔ a ˈj a k o
lumuklok	l u m u k ˈl o k
rotasyon	ɾ o t a s ˈj o n
pintuan	p i n ˈt u ʔ a n
liwat	ˈl i w a t
bigting	b i ɡ ˈt i ŋ
maglalaway	m a ɡ l a l a ˈw a j
kalan	k a ˈl a n
Huwebes	h u ˈe b e s
Buenviaje	b u e n v i ˈa h e
akurdiyon	ʔ a k u ɾ d i ˈo n
tiwasay	t i w a ˈs a j
tiple	ˈt i p l e
Dalangin	d a ˈl a ŋ i n
Vecino	v e ˈs i n o
dini	ˈd i n i
pampanitikan	p a m ˈp a n i t i k a n
Magdangal	m a ɡ d a ˈŋ a l
huwataw	h u ˈa t a w
Bolivar	b o ˈl i v a ɾ
hagulhol	h a ɡ u l ˈh o l
uhod	ˈʔ u h o d
eskalera	ʔ e s k a ˈl e ɾ a
hilaw	h i ˈl a w
iki	ˈʔ i k i ʔ
Kankanaey	k a n k a ˈn a ʔ e j
namnam	n a m ˈn a m
talukab	t a ˈl u k a b
oposisyon	ʔ o p o s i s ˈj o n
erkon	ˈʔ e ɾ k o n
kalapati	k a l a ˈp a t i
solusyon	s o l u s ˈj o n
dapat	ˈd a p a t
dagta	d a ɡ ˈt a ʔ
lagkit	l a ɡ ˈk i t
limon	l i ˈm o n
simetriya	s i m e t ˈɾ i a
halabos	h a l a ˈb o s
Montalbo	m o n ˈt a l b o
kunat	ˈk u n a t
Grace	ˈɡ ɾ e j s
mamuhay	m a ˈm u h a j
lambayog	l a m ˈb a j o ɡ
tanghalian	t a ŋ h a ˈl i ʔ a n
sais	s a ˈʔ i s
sulsol	s u l ˈs o l
ahas	ˈʔ a h a s
disko	ˈd i s k o
hawig	h a ˈw i ɡ
kumporme	k u m ˈp o ɾ m e
Tien	ˈt j e n
lingguwista	l i ŋ ɡ u ˈi s t a
tosta	t o s ˈt a
mabalakid	m a b a ˈl a k i d
kibit	k i ˈb i t
kuwadro	k u ˈa d ɾ o
gladyador	ɡ l a d j a ˈd o ɾ
DOLE	ˈd o l e
balikan	ˌb a ˈl i k a n
dutaan	d u ˈt a ʔ a n
kapatawaran	k a p a t a w a ˈɾ a n
donasyon	d o n a s ˈj o n
aberya	ʔ a b e ɾ ˈj a
nguyngoy	ŋ u j ˈŋ o j
luwa	l u ˈa ʔ
kisig	ˈk i s i ɡ
aikido	ʔ a j ˈk i d o
Jara	ˈh a ɾ a
maunlad	m a ʔ u n ˈl a d
kugita	k u ˈɡ i t a ʔ
akala	ʔ a ˈk a l a ʔ
kumbensiyon	k u m b e n s i ˈo n
mayroon	m a j ɾ o ˈʔ o n
estasyon	ʔ e s t a s ˈj o n
shiboli	ˈʃ i b o l i
malikhain	m a l i k ˈh a ʔ i n
mamumuhunan	m a m u m u ˈh u n a n
sibika	ˌs i b i ˈk a
pusaw	p u ˈs a w
protina	p ɾ o ˈt i n a
suplay	s u p ˈl a j
Ochoa	ʔ o ˈt͡ʃ o a
patidyugto	p a t i d j u ɡ ˈt o ʔ
botika	b o ˈt i k a
terminal	ˌt e ɾ m i ˈn a l
deskaril	d e s k a ˈɾ i l
manlait	m a n ˈl a ʔ i t
Irlanda	ʔ i ɾ ˈl a n d a
malindol	m a l i n ˈd o l
hustisya	h u s ˈt i s j a
Jalandoni	h a l a n ˈd o n i
Satanas	s a t a ˈn a s
sinturon	s i n t u ˈɾ o n
bigtiin	b i ɡ t i ˈʔ i n
ipakuha	ʔ i p a ˈk u h a
mapurol	m a p u ˈɾ o l
perspektibo	p e ɾ s p e k ˈt i b o
bayad	ˈb a j a d
kubil	k u ˈb i l
tokaya	t o ˈk a j a
ambubuyog	ʔ a m b u ˈb u j o ɡ
setro	ˈs e t ɾ o
propagandista	p ɾ o p a ɡ a n ˈd i s t a
proyekto	p ɾ o ˈj e k t o
senyal	s e n ˈj a l
gamol	ɡ a ˈm o l
almuwerso	ʔ a l m u ˈe ɾ s o
desente	d e ˈs e n t e
Daisuke	d a j ˈs u k e
benesyana	b e n e s ˈj a n a
bobo	ˈb o b o
Lazaro	ˈl a z a ɾ o
melodiya	m e l o ˈd i a
imoralidad	ʔ i m o ɾ a l i ˈd a d
limay	ˈl i m a j
babag	b a ˈb a ɡ
isulat	ʔ i ˈs u l a t
pagkakasakit	p a ɡ k a k a s a ˈk i t
Nacpil	n a k ˈp i l
manuntok	m a n u n ˈt o k
bibliyoteka	b i b l i o ˈt e k a
Dee	d i
kardbord	ˈk a ɾ d b o ɾ d
biskonde	b i s ˈk o n d e
elektrisista	ʔ e l e k t ɾ i ˈs i s t a
obaryo	ʔ o ˈb a ɾ j o
magsapatos	m a ɡ s a ˈp a t o s
bandehado	b a n d e ˈh a d o
pananambang	p a n a n a m ˈb a ŋ
monopolyo	m o n o ˈp o l j o
rekisito	ɾ e k i ˈs i t o
Alfredo	ʔ a l ˈf ɾ e d o
saro	ˈs a ɾ o
noon	n o ˈʔ o n
unawa	ʔ u ˈn a w a ʔ
polyeto	p o l ˈj e t o
Peñaflor	p e ɲ a ˈf l o ɾ
patimog	p a ˈt i m o ɡ
diblinig	d i b l i ˈn i ɡ
Suansing	s u a n ˈs i ŋ
umisod	ʔ u ˈm i s o d
reptilya	ɾ e p ˈt i l j a
panauhin	p a n a ˈʔ u h i n
residente	ɾ e s i ˈd e n t e
Laude	ˈl a w d e
uslak	ʔ u s ˈl a k
'y	j
tagahanga	t a ɡ a ˈh a ŋ a ʔ
webera	w e ˈb e ɾ a
Catindig	k a t i n ˈd i ɡ
lusog	l u ˈs o ɡ
medyas	ˈm e d j a s
Solano	s o ˈl a n o
taksan	t a k ˈs a n
kumpensasyon	k u m p e n s a s ˈj o n
urang	ˈʔ u ɾ a ŋ
kamyas	k a m ˈj a s
adelanto	ʔ a d e ˈl a n t o
bukid	ˈb u k i d
salwak	s a l ˈw a k
Maristela	m a ɾ i s ˈt e l a
lumot	ˈl u m o t
Manalastas	m a n a l a s ˈt a s
distansiya	d i s ˈt a n s j a
biluslawas	b i l u s ˈl a w a s
nerbyoso	n e ɾ ˈb j o s o
tungaw	t u ˈŋ a w
luminis	l u ˈm i n i s
Maribel	m a ɾ i ˈb e l
tipaklong	t i p a k ˈl o ŋ
galagala	ɡ a l a ɡ a ˈl a
mangaliwa	m a ŋ a l i ˈw a ʔ
albakora	ʔ a l b a ˈk o ɾ a
lawaan	l a ˈw a ʔ a n
pulseras	p u l ˈs e ɾ a s
humiram	h u m i ˈɾ a m
bangketa	b a ŋ ˈk e t a
senyora	s e n ˈj o ɾ a
milenyal	m i ˈl e n j a l
ermat	ˈʔ e ɾ m a t
labong	l a ˈb o ŋ
kalyos	k a l ˈj o s
nais	ˈn a ʔ i s
Maniquiz	m a n i ˈk i s
Magcawas	m a ɡ ˈk a w a s
lugo	l u ˈɡ o
hanger	ˈh a ŋ e ɾ
luwad	l u ˈa d
Cadapan	k a ˈd a p a n
puna	p u ˈn a
gumuwapo	ɡ u m u ˈa p o
panday	p a n ˈd a j
tampalpuki	t a m p a l ˈp u k i
baway	ˈb a w a j
banggit	b a ŋ ˈɡ i t
ya	j a
kerosin	ˌk e ɾ o ˈs i n
siwang	ˈs i w a ŋ
atribido	ʔ a t ɾ i ˈb i d o
Manalo	m a ˈn a l o
kidsulid	k i d ˈs u l i d
makakanan	m a k a ˈk a n a n
simana	s i ˈm a n a
impormal	ʔ i m p o ɾ ˈm a l
matalik	m a ˈt a l i k
lesbiyana	l e s b i ˈa n a
lupog	l u ˈp o ɡ
gawin	ɡ a ˈw i n
binatilyo	b i n a ˈt i l j o
Banal	b a ˈn a l
Sicat	ˈs i k a t
dekwatin	ˈd e k w a t i n
dibdib	d i b ˈd i b
diko	ˈd i k o
lubid	ˈl u b i d
blusa	ˈb l u s a
ligamento	l i ɡ a ˈm e n t o
letsugas	l e ˈt͡ʃ u ɡ a s
Pinas	p i ˈn a s
Collado	k o l ˈj a d o
olats	ˈʔ o l a t s
Iloko	ʔ i ˈl o k o
Mayon	m a ˈj o n
Decena	d e ˈs e n a
Kuniko	k u ˈn i k o
Gabaldon	ɡ a b a l ˈd o n
dagasdas	d a ɡ a s ˈd a s
sabog	s a ˈb o ɡ
otel	ʔ o ˈt e l
Kapitan	k a p i ˈt a n
Medrano	m e d ˈɾ a n o
sila	s i ˈl a
palintong	p a l i n ˈt o ŋ
jabol	d͡ʒ a ˈb o l
Untalan	ʔ u n t a ˈl a n
pambansa	p a m b a n ˈs a ʔ
lampong	l a m ˈp o ŋ
wisik	w i ˈs i k
junakis	d͡ʒ u ˈn a k i s
pintor	p i n ˈt o ɾ
magbanda	m a ɡ ˈb a n d a
lupagi	l u p a ˈɡ i ʔ
sundot	s u n ˈd o t
dahop	d a ˈh o p
patolohiya	p a t o l o ˈh i a
kasera	k a ˈs e ɾ a
bini	ˈb i n i ʔ
paminggalan	ˌp a m i ŋ ˈɡ a l a n
sangat	ˈs a ŋ a t
magdaos	p a ɡ ˈd a ʔ o s
anghit	ʔ a ŋ ˈh i t
panghalip	p a ŋ h a ˈl i p
kitse	k i ˈt͡ʃ e
ligtas	l i ɡ ˈt a s
amin	ˈʔ a m i n
Candelaria	k a n d e ˈl a ɾ j a
tsitsa	ˈt͡ʃ i t͡ʃ a
umayos	ʔ u ˈm a j o s
magusot	m a ɡ u ˈs o t
dalawit	d a ˈl a w i t
nino	ˈn i n o
Biyer.	b i ˈe ɾ
lumbay	l u m ˈb a j
Sangandaan	s a ˌŋ a n d a ˈʔ a n
kulit	k u ˈl i t
Pamplona	p a m ˈp l o n a
paskuwa	ˈp a s k u a
hukay	ˈh u k a j
kusing	k u ˈs i ŋ
sibuyas	s i ˈb u j a s
sipol	ˈs i p o l
relohero	ɾ e l o ˈh e ɾ o
pirata	p i ˈɾ a t a
bumabahing	b u m a b a ˈh i ŋ
manamit	m a n a ˈm i t
punyeta	p u n ˈj e t a
Nobuhisa	n o b u ˈh i s a
tumoma	t u ˈm o m a ʔ
asa	ˈʔ a s a
magparami	m a ɡ p a ˈɾ a m i
babaero	b a b a ˈʔ e ɾ o
tumitingala	t u m i t i ŋ a ˈl a ʔ
ulunan	ʔ u l u ˈn a n
f	ˈʔ e f
banggerahan	b a ŋ ɡ e ɾ a ˈh a n
Peñaflorida	p e ɲ a f l o ˈɾ i d a
landa	l a n ˈd a
kabaretista	k a b a ɾ e ˈt i s t a
kunsumisyon	k u n s u m i s ˈj o n
nguso	ˈŋ u s o ʔ
korni	ˈk o ɾ n i
Mabato	m a b a ˈt o
ornitolohiya	ʔ o ɾ n i t o l o ˈh i a
hapis	ˈh a p i s
singkamas	s i ŋ k a ˈm a s
bahagi	b a ˈh a ɡ i ʔ
em	ʔ e m
padyak	p a d ˈj a k
seleksiyon	s e l e k s i ˈo n
magwagi	m a ɡ w a ˈɡ i ʔ
peste	ˈp e s t e
papagtalunan	ˌp a p a ɡ t a ˈl u n a n
Razon	ɾ a ˈz o n
administrasyon	ʔ a d m i n i s t ɾ a s ˈj o n
Albano	ʔ a l ˈb a n o
masaker	ˈm a s a k e ɾ
Majayjay	m a h a j ˈh a j
panlikod	p a n l i ˈk o d
salmo	ˈs a l m o
talindaw	t a l i n ˈd a w
sunuran	ˌs u ˈn u ɾ a n
kasulatan	k a s u l a ˈt a n
makatarungan	m a k a t a ˈɾ u ŋ a n
himagsik	h i m a ɡ ˈs i k
liko	l i ˈk o ʔ
lipa	l i ˈp a
bangaw	ˈb a ŋ a w
higante	h i ˈɡ a n t e
Damulag	d a ˈm u l a ɡ
Manalang	m a ˈn a l a ŋ
ayungin	ʔ a ˈj u ŋ i n
kabituinan	k a b i t u ʔ i ˈn a n
hatsing	h a ˈt͡ʃ i ŋ
imbudo	ʔ i m ˈb u d o
tulag	t u ˈl a ɡ
radyasyon	ɾ a d j a s ˈj o n
drama	ˈd ɾ a m a
iyelo	ʔ i ˈe l o
lamod	ˈl a m o d
gawan	ɡ a ˈw a n
pagsusunog	p a ɡ s u s u ˈn o ɡ
dyudo	ˈd j u d o
kumbulsiyon	k u m b u l s i ˈo n
arkitektura	ʔ a ɾ k i t e k ˈt u ɾ a
astinggal	ʔ a s t i ŋ ˈɡ a l
basbasan	b a s b a ˈs a n
suplada	s u p ˈl a d a
manananim	ˌm a n a n a ˈn i m
raan	ˈɾ a ʔ a n
kiyeme	k i ˈe m e
ugnay	ʔ u ɡ ˈn a j
kubo	ˈk u b o
ibigay	ʔ i b i ˈɡ a j
kursonada	k u ɾ s o ˈn a d a
libid	ˈl i b i d
maarte	m a ˈʔ a ɾ t e
unyonista	ʔ u n j o ˈn i s t a
Clemente	k l e ˈm e n t e
Esguerra	ʔ e s ˈɡ e r a
gulot	ɡ u ˈl o t
kausap	k a ˈʔ u s a p
primo	ˈp ɾ i m o
anasan	ˌʔ a ˈn a s a n
ragat	ˈɾ a ɡ a t
halayhay	h a l a j ˈh a j
balino	b a ˈl i n o
rehistrador	ɾ e h i s t ɾ a ˈd o ɾ
kartamoneda	k a ɾ t a m o ˈn e d a
Flora	ˈf l o ɾ a
albahaka	ʔ a l b a ˈh a k a
malambot	m a l a m ˈb o t
Kulas	k u ˈl a s
kongkreto	k o ŋ ˈk ɾ e t o
kawayanan	k a w a j a ˈn a n
hane	h a ˈn e
kyu	ˈk j u
uliuli	ʔ u l i ˈʔ u l i
ungkat	ʔ u ŋ ˈk a t
repleksiyon	ɾ e p l e k s i ˈo n
aakyat	ʔ a ʔ a k ˈj a t
tunggak	t u ŋ ˈɡ a k
Rebanal	ɾ e b a ˈn a l
tangay	t a ˈŋ a j
Kalantiaw	k a l a n ˈt j a w
Bernal	b e ɾ ˈn a l
kayumanis	k a j u ˈm a n i s
palakpakan	p a l a k ˈp a k a n
masilya	m a ˈs i l j a
duhambindahon	d u h a m b i n ˈd a h o n
papagtawanan	ˌp a p a ɡ t a w a ˈn a n
Pasamba	p a ˈs a m b a
tunggali	t u ŋ ˈɡ a l i ʔ
harapan	h a ɾ a ˈp a n
baat	b a ˈʔ a t
Triviño	t ɾ i ˈv i ɲ o
Maynila	m a j ˈn i l a ʔ
magkaaway	m a ɡ k a ˈʔ a w a j
lako	ˈl a k o ʔ
atim	ʔ a ˈt i m
suplete	s u p ˈl e t e
kuripot	k u ˈɾ i p o t
palapatik	p a l a ˈp a t i k
kuya	ˈk u j a
kaalit	k a ˈʔ a l i t
abelyana	ʔ a b e l ˈj a n a
J	d j e j
sakal	s a ˈk a l
Sin	ˈs i n
tumpa	t u m ˈp a
Rosete	ɾ o ˈs e t e
yukod	j u ˈk o d
bayna	ˈb a j n a
Mabulo	m a ˈb u l o
bagol	b a ˈɡ o l
kulayin	k u l a ˈj i n
kadiri	k a ˈd i ɾ i
bamos	b a ˈm o s
haka	ˈh a k a ʔ
balaglawas	b a l a ɡ ˈl a w a s
magbili	m a ɡ b i ˈl i
labanderiya	l a ˌb a n d e ˈɾ i a
sumite	s u m i ˈt e
Dulay	ˈd u l a j
Salcedo	s a l ˈs e d o
Sobrepeña	s o b ɾ e ˈp e ɲ a
tupak	t u ˈp a k
Weste	ˈw e s t e
lintik	l i n ˈt i k
kayat	ˈk a j a t
gamot	ɡ a ˈm o t
Mallare	m a l ˈj a ɾ e
walumpu	w a l u m ˈp u ʔ
Olaguer	ʔ o l a ˈɡ e ɾ
Guevarra	ɡ e ˈv a ɾ a
yeso	ˈj e s o
bisitahin	b i s i ˈt a h i n
gahasa	ɡ a ˈh a s a ʔ
yabangan	j a b a ˈŋ a n
alandahaw	ʔ a l a n ˈd a h a w
tatsihaan	t a t s i ˈh a ʔ a n
gumban	ɡ u m ˈb a n
nitrogliserina	n i t ɾ o ɡ l i s e ˈɾ i n a
demokrasya	d e m o ˈk ɾ a s j a
Urugway	ʔ u ɾ u ɡ ˈw a j
Elizaga	ʔ e l i ˈz a ɡ a
silidkulay	s i ˌl i d k u ˈl a j
hibang	h i ˈb a ŋ
bagnet	b a ɡ ˈn e t
mapuknat	m a p u k ˈn a t
Diamante	d j a ˈm a n t e
pano	ˈp a n o
manguna	m a ˈŋ u n a
Amelia	ʔ a ˈm i l j a
kisay	k i ˈs a j
pangmatanda	p a ŋ m a t a n ˈd a ʔ
Naomi	n a ˈj o w m i
holdap	ˈh o l d a p
hayop	ˈh a j o p
organista	ʔ o ɾ ɡ a ˈn i s t a
talas	ˈt a l a s
yakyak	j a k ˈj a k
maestra	m a ˈe s t ɾ a
personal	p e ɾ s o ˈn a l
Cariño	k a ˈɾ i ɲ o
tawge	ˈt a w ɡ e
meganon	ˌm e ɡ a ˈn o n
Carreon	k a ɾ e ˈo n
sinaing	s i ˈn a ʔ i ŋ
impluwensiya	ʔ i m p l u ˈe n s j a
nakabibingi	n a k a b i b i ˈŋ i
nakakabwisit	n a k a k a ˈb w i s i t
lupig	ˈl u p i ɡ
heranyo	h e ˈɾ a n j o
parusa	p a ˈɾ u s a
kamelyo	k a ˈm e l j o
aguho	ʔ a ˈɡ u h o ʔ
yatyat	j a t ˈj a t
Loo	ˈl u
tahong	t a ˈh o ŋ
Cenizal	s e n i ˈz a l
dilikas	d i l i ˈk a s
panaguri	p a n a ɡ u ˈɾ i ʔ
kupad	ˈk u p a d
bronse	ˈb ɾ o n s e
Ching	ˈt͡ʃ i ŋ
abolisyon	ʔ a b o l i s ˈj o n
koreo	k o ɾ e ˈo
kooperasyon	k o ʔ o p e ɾ a s ˈj o n
onlayn	ˈʔ o n l a j n
sanlibutan	s a n l i b u ˈt a n
Magbuhat	m a ɡ ˈb u h a t
korapsiyon	k o ɾ a p s i ˈo n
Katoliko	k a ˈt o l i k o
Pederio	p e ˈd e ɾ j o
Capili	k a ˈp i l i
sandugo	s a n d u ˈɡ o ʔ
aguha	ʔ a ˈɡ u h a
alinman	ʔ a l i n ˈm a n
sisante	s i ˈs a n t e
kapas	ˈk a p a s
radikalismo	ɾ a d i k a ˈl i s m o
tuldik	t u l ˈd i k
mananakay	m a n a ˈn a k a j
akin	ˈʔ a k i n
lara	ˈl a ɾ a ʔ
dinsulan	d i n ˈs u l a n
bugaw	ˈb u ɡ a w
banayad	b a ˈn a j a d
alisangsang	ʔ a l i s a ŋ ˈs a ŋ
lukso	l u k ˈs o
panananim	p a n a n a ˈn i m
ginto	ɡ i n ˈt o ʔ
gaya	ˈɡ a j a
agulo	ʔ a ˈɡ u l o
pindutan	p i n ˈd u t a n
puwas	p u ˈa s
prinsa	ˈp ɾ i n s a
Tayao	ˈt a j a w
lilipad	l i l i ˈp a d
saniban	s a ˈn i b a n
persigido	p e ɾ s i ˈɡ i d o
patid	p a ˈt i d
kasilyas	k a ˈs i l j a s
daluhaka	d a l u ˈh a k a ʔ
adhika	ʔ a d h i ˈk a ʔ
burak	ˈb u ɾ a k
Disyembre	d i s ˈj e m b ɾ e
pinansiyal	p i ˌn a n s i ˈa l
senador	s e n a ˈd o ɾ
tagiktik	t a ɡ i k ˈt i k
mambiktima	m a m ˈb i k t i m a
tinig	ˈt i n i ɡ
taliwakas	t a l i w a ˈk a s
nagbabaon	n a ɡ b a ˈb a ʔ o n
magiting	m a ˈɡ i t i ŋ
umusbong	ʔ u m u s ˈb o ŋ
singkad	s i ŋ ˈk a d
partisipasyon	p a ɾ t i s i p a s ˈj o n
kamakalawa	k a m a k a l a ˈw a
triduo	ˈt ɾ i d u ʔ o
gahol	ˈɡ a h o l
kubrekama	k u b ɾ e ˈk a m a
dinsol	d i n ˈs o l
GRO	ˈd j i ʔ a ɾ ʔ o
pabor	p a ˈb o ɾ
luwang	l u ˈa ŋ
mamilis	m a m i ˈl i s
panuntunan	p a n u n ˈt u n a n
g̃	ŋ
makipot	m a ˈk i p o t
manghawa	m a ŋ ˈh a w a
daspanin	ˈd a s p a n i n
talino	t a ˈl i n o
manipis	m a n i ˈp i s
yano	ˈj a n o
puwente	p u ˈe n t e
hukuman	h u ˈk u m a n
dumungaw	d u ˈm u ŋ a w
Juana	h u ˈa n a
rekluta	ɾ e k ˈl u t a
suklay	s u k ˈl a j
Danesa	d a ˈn e s a
kabaktan	k a b a k ˈt a n
Sarenas	s a ˈɾ e n a s
yangyang	j a ŋ ˈj a ŋ
inampalan	ʔ i n a m ˈp a l a n
wilik	ˈw i l i k
berdugo	b e ɾ ˈd u ɡ o
tabernakulo	t a b e ɾ ˌn a k u ˈl o
Pesigan	p e ˈs i ɡ a n
NAWASA	n a ˈw a s a
lumamig	l u m a ˈm i ɡ
trabahador	t ɾ a b a h a ˈd o ɾ
Coquia	ˈk o k j a
hapit	ˈh a p i t
dibdibin	d i b d i ˈb i n
tulos	ˈt u l o s
palagi	p a ˈl a ɡ i ʔ
Zafra	ˈz a f ɾ a
bubog	ˈb u b o ɡ
magulat	m a ˈɡ u l a t
kasero	k a ˈs e ɾ o
hapag	h a ˈp a ɡ
magugulo	m a ɡ u ɡ u ˈl o
sumingaw	s u m i ˈŋ a w
magbasanlot	m a ɡ b a s a n ˈl o t
palitada	p a l i ˈt a d a
balabal	b a ˈl a b a l
sintomas	ˈs i n t o m a s
Epipanya	ʔ e p i ˈp a n j a
lansang	l a n ˈs a ŋ
usong	ˈʔ u s o ŋ
restitusyon	ɾ e s t i t u s ˈj o n
paraluman	p a ɾ a ˈl u m a n
alusitha	ʔ a l u s i t ˈh a ʔ
aksiyon	ʔ a k s i ˈo n
sistema	s i s ˈt e m a
oryente	ʔ o ɾ ˈj e n t e
sadsad	s a d ˈs a d
aborsiyonista	ʔ a b o ɾ s i o ˈn i s t a
Bolbok	b o l ˈb o k
likot	l i ˈk o t
ipatapon	ʔ i p a ˈt a p o n
penitensiya	p e n i ˈt e n s j a
parlamentaryo	p a ɾ l a m e n ˈt a ɾ j o
tungki	t u ŋ ˈk i ʔ
dagos	ˈd a ɡ o s
sugapa	s u ˈɡ a p a ʔ
payamanin	p a j a ˈm a n i n
sapagkat	s a p a ɡ ˈk a t
dalubhayupan	d a ˌl u b h a ˈj u p a n
isapribado	ʔ i s a p ɾ i ˈb a d o
tawad	ˈt a w a d
sangkap	s a ŋ ˈk a p
lalagyan	l a l a ɡ ˈj a n
dami	ˈd a m i
Llanera	l j a ˈn e ɾ a
nagandahan	n a ɡ a n d a ˈh a n
Cabanatuan	k a b a n a ˈt u ʔ a n
balatik	b a l a ˈt i k
Sariaya	s a ɾ ˈj a j a
disposisyon	d i s p o s i s ˈj o n
Natanauan	n a t a ˈn a w a n
manman	m a n ˈm a n
panlinis	p a n ˈl i n i s
ibangsilyo	ʔ i b a ŋ ˈs i l j o
Ilokana	ʔ i l o ˈk a n a
tikang	t i ˈk a ŋ
amot	ˈʔ a m o t
Zosimo	ˈz o s i m o
nanghawa	n a ŋ ˈh a w a
kuwadrilyon	k u a d ɾ i l ˈj o n
maghimagsik	m a ɡ h i m a ɡ ˈs i k
mamolitika	m a m o ˈl i t i k a
salik	ˈs a l i k
nipis	n i ˈp i s
mahikaw	m a ˈh i k a w
ugali	ʔ u ˈɡ a l i ʔ
kadugo	k a d u ˈɡ o ʔ
repormista	ɾ e p o ɾ ˈm i s t a
kromosoma	k ɾ o m o ˈs o m a
maginaw	m a ɡ i ˈn a w
bigtihin	b i ɡ t i ˈh i n
Misamis	m i ˈs a m i s
agapay	ʔ a ˈɡ a p a j
tuso	ˈt u s o
halibhib	h a l i b ˈh i b
echas	ˈʔ e t͡ʃ a s
kinyang	k i n ˈj a ŋ
bigti	b i ɡ ˈt i
Romana	ɾ o ˈm a n a
Corro	ˈk o r o
sakate	s a ˈk a t e
inspektor	ʔ i n s p e k ˈt o ɾ
Fung	ˈf u ŋ
haligutgot	h a l i ɡ u t ˈɡ o t
sawil	s a ˈw i l
mamanhikan	m a m a n ˈh i k a n
sota	ˈs o t a
integral	ʔ i n t e ɡ ˈɾ a l
sumbong	s u m ˈb o ŋ
higa	h i ˈɡ a ʔ
magbilad	m a ɡ b i ˈl a d
bigotilyo	b i ɡ o ˈt i l j o
makikitid	m a k i ˈk i t i d
andaderas	ʔ a n d a ˈd e ɾ a s
alikabok	ʔ a l i k a ˈb o k
Hung	ˈh u ŋ
batubalani	b a t u b a ˈl a n i ʔ
giba	ɡ i ˈb a ʔ
liyabe	l i ˈa b e
humawak	h u ˈm a w a k
Aldover	ʔ a l d o ˈv e ɾ
lanunab	l a ˈn u n a b
iniina	ʔ i ˌn i ʔ i ˈn a
tenga	ˈt e ŋ a
magbabasa	m a ɡ b a b a ˈs a
literatura	l i t e ɾ a ˈt u ɾ a
mamutla	m a m u t ˈl a ʔ
hitik	h i ˈt i k
Dayang	ˈd a j a ŋ
disiotso	d i s i ˈʔ o t͡ʃ o
aplikasyon	ʔ a p l i k a s ˈj o n
sanib	ˈs a n i b
pantukoy	p a n ˈt u k o j
ladlad	l a d ˈl a d
sangal	s a ˈŋ a l
waley	w a ˈl e j
karbungkulo	k a ɾ ˈb u ŋ k u l o
telepatiya	t e l e p a ˈt i a
gitling	ɡ i t ˈl i ŋ
inggitero	ʔ i ŋ ɡ i ˈt e ɾ o
Negros	ˈn e ɡ ɾ o s
bertdey	ˈb e ɾ t d e j
kainin	k a ˈʔ i n i n
tugi	t u ˈɡ i ʔ
mabagyo	m a b a ɡ ˈj o
Isabang	ʔ i ˈs a b a ŋ
bulilyaso	b u l i l ˈj a s o
kalamismis	k a l a m i s ˈm i s
tiplas	t i p ˈl a s
Miraflores	m i ɾ a f ˈl o ɾ e s
tonta	ˈt o n t a
yangga	j a ŋ ˈɡ a ʔ
sagot	s a ˈɡ o t
Biring	b i ˈɾ i ŋ
guya	ˈɡ u j a ʔ
abnormalidad	ʔ a b n o ɾ m a l i ˈd a d
lagislis	l a ɡ i s ˈl i s
hibi	ˈh i b i
salig	ˈs a l i ɡ
humigit	h u m i ˈɡ i t
katarungan	k a t a ˈɾ u ŋ a n
Maloles	m a ˈl o l e s
Carandang	k a ɾ a n ˈd a ŋ
mabulaklak	m a b u l a k ˈl a k
Vigan	ˈv i ɡ a n
kuro	ˈk u ɾ o ʔ
tingni	t i ŋ ˈn i
pagakpak	p a ɡ a k ˈp a k
ateneo	ʔ a t e ˈn e o
timayok	t i ˈm a j o k
malabnaw	m a l a b ˈn a w
suriso	s u ˈɾ i s o
Karunungan	k a ɾ u ˈn u ŋ a n
magpaalam	m a ɡ p a ˈʔ a l a m
matibay	m a ˈt i b a j
palarindingan	p a l a ɾ i n ˈd i ŋ a n
Hau	ˈh a w
tagigapay	t a ɡ i ɡ a ˈp a j
tsitsaron	t͡ʃ i t͡ʃ a ˈɾ o n
Catibog	k a ˈt i b o ɡ
riyesgo	ɾ i ˈe s ɡ o
pangadyi	p a ŋ a d ˈj i ʔ
taniman	t a n i ˈm a n
endoso	ʔ e n ˈd o s o
yagong	ˈj a ɡ o ŋ
subalit	s u ˈb a l i t
patol	ˈp a t o l
upas	ˈʔ u p a s
siyopaw	s i ˈo p a w
inam	ˈʔ i n a m
kuliglig	k u l i ɡ ˈl i ɡ
rotonda	ɾ o ˈt o n d a
Malilay	m a ˈl i l a j
laspag	l a s ˈp a ɡ
labintador	l a b i n t a ˈd o ɾ
Aquino	ʔ a ˈk i n o
taliba	t a ˈl i b a ʔ
katalaghayan	k a t a l a ɡ h a ˈj a n
kilig	k i ˈl i ɡ
ipaayos	ʔ i p a ˈʔ a j o s
samakatwid	s a m a k a t ˈw i d
kartesyano	ˌk a ɾ t e s ˈj a n o
Haw	ˈh a w
lukto	l u k ˈt o ʔ
adhikain	ʔ a d h i ˈk a ʔ i n
inspeksiyon	ʔ i n s p e k s i ˈo n
butanding	b u t a n ˈd i ŋ
Marinduque	m a ɾ i n ˈd u k e
rebulto	ɾ e ˈb u l t o
manloloko	m a n l o ˈl o k o
Manaoag	m a ˈn a w a ɡ
deliryo	d e ˈl i ɾ j o
optimista	ʔ o p t i ˈm i s t a
inidoro	ʔ i n i ˈd o ɾ o
reengkarnasyon	ɾ e ʔ e ŋ k a ɾ n a s ˈj o n
deskumpiyado	d e s k u m p i ˈa d o
Michelena	m i t͡ʃ e ˈl e n a
maningil	m a n i ˈŋ i l
Leyson	ˈl e j s o n
pitsel	p i ˈt͡ʃ e l
binhi	b i n ˈh i ʔ
sinigurado	s i n i ɡ u ˈɾ a d o
humatsing	h u m a ˈt͡ʃ i ŋ
lumutang	l u ˈm u t a ŋ
mabunganga	m a b u ˈŋ a ŋ a ʔ
laguyo	l a ˈɡ u j o ʔ
iglesya	ʔ i ɡ ˈl e s j a
Hupiter	ˈh u p i t e ɾ
dehado	d e ˈh a d o
paliguan	ˈp a l i ɡ u ʔ a n
ikabilanggo	ʔ i k a b i l a ŋ ˈɡ o ʔ
sugadagitban	s u ɡ a d a ɡ i t ˈb a n
Bañaga	b a ˈɲ a ɡ a
Campo	ˈk a m p o
klinik	ˈk l i n i k
orinola	ʔ o ɾ i ˈn o l a
mainsekto	m a ʔ i n ˈs e k t o
malapot	m a ˈl a p o t
Libjo	l i b ˈh o ʔ
Alolod	ʔ a l o ˈl o d
pilit	p i ˈl i t
Kuwaresma	k u a ˈɾ e s m a
sapsuy	s a p ˈs u j
pakikiapid	p a k i k i ʔ a ˈp i d
tiktiko	t i k ˈt i k o ʔ
Hizon	ˈh i z o n
Kristiyano	k ɾ i s t i ˈa n o
linggatong	l i ŋ ˈɡ a t o ŋ
Gupit	ɡ u ˈp i t
sigwasan	s i ɡ ˈw a s a n
sabi	ˈs a b i
diso	d i ˈs o
naganap	n a ɡ a ˈn a p
Princess	ˈp ɾ i n s e s
butigan	b u t i ˈɡ a n
panadero	p a n a ˈd e ɾ o
ebak	ˈʔ e b a k
tako	ˈt a k o
mandadangkal	m a n d a d a ŋ ˈk a l
palya	p a l ˈj a
panrelihiyon	p a n ɾ e l i h i ˈo n
takoyaki	t a k o ˈj a k i
tate	t a ˈt e ʔ
mutya	m u t ˈj a ʔ
marites	ˈm a ɾ i t e s
kabukiran	k a b u ˈk i ɾ a n
balandra	b a ˈl a n d ɾ a
pamamahagi	p a m a m a ˈh a ɡ i ʔ
Garces	ˈɡ a ɾ s e s
sipon	s i ˈp o n
Elorde	ʔ e ˈl o ɾ d e
muok	m u ˈʔ o k
kordero	k o ɾ ˈd e ɾ o
maimot	m a ˈʔ i m o t
pantalon	p a n t a ˈl o n
kulaysukat	k u l a j ˈs u k a t
Yolanda	j o ˈl a n d a
peluka	p e ˈl u k a
yumamot	j u m a ˈm o t
organisado	ʔ o ɾ ɡ a n i ˈs a d o
apatita	ʔ a p a ˈt i t a
ipagsanggalang	ʔ i p a ɡ s a ŋ ɡ a ˈl a ŋ
puyat	ˈp u j a t
bilas	b i ˈl a s
warlahin	ˈw a ɾ l a h i n
bukana	b u ˈk a n a
sumpa	s u m ˈp a ʔ
Inglesero	ʔ i ŋ ɡ l e ˈs e ɾ o
binibini	b i n i ˈb i n i
dale	ˈd a l e
sus	ˈs u s
tsek	ˈt͡ʃ e k
kalo	ˈk a l o ʔ
sotanghon	ˈs o t a ŋ h o n
toniko	ˈt o n i k o
sidlan	s i d ˈl a n
soli	ˈs o l i ʔ
dalwa	d a l ˈw a
bagaso	b a ˈɡ a s o
palay	ˈp a l a j
Abelgas	ʔ a b e l ˈɡ a s
sebo	ˈs e b o
molave	m o ˈl a v e
luwag	l u ˈa ɡ
kolehiyo	k o ˈl e h i o
tahan	ˈt a h a n
idroheno	ʔ i ˈd ɾ o h e n o
ko	k o
echosera	ʔ e t͡ʃ o ˈs e ɾ a
Gumaca	ɡ u ˈm a k a
tsibog	t͡ʃ i ˈb o ɡ
barato	b a ˈɾ a t o
trosohan	t ɾ o s o ˈh a n
alternatibo	ʔ a l t e ɾ n a ˈt i b o
pilak	ˈp i l a k
hirol	ˈh i ɾ o l
ligo	ˈl i ɡ o ʔ
kalaswaan	k a l a s w a ˈʔ a n
rehente	ɾ e ˈh e n t e
pribilehiyo	p ɾ i b i ˈl e h i o
boksing	ˈb o k s i ŋ
abyog	ʔ a b ˈj o ɡ
seminaryo	s e m i ˈn a ɾ j o
Setsuko	s e t ˈs u k o
Piñon	p i ˈɲ o n
bulyos	b u l ˈj o s
Jasmine	ˈd͡ʒ a s m i n
salba	s a l ˈb a
taludtod	t a l u d ˈt o d
magdemanda	m a ɡ d e ˈm a n d a
lagundi	l a ɡ u n ˈd i ʔ
butot	b u ˈt o t
keri	ˈk e ɾ i
mabalang	m a ˈb a l a ŋ
pukyutan	p u k ˈj u t a n
nabubuwisit	n a b u b u ˈi s i t
balatong	b a ˈl a t o ŋ
milagro	m i ˈl a ɡ ɾ o
bagal	ˈb a ɡ a l
Heminis	ˈh e m i n i s
dabaw	ˈd a b a w
alog	ʔ a ˈl o ɡ
alilis	ʔ a l i ˈl i s
o	ˈʔ o
salsa	ˈs a l s a
Italyano	ʔ i t a l ˈj a n o
maputik	m a ˈp u t i k
Sarcia	ˈs a ɾ s j a
lamog	l a ˈm o ɡ
Ortea	ʔ o ɾ ˈt e a
balakyot	b a l a k ˈj o t
oslo	ˈʔ o s l o
apak	ˈʔ a p a k
kriket	ˈk ɾ i k e t
uranyo	ʔ u ˈɾ a n j o
Gubat	ˈɡ u b a t
Magallanes	m a ɡ a l ˈj a n e s
abain	ʔ a b a ˈʔ i n
gamusa	ɡ a ˈm u s a
megalomanya	m e ɡ a l o ˈm a n j a
David	ˈd e j v i d
talungtong	t a l u ŋ ˈt o ŋ
editoryal	ʔ e d i t o ɾ ˈj a l
abandonado	ʔ a b a n d o ˈn a d o
ateismo	ʔ a t e ˈi s m o
tanaw	t a ˈn a w
asido	ˈʔ a s i d o
budhi	b u d ˈh i ʔ
Pinagkaisahan	p i n a ɡ k a ʔ i s a ˈh a n
signo	ˈs i ɡ n o
Songco	ˈs o ŋ k o
tinapay	t i ˈn a p a j
tekwan	ˈt e k w a n
pasasalamat	p a s a s a ˈl a m a t
enagwas	ʔ e ˈn a ɡ w a s
Gerda	ˈɡ e ɾ d a
diyablo	d i ˈa b l o
buwa	b u ˈa ʔ
langal	l a ˈŋ a l
tinapa	t i n a ˈp a
dokumentaryo	d o k u m e n ˈt a ɾ j o
Alberto	ʔ a l ˈb e ɾ t o
kimona	k i ˈm o n a
sulatan	s u ˈl a t a n
banyo	ˈb a n j o
mansanas	m a n ˈs a n a s
istorbo	ʔ i s ˈt o ɾ b o
anakroniko	ʔ a n a k ˌɾ o n i ˈk o
mambabarang	ˌm a m b a ˈb a ɾ a ŋ
Lakan	l a ˈk a n
tonsura	t o n ˈs u ɾ a
balas	b a ˈl a s
magkasakit	m a ɡ k a s a ˈk i t
busilak	b u ˈs i l a k
agoy	ˈʔ a ɡ o j
reto	ˈɾ e t o
kulugo	k u l u ˈɡ o
yumanig	j u m a ˈn i ɡ
pasilidad	p a s i l i ˈd a d
hoy	ˈh o j
mayoldomo	m a j o l ˈd o m o
burol	b u ˈɾ o l
Manaois	m a ˈn a w i s
lona	ˈl o n a
upahan	ʔ u ˈp a h a n
mulinyari	m u l i n ˈj a ɾ i ʔ
santelmo	s a n ˈt e l m o
tagisuyo	t a ɡ i ˈs u j o ʔ
buwitre	b u ˈi t ɾ e
pasintabi	p a s i n ˈt a b i ʔ
hasain	h a ˈs a ʔ i n
baniaga	b a n ˈj a ɡ a ʔ
sagupa	s a ˈɡ u p a ʔ
hampol	h a m ˈp o l
bulakbol	b u l a k ˈb o l
tangina	t a ŋ i ˈn a
lungkag	l u ŋ ˈk a ɡ
pangkat	p a ŋ ˈk a t
sisihan	s i s i ˈh a n
Tayabense	t a j a ˈb e n s e
tribu	ˈt ɾ i b u
mga	m a ˈŋ a
arnibal	ʔ a ɾ ˈn i b a l
Irlandesa	ʔ i ɾ l a n ˈd e s a
paninindigan	p a n i n i n ˈd i ɡ a n
testamento	t e s t a ˈm e n t o
palanggana	p a l a ŋ ˈɡ a n a
tsikot	t͡ʃ i ˈk o t
dapal	ˈd a p a l
magarbo	m a ˈɡ a ɾ b o
kontrasenyas	k o n t ɾ a ˈs e n j a s
hipno	h i p ˈn o
magnate	m a ɡ ˈn a t e
ambisyon	ʔ a m b i s ˈj o n
Kiamzon	k i ˈa m s o n
guwatsinanggo	ɡ u a t͡ʃ i ˈn a ŋ ɡ o
Bulakan	b u l a ˈk a n
disaluyan	d i s a ˈl u j a n
Barbie	ˈb a ɾ b i
aswang	ʔ a s ˈw a ŋ
marmol	m a ɾ ˈm o l
kakosa	k a ˈk o s a
tagarito	t a ɡ a ˈɾ i t o
Lantican	l a n ˈt i k a n
depende	d e ˈp e n d e
ektarya	ʔ e k ˈt a ɾ j a
matipuno	m a t i ˈp u n o ʔ
eksorsismo	ʔ e k s o ɾ ˈs i s m o
pakikiramay	p a k i k i ˈɾ a m a j
talulot	t a ˈl u l o t
banas	b a ˈn a s
molestahin	m o ˌl e s t a ˈh i n
pagdaan	p a ɡ d a ˈʔ a n
bumagyo	b u m a ɡ ˈj o
Sandoval	s a n d o ˈv a l
lumabo	l u ˈm a b o ʔ
duwag	d u ˈa ɡ
hila	ˈh i l a
also	ˈʔ a l s o
ilap	ʔ i ˈl a p
tabi	t a ˈb i
tugya	t u ɡ ˈj a ʔ
radyo	ˈɾ a d j o
engrande	ʔ e ŋ ˈɡ ɾ a n d e
ragsak	ɾ a ɡ ˈs a k
empleyada	ʔ e m p l e ˈa d a
makina	ˈm a k i n a
hingalo	h i ŋ a ˈl o ʔ
tanggalin	t a ŋ ɡ a ˈl i n
bitak	b i ˈt a k
lusok	l u ˈs o k
kubtangkas	k u b t a ŋ ˈk a s
magbutas	m a ɡ b u ˈt a s
letson	l e ˈt͡ʃ o n
Pilipinismo	p i l i p i ˈn i s m o
bayag	b a ˈj a ɡ
sundong	s u n ˈd o ŋ
ahiya	ˈʔ a h i a
Aragon	ʔ a ɾ a ˈɡ o n
varyant	ˈv a ɾ j a n t
walwal	w a l ˈw a l
agos	ˈʔ a ɡ o s
mananayaw	m a n a ˈn a j a w
balansang	b a l a n ˈs a ŋ
hiwalay	h i w a ˈl a j
baligtad	b a l i ɡ ˈt a d
basagulero	b a s a ɡ u ˈl e ɾ o
Beneswela	b e n e s ˈw e l a
pandinig	p a n d i ˈn i ɡ
latay	ˈl a t a j
mahalin	m a h a ˈl i n
Nagtalon	n a ɡ ˈt a l o n
tuna	t u ˈn a ʔ
balam	ˈb a l a m
sutmondilaw	s u t ˌm o n d i ˈl a w
kapansanan	k a p a n ˈs a n a n
saktan	s a k ˈt a n
yumahod	j u ˈm a h o d
lugar	l u ˈɡ a ɾ
kali	k a ˈl i
kamakapuwo	k a m a k a ˈp u o ʔ
Chiyoko	t͡ʃ i ˈo k o
mangamote	m a ŋ a ˈm o t e
Manalaysay	m a n a l a j ˈs a j
dalya	ˈd a l j a
dekorasyon	d e k o ɾ a s ˈj o n
ilot	ʔ i ˈl o t
pagtutulungan	p a ɡ t u t u l u ˈŋ a n
tokneneng	t o k ˈn e n e ŋ
daplis	d a p ˈl i s
Salandanan	s a l a n ˈd a n a n
agkap	ʔ a ɡ ˈk a p
italiko	ʔ i ˈt a l i k o
bulo	b u ˈl o ʔ
Segui	ˈs e ɡ i
tikoy	ˈt i k o j
bisaklat	b i s a k ˈl a t
itapat	ʔ i t a ˈp a t
lugami	l u ɡ a ˈm i ʔ
pasma	p a s ˈm a
Libya	ˈl i b j a
kalangay	k a ˈl a ŋ a j
kumapal	k u m a ˈp a l
ganansiya	ɡ a ˈn a n s j a
rumupok	ɾ u m u ˈp o k
mawasak	m a ˈw a s a k
agnostiko	ʔ a ɡ ˈn o s t i k o
gatilyo	ɡ a ˈt i l j o
elegansiya	ʔ e l e ˈɡ a n s j a
konsentidora	k o n s e n t i ˈd o ɾ a
salaula	s a l a ˈʔ u l a ʔ
maano	m a ʔ a ˈn o
saya	s a ˈj a
Gallardo	ɡ a l ˈj a ɾ d o
sekreto	s e k ˈɾ e t o
Ricardo	ɾ i ˈk a ɾ d o
Asistio	ʔ a ˈs i s t j o
daloy	ˈd a l o j
ingklitik	ʔ i ŋ ˈk l i t i k
kahelada	k a h e ˈl a d a
Agapay	ʔ a ˈɡ a p a j
kulungan	ˌk u ˈl u ŋ a n
Eden	ʔ e ˈd e n
sulid	ˈs u l i d
kosta	ˈk o s t a
weder	ˈw e d e ɾ
estrikto	ʔ e s ˈt ɾ i k t o
awtorisasyon	ʔ a w t o ɾ i s a s ˈj o n
Andrade	ʔ a n ˈd ɾ a d e
bertebrado	b e ɾ t e b ˈɾ a d o
Cu	ˈk u
garbo	ˈɡ a ɾ b o
sulit	ˈs u l i t
birilidad	b i ɾ i l i ˈd a d
piyesa	p i ˈe s a
Javier	h a v i ˈe ɾ
dagusdos	d a ɡ u s ˈd o s
tilos	ˈt i l o s
pananamantala	p a n a n a m a n t a ˈl a
latundan	l a t u n ˈd a n
samaral	s a ˈm a ɾ a l
waray	w a ˈɾ a j
Clarence	ˈk l a ɾ e n s
bakuran	b a ˈk u ɾ a n
birtud	b i ɾ ˈt u d
nang	n a ŋ
Maunahan	m a ʔ u ˈn a h a n
Garcia	ɡ a ɾ ˈs i a
buyo	ˈb u j o
antala	ʔ a n ˈt a l a
kamya	ˈk a m j a
barko	b a ɾ ˈk o
jepoy	ˈd͡ʒ e p o j
kakanin	k a k a ˈn i n
sarsaparilya	s a ɾ s a p a ˈɾ i l j a
halimbawa	h a l i m ˈb a w a ʔ
Budista	b u ˈd i s t a
malaruhat	m a l a ˈɾ u h a t
Buhain	b u ˈh a ʔ i n
ramdam	ɾ a m ˈd a m
sabila	ˈs a b i l a
ampiyon	ʔ a m p i ˈo n
laping	l a ˈp i ŋ
hagkan	h a ɡ ˈk a n
kaban	k a ˈb a n
eto	ˈʔ e t o
tsismis	ˈt͡ʃ i s m i s
bira	b i ˈɾ a
antot	ʔ a n ˈt o t
pangangailangan	p a ŋ a ŋ a ʔ i ˈl a ŋ a n
Biyernes	b i ˈe ɾ n e s
dapithapon	ˌd a p i t ˈh a p o n
layaw	ˈl a j a w
pulupito	p u ˈl u p i t o
habonero	h a b o ˈn e ɾ o
taimtim	t a ʔ i m ˈt i m
maanggo	m a ʔ a ŋ ˈɡ o
z	z i
hangad	h a ˈŋ a d
hindi	h i n ˈd i ʔ
matatauhan	m a t a t a ˈʔ u h a n
obserba	ʔ o b s e ɾ ˈb a
despedida	d e s p e ˈd i d a
ipakita	ʔ i p a ˈk i t a
Basallote	b a s a l ˈj o t e
pagerper	ˌp a ˈɡ e ɾ p e ɾ
manirahan	m a n i ˈɾ a h a n
iset	ʔ i ˈs e t
ikalabingwalo	ʔ i k a l a ˌb i ŋ w a ˈl o
Babao	ˈb a b a w
irebisa	ʔ i ɾ e b i ˈs a
Ormoc	ʔ o ɾ ˈm o k
melokoton	m e l o k o ˈt o n
tambakol	t a m ˈb a k o l
madrasta	m a d ˈɾ a s t a
Summer	ˈs a m e ɾ
palpak	p a l ˈp a k
maghari	m a ɡ ˈh a ɾ i ʔ
pumatay	p u m a ˈt a j
bakli	b a k ˈl i ʔ
kurus	k u ˈɾ u s
haj	ˈh a d͡ʒ
Marulas	m a ɾ u ˈl a s
Opeña	ʔ o ˈp e ɲ a
pula	p u ˈl a
Marte	ˈm a ɾ t e
panwelo	p a n ˈw e l o
Luzviminda	l u z v i ˈm i n d a
punla	p u n ˈl a ʔ
matiyaga	m a t j a ˈɡ a ʔ
Abulencia	ʔ a b u ˈl e n s j a
Olanda	ʔ o ˈl a n d a
balasto	b a ˈl a s t o
lisa	l i ˈs a ʔ
Catapang	k a ˈt a p a ŋ
opresyon	ʔ o p ɾ e s ˈj o n
diskuwento	d i s k u ˈe n t o
ikit	ˈʔ i k i t
pagkakaisa	p a ɡ k a k a ʔ i ˈs a
eksibisyon	ʔ e k s i b i s ˈj o n
balbakwa	b a l b a k ˈw a
himay	h i ˈm a j
samat	ˈs a m a t
empleado	ʔ e m p l e ˈa d o
kaldero	k a l ˈd e ɾ o
fotobam	ˈf o t o b a m
umawit	ʔ u ˈm a w i t
pagalingin	p a ɡ a l i ˈŋ i n
sentido	s e n ˈt i d o
piskalya	p i s k a l ˈj a
kaliko	k a ˈl i k o
Lubiano	l u b ˈj a n o
pamahalaan	ˌp a m a h a l a ˈʔ a n
kusin	k u ˈs i n
taglamig	t a ɡ l a ˈm i ɡ
antok	ʔ a n ˈt o k
ostiya	ˈʔ o s t j a
Alabang	ʔ a l a ˈb a ŋ
elye	ˈʔ e l j e
apula	ʔ a ˈp u l a ʔ
sakramento	s a k ɾ a ˈm e n t o
importante	ʔ i m p o ɾ ˈt a n t e
salaan	s a l a ˈʔ a n
malalakas	m a l a l a ˈk a s
oeste	ʔ o ˈe s t e
ukab	ˈʔ u k a b
nagkukuwento	n a ɡ k u k u ˈe n t o
Melchor	m e l ˈt͡ʃ o ɾ
kondo	ˈk o n d o
Aprika	ˈʔ a p ɾ i k a
kolado	k o ˈl a d o
Siam	s i ˈa m
umaakyat	ʔ u m a ʔ a k ˈj a t
Indotsina	ʔ i n d o ˈt͡ʃ i n a
alangilan	ʔ a l a ˈŋ i l a n
Acuña	ʔ a ˈk u ɲ a
chaka	t͡ʃ a ˈk a ʔ
pangyari	p a ŋ ˈj a ɾ i
mangopya	m a ˈŋ o p j a
talunton	t a l u n ˈt o n
lanting	l a n ˈt i ŋ
bansalagin	b a n s a l a ˈɡ i n
biskuwit	b i s k u ˈi t
pambata	p a m ˈb a t a
insulares	ʔ i n s u ˈl a ɾ e s
Netoy	ˈn e t o j
bilo	b i ˈl o
pispis	p i s ˈp i s
matindi	m a t i n ˈd i
kalma	ˈk a l m a
aduwana	ʔ a d u ˈa n a
tumulong	t u ˈm u l o ŋ
samaya	s a m a ˈj a ʔ
Kaye	k e j
parinlas	p a ˈɾ i n l a s
senado	s e ˈn a d o
bibingka	b i ˈb i ŋ k a
espongha	ʔ e s ˈp o ŋ h a
bakong	ˈb a k o ŋ
iskandalo	ʔ i s ˈk a n d a l o
Yasmin	ˈj a s m i n
mangailangan	m a ŋ a ʔ i ˈl a ŋ a n
sipat	ˈs i p a t
Lo	ˈl o
denggoy	ˈd e ŋ ɡ o j
hinga	h i ˈŋ a
bungaw	b u ˈŋ a w
kaliitan	k a l i ʔ i ˈt a n
nananamantala	n a n a n a m a n t a ˈl a
gariya	ɡ a ˈɾ i a ʔ
deretso	d e ˈɾ e t͡ʃ o
ngipin	ˈŋ i p i n
oranggutan	ʔ o ˈɾ a ŋ ɡ u t a n
soberaniya	s o b e ɾ a ˈn i a
trabahadora	t ɾ a b a h a ˈd o ɾ a
Kurita	k u ˈɾ i t a
bumagal	b u ˈm a ɡ a l
tabas	ˈt a b a s
sino	ˈs i n o
Katipunan	k a t i ˈp u n a n
yumakap	j u ˈm a k a p
lugal	l u ˈɡ a l
senakulo	s e ˈn a k u l o
gayumpaman	ɡ a ˌj u m p a ˈm a n
maso	ˈm a s o
aruskaldo	ʔ a ɾ u s ˈk a l d o
ikalawa	ʔ i k a l a ˈw a
peymuth	ˈp e j m u θ
asiwa	ʔ a s i ˈw a ʔ
kingke	k i ŋ ˈk e
bakawan	b a ˈk a w a n
kupal	ˈk u p a l
Kuya	ˈk u j a
parokyano	p a ɾ o k ˈj a n o
mutsatso	m u ˈt͡ʃ a t͡ʃ o
halata	h a l a ˈt a ʔ
pamilyaridad	p a m i l j a ɾ i ˈd a d
yumi	ˈj u m i ʔ
Nagcarlan	n a ɡ k a ɾ ˈl a n
Kaprikorniyo	k a p ɾ i ˈk o ɾ n j o
hagap	ˈh a ɡ a p
kuminoy	k u m i ˈn o j
alugin	ʔ a l u ˈɡ i n
Aliga	ʔ a ˈl i ɡ a
gagi	ˈɡ a ɡ i ʔ
pusakal	p u s a ˈk a l
lunaw	l u ˈn a w
maghalabos	m a ɡ h a l a ˈb o s
cno	ˈs i n o
Betty	ˈb e t i
Guerra	ˈɡ e ɾ a
Carunungan	k a ɾ u ˈn u ŋ a n
relasyon	ɾ e l a s ˈj o n
Ferrol	f e ˈɾ o l
permiso	p e ɾ ˈm i s o
wangwang	ˈw a ŋ w a ŋ
seks	ˈs e k s
peram	ˈp e ɾ a m
patnugot	p a t ˈn u ɡ o t
Leyte	ˈl e j t e
hain	ˈh a ʔ i n
tagiliran	t a ɡ i ˈl i ɾ a n
pilyo	ˈp i l j o
kristo	ˈk ɾ i s t o
Cobarrubias	k o b a ˈɾ u b j a s
Samar	ˈs a m a ɾ
Escueta	ʔ e s k u ˈe t a
tol	ˈt o l
langhap	l a ŋ ˈh a p
liing	l i ˈʔ i ŋ
haltak	h a l ˈt a k
lamat	ˈl a m a t
manood	m a n o ˈʔ o d
kana	k a ˈn a ʔ
semantika	s e ˌm a n t i ˈk a
putok	p u ˈt o k
sangkatauhan	s a ŋ k a t a ˈʔ u h a n
Nuevo	n u ˈe v o
madagta	m a d a ɡ ˈt a ʔ
pagkasuplado	p a ɡ k a s u p ˈl a d o
pumanig	p u ˈm a n i ɡ
pasulo	p a ˈs u l o
brodkast	ˈb ɾ o d k a s t
ipadala	ʔ i p a d a ˈl a
haspe	h a s ˈp e
selestiyal	s e l e s t i ˈa l
Kumiko	k u ˈm i k o
kalihim	k a ˈl i h i m
dagitban	d a ɡ i t ˈb a n
tonelada	t o n e ˈl a d a
tsarter	ˈt͡ʃ a ɾ t e ɾ
katha	k a t ˈh a ʔ
maaari	m a ʔ a ˈʔ a ɾ i ʔ
akap	ˈʔ a k a p
bilangguan	b i l a ŋ ˈɡ u ʔ a n
ubo	ʔ u ˈb o
hinguto	h i ˈŋ u t o
manunula	m a n u n u ˈl a ʔ
tambanggalan	t a m b a ŋ ɡ a ˈl a n
balbon	b a l ˈb o n
pastilyas	p a s ˈt i l j a s
kalsiyo	ˈk a l s j o
bungangera	b u ŋ a ˈŋ e ɾ a
letmaku	ˈl e t m a k u
maburol	ˌm a ˈb u ɾ o l
suki	ˈs u k i ʔ
kutsada	k u ˈt͡ʃ a d a
ibahaw	ʔ i ˈb a h a w
hikmat	h i k ˈm a t
mapanira	m a p a ˈn i ɾ a ʔ
mahinhin	m a h i n ˈh i n
Hesus	h e ˈs u s
dantaon	d a n t a ˈʔ o n
anggulo	ˈʔ a ŋ ɡ u l o
kabulagsakan	k a b u l a ɡ s a ˈk a n
mulinilyo	m u l i ˈn i l j o
diyaryo	d i ˈa ɾ j o
talibas	t a l i ˈb a s
maako	m a ʔ a ˈk o
panggang	p a ŋ ˈɡ a ŋ
bayawak	b a ˈj a w a k
Pedregal	p e d ɾ e ˈɡ a l
Ticzon	ˈt i k s o n
Binubusan	b i n u ˈb u s a n
pondohan	p o n d o ˈh a n
ligat	ˈl i ɡ a t
masaktan	m a s a k ˈt a n
Inocencio	ʔ i n o ˈs e n s j o
Valmores	v a l ˈm o ɾ e s
Jaruda	h a ˈɾ u d a
So	ˈs o
lunsod	l u n ˈs o d
balda	b a l ˈd a
repriherador	ɾ e p ɾ i h e ɾ a ˈd o ɾ
Banayad	b a ˈn a j a d
lalaki	l a ˈl a k i
tikling	t i k ˈl i ŋ
Sabado	ˈs a b a d o
bunggabilya	b u ŋ ɡ a ˈb i l j a
kelan	ˈk e l a n
Dazo	ˈd a z o
sidhi	s i d ˈh i ʔ
Hayag	ˈh a j a ɡ
Espinoza	ʔ e s p i ˈn o z a
sagimuymoy	s a ɡ i m u j ˈm o j
uso	ˈʔ u s o
buryong	b u ɾ ˈj o ŋ
pananawagan	p a n a n a ˈw a ɡ a n
dolar	ˈd o l a ɾ
pampubliko	p a m ˈp u b l i k o
mama	ˈm a m a ʔ
biyopisika	b i o ˈp i s i k a
sodiyako	s o ˈd i a k o
pagkabata	p a ɡ k a ˈb a t a ʔ
iringan	ʔ i ˈɾ i ŋ a n
golp	ˈɡ o l p
tagulamin	t a ɡ u l a ˈm i n
garapata	ɡ a ɾ a ˈp a t a
Ho	ˈh o
Bajado	b a ˈh a d o
himagas	h i ˈm a ɡ a s
lisan	ˈl i s a n
magpaskil	m a ɡ p a s ˈk i l
orihinal	ʔ o ɾ i h i ˈn a l
kotamaya	k o t a ˈm a j a
Camantigue	k a m a n t i ˈɡ e
rehas	ˈɾ e h a s
paglilitis	p a ɡ l i ˈl i t i s
sinulid	s i ˈn u l i d
hupot	h u ˈp o t
tipuno	t i ˈp u n o ʔ
ayon	ˈʔ a j o n
Encarnacion	ʔ e n k a ɾ n a s ˈj o n
Soliven	s o l i ˈv e n
saranggola	s a ɾ a ŋ ˈɡ o l a
matwiran	m a t ˈw i ɾ a n
Awstralya	ʔ a w s ˈt ɾ a l j a
Quimson	ˈk i m s o n
taling	ˈt a l i ŋ
lakbay	l a k ˈb a j
tolerable	t o l e ˈɾ a b l e
