حنفي	ħ a n a f i j j
رفأ	r a f a ʔ a
مقطعية	m a q tˤ a ʕ i j j a
جبت	d͡ʒ i b t
عمة	ʕ a m m a
ريال	r i j aː l
أنواط	ʔ a n w aː tˤ
عمروسة	ʕ a m r uː s a
ركيزة	r a k iː z a
وجيز	w a d͡ʒ iː z
منذ	m u n ð u
أكسيد	ʔ u k s iː d
خرنق	x i r n i q
تمرين	t a m r iː n
طار	tˤ aː r a
ذبابة	ð u b aː b a
إمضاء	ʔ i m dˤ aː ʔ
مأزق	m a ʔ z i q
اكتحل	i k t a ħ a l a
أباس	ʔ u b aː s
أنيون	ʔ a n j uː n
بحاح	b u ħ aː ħ
مثلث	m u θ a l l a θ
سبج	s a b a d͡ʒ
صئم	sˤ a ʔ i m a
أجوف	ʔ a d͡ʒ w a f
عنبروت	ʕ a n b a r uː t
أنطاكية	ʔ a n tˤ aː k i j a
تدرج	t a d a r r a d͡ʒ a
الكويت	a l k u w a j t
شاي	ʃ aː j
دمية	d u m j a
ناهز	n aː h a z a
براعة	b a r aː ʕ a
أنفق	ʔ a n f a q a
أغلب	ʔ a ɣ l a b
فسيفساء	f u s a j f i s aː ʔ
حامض	ħ aː m i dˤ
دائخ	d aː ʔ i x
ضحية	dˤ a ħ i j j a
حذار	ħ a ð aː r i
ودامون	w a d aː m uː n
قستوس	q i s t uː s
حوض	ħ a w dˤ
مايو	m aː j uː
سلاف	s u l aː f
صبابة	sˤ a b aː b a
قنديد	q i n d iː d
رمس	r a m a s
حاء	ħ aː ʔ
تترى	t a t r aː
مستوقد	m u s t a w q a d
أنتيكخانة	ʔ a n t iː k x aː n a
مخلوقات	m a x l uː q aː t
قيتارة	q iː t aː r a
اختلاس	i x t i l aː s
غزير	ɣ a z iː r
أوج	ʔ a w d͡ʒ
أصحى	ʔ a sˤ ħ aː
تراخوما	t a r aː x uː m aː
تلقاء	t i l q aː ʔ a
إفادة	ʔ i f aː d a
أوعية	ʔ a w ʕ i j a
خنزير	x i n z iː r
ملاحقة	m u l aː ħ a q a
مصبنة	m a sˤ b a n a
أسفر	ʔ a s f a r a
مطواة	m i tˤ w aː h
إزعاج	ʔ i z ʕ aː d͡ʒ
بادية	b aː d i j a
متوسط	m u t a w a s s i tˤ
أطلع	ʔ a tˤ l a ʕ a
روسيا	r uː s i j aː
مشرك	m u ʃ r i k
شارع	ʃ aː r i ʕ
أولياء	ʔ a w l i j aː ʔ
لبأ	l i b a ʔ
ثكل	θ a k i l a
أصطرك	ʔ a sˤ tˤ a r a k
مرجع	m a r d͡ʒ i ʕ
شرب	ʃ a r i b a
جندبادستر	d͡ʒ u n d u b aː d a s t a r
هوادة	h a w aː d a
إقنيز	ʔ i q n iː z
آتون	ʔ aː t uː n
بلغمي	b a l ɣ a m i j j
شهلة	ʃ a h l a
صحراوي	sˤ a ħ r aː w i j j
بلعوم	b u l ʕ uː m
مروض	m u r a w w a dˤ
ناي	n aː j
وضوء	w u dˤ uː ʔ
تلغراف	t a l i ɣ r aː f
كلك	k a l a k
إنتاج	ʔ i n t aː d͡ʒ
نسى	n a s s aː
قاض	q aː dˤ a
حاط	ħ aː tˤ a
إسماعيلي	ʔ i s m aː ʕ iː l i j j
مجري	m a d͡ʒ a r i j j
نبات	n a b aː t
كيول	k a j j uː l
قولنج	q a w l a n d͡ʒ
سفرجلة	s a f a r d͡ʒ a l a
مقلق	m u q l i q
هدى	h a d aː
مهندس	m u h a n d i s
نعناع	n a ʕ n aː ʕ
مسيح	m a s iː ħ
ثيوقراطي	θ i j uː q r aː tˤ i j j
قالب	q aː l a b
مسلسل	m u s a l s a l
دفتر	d a f t a r
يعقوب	j a ʕ q uː b
فاتية	f aː t i j a
توضح	t a w a dˤ dˤ a ħ a
نزلة	n a z l a
أنزع	ʔ a n z a ʕ a
شاهد	ʃ aː h a d a
اشترى	i ʃ t a r aː
صاع	sˤ aː ʕ
بعلة	b a ʕ l a
سقيفة	s a q iː f a
محب	m u ħ a b b
انتظم	i n t a ðˤ a m a
بسبب	b i s a b a b i
ماثل	m aː θ a l a
ثانوي	θ aː n a w i
إجاص	ʔ i d͡ʒ d͡ʒ aː sˤ
هواء	h a w aː ʔ
لهجة	l a h d͡ʒ a
صيدلي	sˤ a j d a l i j j
إبراهيم	ʔ i b r aː h iː m
شماس	ʃ a m m aː s
تعصر	t a ʕ a sˤ sˤ a r a
ناصور	n aː sˤ uː r
رضة	r a dˤ dˤ a
نصراني	n a sˤ r aː n i j j
لله	l i l l aː h
فرغ	f a r a ɣ a
غالب	ɣ aː l i b
بقبق	b a q b a q a
كارة	k aː r a
ميزان	m iː z aː n
خلاط	x i l aː tˤ
نون	n a w w a n a
نظير	n a ðˤ iː r
سلاح	s i l aː ħ
عربية	ʕ a r a b i j j a
تخلص	t a x a l l a sˤ a
بندر	b a n d a r
عادات	ʕ aː d aː t
شعر	ʃ a ʕ a r
سفينة	s a f iː n a
أسطرلاب	ʔ a s tˤ u r l aː b
الصربية	a sˤ sˤ i r b i j j a
أعياد	ʔ a ʕ j aː d
نخلة	n a x l a
شابانج	ʃ aː b aː n a d͡ʒ
رام	r aː m a
سلسلة	s i l s i l a
طومار	tˤ uː m aː r
أقضى	ʔ a q dˤ aː
شلح	ʃ a l a ħ a
تعصب	t a ʕ a sˤ sˤ a b a
عانى	ʕ aː n aː
غيظ	ɣ a j ðˤ
ترنج	t r i n d͡ʒ
قلعي	q a l a ʕ i j j
تكويت	t a k w iː t
تعالم	t a ʕ aː l a m a
جذع	d͡ʒ a ð a ʕ
دشمة	d u ʃ m a
ذاق	ð aː q a
شلباية	ʃ i l b aː j a
عيدية	ʕ iː d i j j a
نظر	n a ðˤ a r
إحاطة	ʔ i ħ aː tˤ a
متسول	m u t a s a w w i l
بلل	b a l a l
معهد	m a ʕ h a d
قرد	q a r d
سورة	s a w r a
اغرورق	i ɣ r a w r a q a
قارورة	q aː r uː r a
أناخ	ʔ a n aː x a
تقدد	t a q a d d a d a
ميمنة	m a j m a n a
ممتلئ	m u m t a l i ʔ
ساعد	s aː ʕ a d a
قابل	q aː b a l a
كرك	k u r k
شجو	ʃ a d͡ʒ w
تجارة	t i d͡ʒ aː r a
إباحية	ʔ i b aː ħ i j j a
إطراء	ʔ i tˤ r aː ʔ
علة	ʕ i l l a
لوياثان	l a w i j aː θ aː n
رادود	r aː d uː d
طابعة	tˤ aː b i ʕ a
صالح	sˤ aː l i ħ
دستور	d u s t uː r
إسكتلندي	ʔ i s k u t l a n d i j j
رونق	r a w n a q
بدنة	b a d a n a
أرجان	ʔ a r d͡ʒ aː n
مشعر	m a ʃ ʕ a r
وقاء	w i q aː ʔ
فجل	f a d͡ʒ a l
مرفوع	m a r f uː ʕ
وجهة	w i d͡ʒ h a
كذين	k u ð iː n
استفتى	i s t a f t aː
صادف	sˤ aː d a f a
لعنة	l a ʕ n a
مجرب	m u d͡ʒ a r r i b
ساوم	s aː w a m a
دونمة	d uː n m a
انتماء	i n t i m aː ʔ
شبوط	ʃ a b b uː tˤ
ملاك	m u l l aː k
فضي	f i dˤ dˤ i j j
أغماد	ʔ a ɣ m aː d
حجر	ħ a d͡ʒ a r
هوتة	h a w t a
ثانية	θ aː n i j a
مسد	m a s a d a
سعادة	s a ʕ aː d a
حزمة	ħ u z m a
تسلم	t a s a l l a m a
بساطة	b a s aː tˤ a
أنبوب	ʔ u n b uː b
بهشية	b a h a ʃ i j j a
سادس	s aː d i s
بلغم	b a l ɣ a m
سمك	s a m a k
صاخب	sˤ aː x i b
سخيف	s a x iː f
كوريا	k uː r i j aː
أفلس	ʔ a f l a s a
برعم	b a r ʕ a m a
ليمي	l a j m i j j
عقاري	ʕ a q aː r i j j
بيفام	b iː f aː m
نموذج	n a m uː ð a d͡ʒ
أيل	ʔ a j j a l
مسلم	m u s a l l a m
هجوم	h u d͡ʒ uː m
فاء	f aː ʔ
ريشة	r iː ʃ a
بوذي	b uː ð i j j
همجي	h a m a d͡ʒ i j j
تفاف	t i f aː f
إغناطيوس	ʔ i ɣ n aː tˤ i j uː s
أوراق	ʔ a w r aː q
أفاويه	ʔ a f aː w iː h
عصيب	ʕ a sˤ iː b
سكرجة	s u k r u d͡ʒ a
ماه	m aː h a
أنوق	ʔ a n uː q
اجتماع	i d͡ʒ t i m aː ʕ
عنق	ʕ a n a q
قيصر	q a j sˤ a r
كتلة	k u t l a
رهط	r a h a tˤ a
ذئبة	ð i ʔ b a
كزبرة	k u z b a r a
رغوة	r a ɣ w a
مغنم	m a ɣ n a m
أجنبي	ʔ a d͡ʒ n a b i j j
مغيم	m u ɣ a j j i m
ظفر	ðˤ a f a r
زرنب	z a r n a b
قتبان	q a t a b aː n
وديعة	w a d iː ʕ a
طلح	tˤ a l ħ
تغريدة	t a ɣ r iː d a
واقعي	w aː q i ʕ i j j
بعثي	b a ʕ θ i j j
بكارج	b a k aː r i d͡ʒ
باكستاني	b aː k i s t aː n i j j
بنجنكشت	b a n d͡ʒ a n k u ʃ t
قومية	q a w m i j j a
طنجيرة	tˤ a n d͡ʒ iː r a
منور	m a n w a r
مرحلة	m a r ħ a l a
اختلف	i x t a l a f a
منتصف	m u n t a sˤ a f
أيون	ʔ a j uː n
طريق	tˤ a r iː q
الأحد	a l ʔ a ħ a d
مطران	m a tˤ r aː n
معاوية	m u ʕ aː w i j a
دحرج	d a ħ r a d͡ʒ a
أمسك	ʔ a m s a k a
ضيق	dˤ a j j a q a
دورة	d a w r a
قاقلة	q aː q i l l a
طبقة	tˤ a b a q a
هالوك	h aː l uː k
اتضح	i t t a dˤ a ħ a
طلعة	tˤ a l ʕ a
بسالة	b a s aː l a
سؤدد	s u ʔ d a d
قرصنة	q a r sˤ a n a
روس	r a w w a s a
شلة	ʃ a l l a
سيخية	s iː x i j j a
كازخستان	k aː z a x i s t aː n
عفوي	ʕ a f w i j j
راع	r aː ʕ a
عرنسية	ʕ a r a n s i j j a
مدغشقر	m a d a ɣ a ʃ q a r
عودة	ʕ a w d a
دنو	d u n u w w
صأصأ	sˤ a ʔ sˤ a ʔ a
أسير	ʔ a s iː r
محارب	m u ħ aː r i b
واطن	w aː tˤ a n a
نذير	n a ð iː r
صندوق	sˤ a n d uː q
أكتوبر	ʔ a k t uː b a r
سهر	s a h i r a
قطيع	q a tˤ iː ʕ
رضى	r u dˤ aː
زعتر	z a ʕ t a r
معدن	m a ʕ d i n
مكة	m a k k a
طبشورة	tˤ a b ʃ uː r a
جمال	d͡ʒ a m aː l
نبهاء	n u b a h aː ʔ
ضواحك	dˤ a w aː ħ i k
إبرة	ʔ i b r a
رطانة	r a tˤ aː n a
حيوان	ħ a j a w aː n
كركند	k a r k a n d
محسن	m u ħ a s s a n
جشاء	d͡ʒ u ʃ aː ʔ
خصوص	x u sˤ uː sˤ
رجب	r a d͡ʒ a b
متفجرات	m u t a f a d͡ʒ d͡ʒ i r aː t
فاتر	f aː t i r
أصأب	ʔ a sˤ ʔ a b a
تشيلي	t ʃ iː l i j j
فقري	f i q r i j j
ذكاء	ð a k aː ʔ
بيلادونا	b iː l aː d uː n aː
مفلفل	m u f a l f a l
تبرير	t a b r iː r
قريدس	q u r a j d i s
قيتار	q iː t aː r
سبلة	s a b l a
ضوى	dˤ a w aː
بواب	b a w w aː b
إحارة	ʔ i ħ aː r a
ماسورة	m aː s uː r a
كراج	k a r aː d͡ʒ
ابتهاج	i b t i h aː d͡ʒ
تجاوزات	t a d͡ʒ aː w u z aː t
طيفورية	tˤ a j f uː r i j j a
رباعيات	r u b aː ʕ i j j aː t
أباجور	ʔ a b aː d͡ʒ uː r
أغرى	ʔ a ɣ r aː
مؤسسة	m u ʔ a s s a s a
انجذاب	i n d͡ʒ i ð aː b
كميت	k u m a j t
زنباع	z a n b aː ʕ
كنار	k a n aː r
أزرع	ʔ a z r a ʕ a
دمنة	d i m n a
أدوية	ʔ a d w i j a
عمى	ʕ a m m aː
عطاس	ʕ u tˤ aː s
جائز	d͡ʒ aː ʔ i z
نائم	n aː ʔ i m
فصد	f a sˤ a d a
بناية	b i n aː j a
بوذا	b uː ð aː
القرآن	a l q u r ʔ aː n
شلكاية	ʃ a l a k aː j a
ظربان	ðˤ a r i b aː n
شمام	ʃ a m m aː m
ويكيبيديا	w iː k iː b iː d i j aː
يلب	j a l a b
قذال	q a ð aː l
حاسم	ħ aː s i m
قاطعة	q aː tˤ i ʕ a
معادلة	m u ʕ aː d a l a
نجدة	n a d͡ʒ d a
افتراع	i f t i r aː ʕ
حدق	ħ a d a q a
أطرش	ʔ a tˤ r a ʃ
تدلى	t a d a l l aː
هاتف	h aː t i f
سبتمبر	s a b t a m b a r
تضرر	t a dˤ a r r a r a
تحكيم	t a ħ k iː m
سطم	s a tˤ a m a
جار	d͡ʒ aː r
حبق	ħ a b a q
بابل	b aː b i l
توسع	t a w a s s a ʕ a
مضرب	m i dˤ r a b
دجاجة	d a d͡ʒ aː d͡ʒ a
استمات	i s t a m aː t a
دارفلفل	d aː r f i l f i l
سلافي	s l aː f i j j
أعلى	ʔ a ʕ l aː
بنان	b a n aː n
نوراني	n uː r aː n i j j
جمعية	d͡ʒ a m ʕ i j j a
كهرومائي	k a h r uː m aː ʔ i j j
شلغم	ʃ a l ɣ a m
أعرن	ʔ a ʕ r a n a
تضمن	t a dˤ a m m a n a
غافت	ɣ aː f a t
قشر	q a ʃ a r a
كثير	k a θ iː r
نيفق	n a j f a q
معاونة	m u ʕ aː w a n a
مرآة	m i r ʔ aː h
بارز	b aː r a z a
حاسوب	ħ aː s uː b
ابتنى	i b t a n aː
أشل	ʔ a ʃ a l l
تلفت	t a l a f f a t a
المجر	a l m a d͡ʒ a r
وصى	w a sˤ sˤ aː
خليفة	x a l iː f a
أعز	ʔ a ʕ a z z
نشيدة	n a ʃ iː d a
ارتباط	i r t i b aː tˤ
منيرة	m u n iː r a
حلول	ħ u l uː l
سفرة	s u f r a
مسرحي	m a s r a ħ i j j
نسبوية	n i s b a w i j j a
فنجان	f i n d͡ʒ aː n
قندهار	q u n d u h aː r
قاوون	q aː w uː n
هايتي	h aː j i t iː
اسكتلندي	i s k u t l a n d i j j
مينا	m iː n aː
لبلبي	l a b l a b i j j
مومياء	m uː m i j aː ʔ
أدحية	ʔ u d ħ i j a
كشمش	k i ʃ m i ʃ
طباق	tˤ a b b aː q
المغرب	a l m a ɣ r i b
كلب	k a l b
وبيل	w a b iː l
أعور	ʔ a ʕ w a r
عظم	ʕ a ðˤ m
تيش	t iː ʃ
سعيد	s a ʕ iː d
جزدان	d͡ʒ i z d aː n
الزهرة	a z z u h a r a
أثجل	ʔ a θ d͡ʒ a l
زمزريق	z a m z a r iː q
انخفض	i n x a f a dˤ a
زوج	z a w d͡ʒ
ذال	ð aː l
مغفرة	m a ɣ f i r a
تكية	t a k i j j a
مجموعة	m a d͡ʒ m uː ʕ a
زئير	z a ʔ iː r
فتش	f a t t a ʃ a
قصيل	q a sˤ iː l
فراطة	f u r aː tˤ a
إشبين	ʔ i ʃ b iː n
مركب	m a r k a b
درباس	d i r b aː s
يرقة	j a r a q a
سهل	s a h h a l a
صوب	sˤ a w b
ليت	l a j t a
كازاخستان	k aː z aː x i s t aː n
إلى	ʔ i l aː
أنف	ʔ a n f
تدليك	t a d l iː k
سليلة	s a l iː l a
مري	m u r iː
بربير	b a r b iː r
قروش	q u r uː ʃ
محاكمة	m u ħ aː k a m a
نفض	n a f a dˤ a
فني	f a n i j a
مطراني	m u tˤ r aː n i j j
عبوثران	ʕ a b a w θ a r aː n
همزة	h a m z a
افتخر	i f t a x a r a
جين	d͡ʒ iː n
شحن	ʃ a ħ a n a
رجلة	r u d͡ʒ l a
قارون	q aː r uː n
عرناس	ʕ a r n aː s
فحشاء	f a ħ ʃ aː ʔ
فقيه	f a q iː h
برقية	b a r q i j j a
جميز	d͡ʒ u m m a j z
طفيف	tˤ a f iː f
مضيق	m a dˤ iː q
جوز	d͡ʒ a w z
أنسى	ʔ a n s aː
إياك	ʔ i j j aː k a
بركان	b a r k aː n
زغرد	z a ɣ r a d a
دجلة	d i d͡ʒ l a
يراع	j a r aː ʕ
هدهد	h a d h a d a
حيثيات	ħ a j θ i j j aː t
مهذار	m i h ð aː r
إداري	ʔ i d aː r i j j
طرابلس	tˤ a r aː b l u s
تهجى	t a h a d͡ʒ d͡ʒ aː
صلعة	sˤ a l ʕ a
قرنبيط	q a r n a b iː tˤ
مشاوير	m a ʃ aː w iː r
تمادى	t a m aː d aː
سريان	s a r a j aː n
مقاس	m a q aː s
خسأ	x a s a ʔ a
فطيسة	f a tˤ iː s a
مضمون	m a dˤ m uː n
حزاق	ħ a z aː q
كنيسة	k a n iː s a
راتينج	r aː t iː n a d͡ʒ
شذر	ʃ a ð r
صحاف	sˤ a ħ ħ aː f
أشيب	ʔ a ʃ j a b
رزتاق	r u z t aː q
قصرية	q a sˤ r i j j a
حنان	ħ a n aː n
أخامص	ʔ a x aː m i sˤ
اتصل	i t t a sˤ a l a
مماس	m u m aː s s
جنسية	d͡ʒ i n s i j j a
ماعون	m aː ʕ uː n
كستيج	k u s t iː d͡ʒ
بازار	b aː z aː r
نهزة	n u h z a
توصية	t a w sˤ i j a
زغلول	z u ɣ l uː l
ترياق	t i r j aː q
كزمازك	k a z m aː z a k
عفريت	ʕ a f r iː t
تطاير	t a tˤ aː j a r a
فيجن	f a j d͡ʒ a n
سجلاط	s i d͡ʒ i l l aː tˤ
توقف	t a w a q q a f a
فاكهة	f aː k h a
قونية	q uː n i j a
نيوزيلاندا	n i j uː z iː l aː n d aː
بتع	b i t ʕ
احترق	i ħ t a r a q a
أنهك	ʔ a n h a k a
أنتم	ʔ a n t u m
قيصوم	q a j sˤ uː m
حبالة	ħ i b aː l a
بستوقة	b u s t uː q a
خور	x a w r
أسارون	ʔ a s aː r uː n
غراب	ɣ u r aː b
ميتوكندريون	m iː t uː k u n d r i j uː n
أطفال	ʔ a tˤ f aː l
ظمئ	ðˤ a m i ʔ a
طواجن	tˤ a w aː d͡ʒ i n
مجازر	m a d͡ʒ aː z i r
ذرية	ð u r r i j j a
طلاق	tˤ a l aː q
سبعة	s a b ʕ a
ضمان	dˤ a m aː n
هندباء	h i n d i b aː ʔ
كون	k a w n
باذنجان	b aː ð i n d͡ʒ aː n
هندسي	h a n d a s i j j
زينب	z a j n a b
سنت	s a n n a t
سخد	s u x d
نشد	n a ʃ a d a
أبرز	ʔ a b r a z
صخف	sˤ a x a f a
زيارة	z i j aː r a
ميدان	m a j d aː n
ذمم	ð i m a m
كشتبان	k u ʃ t u b aː n
ناردين	n aː r a d iː n
أخطبوط	ʔ u x tˤ u b uː tˤ
خيالي	x a j aː l i j j
زحزح	z a ħ z a ħ a
تاريخ	t aː r iː x
موقع	m a w q i ʕ
درزن	d a r z a n
واثق	w aː θ i q
معطس	m a ʕ tˤ i s
خداج	x i d aː d͡ʒ
قرفصاء	q u r f u sˤ aː ʔ
كوة	k a w w a
درفيل	d a r f iː l
مشواة	m i ʃ w aː h
قرآني	q u r ʔ aː n i j j
ذبول	ð u b uː l
قفازات	q u f f aː z aː t
خصص	x a sˤ sˤ a sˤ a
محطة	m a ħ a tˤ tˤ a
آنك	ʔ aː n u k
معنى	m a ʕ n aː
أعاصير	ʔ a ʕ aː sˤ iː r
مسطرة	m i s tˤ a r a
خفج	x a f a d͡ʒ
أكاذيب	ʔ a k aː ð iː b
براءة	b a r aː ʔ a
بندق	b u n d u q
فؤول	f u ʔ uː l
حوجلة	ħ a w d͡ʒ a l a
المكسيك	a l m a k s iː k
قسطاس	q i s tˤ aː s
قوم	q a w m
تالي	t aː l iː
ولكن	w a l aː k i n
عند	ʕ i n d a
فلت	f a l a t a
بسمة	b a s m a
ذوق	ð a w q
قيمة	q iː m a
مساواة	m u s aː w aː h
صيفة	sˤ a j f a
نبأ	n a b a ʔ
نزهة	n u z h a
مثل	m a θ a l
زوجة	z a w d͡ʒ a
جابية	d͡ʒ aː b i j a
تورم	t a w a r r a m a
دافئ	d aː f i ʔ
مدفأ	m i d f a ʔ
تراوح	t a r aː w a ħ a
شكال	ʃ i k aː l
إبل	ʔ i b i l
القنيطرة	a l q u n a j tˤ i r a
هدد	h a d d a d a
جميلة	d͡ʒ a m iː l a
خشاب	x a ʃ ʃ aː b
أنفحة	ʔ a n f i ħ a
حبن	ħ a b a n
أسطرك	ʔ a s tˤ a r a k
لهيب	l a h iː b
صرافة	sˤ a r r aː f a
تنحى	t a n a ħ ħ aː
مطفأة	m i tˤ f a ʔ a
بطرك	b a tˤ r a k
قطران	q a tˤ a r aː n
تذكرة	t a ð k i r a
جبران	d͡ʒ u b r aː n
مغطس	m a ɣ tˤ i s
استعاذ	i s t a ʕ aː ð a
نقيض	n a q iː dˤ
تجرد	t a d͡ʒ a r r a d a
كربون	k a r b uː n
انتقال	i n t i q aː l
أناغلس	ʔ a n aː ɣ a l i s
ارتباك	i r t i b aː k
تومان	t uː m aː n
متزوج	m u t a z a w w i d͡ʒ
معاصر	m u ʕ aː sˤ i r
سرقين	s i r q iː n
أباخس	ʔ a b aː x i s u
مليء	m a l iː ʔ
اللات	a l l aː t
داركيسة	d aː r k iː s a
صيدلية	sˤ a j d a l i j j a
نهض	n a h a dˤ a
أطنب	ʔ a tˤ n a b a
ورطة	w a r tˤ a
ثدييات	θ a d j i j j aː t
قطارة	q a tˤ tˤ aː r a
دراماتيكي	d i r aː m aː t iː k i j j
برسيم	b i r s iː m
صغر	sˤ a ɣ a r a
رهبانية	r a h b aː n i j j a
استوقف	i s t a w q a f a
مصحنة	m i sˤ ħ a n a
المنامة	a l m a n aː m a
أبنوس	ʔ a b a n uː s
افتقد	i f t a q a d a
قطيفة	q a tˤ iː f a
الرياض	a r r i j aː dˤ
تساءل	t a s aː ʔ a l a
كاسيت	k aː s iː t
أنبذ	ʔ a n b a ð a
غامق	ɣ aː m i q
فوف	f uː f
سلعة	s i l ʕ a
نزعة	n a z ʕ a
استمنى	i s t a m n aː
ضمير	dˤ a m iː r
سويداء	s u w a j d aː ʔ
صتع	sˤ a t a ʕ a
هيئة	h a j ʔ a
سخل	s a x l
عبرة	ʕ i b r a
حلال	ħ a l aː l
أضر	ʔ a dˤ a r r a
بيوت	b u j uː t
جسم	d͡ʒ a s s a m a
تأسف	t a ʔ a s s a f a
وثيق	w a θ iː q
ممسحة	m i m s a ħ a
حادث	ħ aː d a θ a
رابطة	r aː b i tˤ a
أوجس	ʔ a w d͡ʒ a s a
الصويرة	a sˤ sˤ a w iː r a
بطروخ	b a tˤ r uː x
تيغار	t a j ɣ aː r
رصع	r a sˤ sˤ a ʕ a
سوريا	s uː r i j aː
خباز	x a b b aː z
سرنديب	s a r a n d iː b
السويد	a s s u w a j d
طائر	tˤ aː ʔ i r
قصاج	q u sˤ aː d͡ʒ
قلم	q a l a m
جمهورية	d͡ʒ u m h uː r i j j a
ثمر	θ a m a r
مخروطي	m a x r uː tˤ i j j
سكنجبين	s i k a n d͡ʒ a b iː n
متفرق	m u t a f a r r i q
خزينة	x a z iː n a
مغن	m u ɣ a n n i n
تصالح	t a sˤ aː l a ħ a
تقرر	t a q a r r a r a
أراد	ʔ a r aː d a
توعوي	t a w ʕ a w i j j
برشيد	b a r ʃ iː d
تخضخض	t a x a dˤ x a dˤ a
العرائش	a l ʕ a r aː ʔ i ʃ
خامر	x aː m a r a
علا	ʕ a l aː
كودين	k uː d iː n
قبرة	q u b b a r a
ارتياد	i r t i j aː d
أرض	ʔ a r dˤ
هذر	h a ð a r a
سمار	s a m aː r
كانون	k aː n uː n
ممحوق	m a m ħ uː q
دكان	d u k k aː n
مكان	m a k aː n
رواقي	r i w aː q i j j
جدد	d͡ʒ a d a d
أسمرا	ʔ a s m a r aː
وتيرة	w a t iː r a
إبداعي	ʔ i b d aː ʕ i j j
عنصر	ʕ u n sˤ u r
صخد	sˤ a x a d a
مازريون	m aː z a r i j uː n
دغفل	d a ɣ f a l
ثور	θ a w r
بلجيكا	b a l d͡ʒ iː k a
عضلة	ʕ a dˤ a l a
غرب	ɣ a r a b
شاكر	ʃ aː k i r
مقاعد	m a q aː ʕ i d
دستة	d a s t a
سهوة	s a h w a
هيول	h a j uː l
تأميم	t a ʔ m iː m
بهائي	b a h aː ʔ i j j
فهم	f a h h a m a
حاجة	ħ aː d͡ʒ a
جنسي	d͡ʒ a n n i s iː
محن	m i ħ a n
باروق	b aː r uː q
ديك	d iː k
قنطرة	q a n tˤ a r a
تخت	t a x t
اجتذب	i d͡ʒ t a ð a b a
شبوطة	ʃ a b b uː tˤ a
تلفاف	t i l f aː f
حملة	ħ a m l a
تنسيق	t a n s iː q
وسق	w a s q
ركلة	r a k l a
زنبوع	z a n b uː ʕ
دعا	d a ʕ aː
باب	b aː b
قافلة	q aː f i l a
مكن	m a k k a n a
فرهود	f u r h uː d
مثابة	m a θ aː b a
أكرى	ʔ a k r aː
رئوي	r i ʔ a w i j j
بدلة	b a d l a
اعتلى	i ʕ t a l aː
مغناطيس	m a ɣ n aː tˤ iː s
بردي	b a r d i j j
ثمن	t u m u n
اكتسى	i k t a s aː
فرفحين	f a r f a ħ iː n
غائر	ɣ aː ʔ i r
سرجين	s i r d͡ʒ iː n
عاين	ʕ aː j a n a
ناخوذة	n aː x uː ð a
عازب	ʕ aː z i b
استقل	i s t a q a l l a
إسرائيل	ʔ i s r aː ʔ iː l
نفث	n a f a θ a
رضائع	r a dˤ aː ʔ i ʕ
المريخ	a l m i r r iː x
طاح	tˤ aː ħ a
عافية	ʕ aː f i j a
ألاباما	ʔ a l aː b aː m aː
أزعر	ʔ a z ʕ a r
ائتمر	i ʔ t a m a r a
تسلية	t a s l i j a
خندريس	x a n d a r iː s
سينمائي	s i j n a m aː ʔ i j j
مهرة	m u h r a
شمشار	ʃ a m ʃ aː r
إمهال	ʔ i m h aː l
حسل	ħ i s l
وابور	w aː b uː r
نبيل	n a b iː l
قوش	q uː ʃ
أطباء	ʔ a tˤ i b b aː ʔ
أنور	ʔ a n w a r
كمثراة	k u m m a θ r aː h
جنائي	d͡ʒ i n aː ʔ i j j
فرصاد	f i r sˤ aː d
مسافة	m a s aː f a
سيس	s a j j a s a
نباهة	n a b aː h a
قطار	q i tˤ aː r
لسع	l a s a ʕ a
تطبب	t a tˤ a b b a b a
نخشوش	n a x ʃ uː ʃ
شاسع	ʃ aː s i ʕ
سين	s iː n
مطاف	m a tˤ aː f
شابانك	ʃ aː b aː n a k
تعويذة	t a ʕ w iː ð a
لحاق	l a ħ aː q
رثية	r a θ j a
قتل	q a t a l a
باستا	b aː s t aː
بكارة	b a k aː r a
ديسم	d a j s a m
ثقافة	θ a q aː f a
خلاعي	x a l aː ʕ i j j
أمير	ʔ a m iː r
انتظام	i n t i ðˤ aː m
مثانة	m a θ aː n a
فشقر	f a ʃ q a r
عراك	ʕ i r aː k
بيض	b a j dˤ
زبل	z a b b a l a
إنقاض	ʔ i n q aː dˤ
خالف	x aː l a f a
جحا	d͡ʒ u ħ aː
لاط	l aː tˤ a
فالوذة	f aː l uː ð a
فئران	f i ʔ r aː n
تقني	t i q n i j j
جليد	d͡ʒ a l iː d
قفير	q a f iː r
أورانوس	ʔ uː r aː n uː s
وصيف	w a sˤ iː f
غضب	ɣ a dˤ a b
هنا	h u n aː
أنموذج	ʔ u n m uː ð a d͡ʒ
دكتور	d u k t uː r
شبشب	ʃ i b ʃ i b
ترنجان	t u r u n d͡ʒ aː n
قرصن	q a r sˤ a n a
كتابة	k i t aː b a
أفريقيا	ʔ a f r iː q j aː
جوهري	d͡ʒ a w h a r i j j
غفر	ɣ a f a r a
ببنودة	b a b n uː d a
مسجد	m a s d͡ʒ i d
انتقد	i n t a q a d a
جرذ	d͡ʒ u r a ð
ازديان	i z d i j aː n
عربن	ʕ a r b a n a
مثلجات	m u θ a l l a d͡ʒ aː t
تذاكى	t a ð aː k aː
عاب	ʕ aː b a
فركس	f i r k i s
شاورما	ʃ aː w a r m aː
بسكرة	b i s k a r a
اندلع	i n d a l a ʕ a
متصل	m u t t a sˤ i l
هزر	h a z a r a
فرخ	f a r r a x a
غسق	ɣ a s a q
صهريج	sˤ a h r iː d͡ʒ
مرصبان	m a r sˤ a b aː n
تمسيد	t a m s iː d
رواصيل	r a w aː sˤ iː l
بغداد	b a ɣ d aː d
إنهاء	ʔ i n h aː ʔ
قبر	q a b a r a
أبلس	ʔ a b l a s a
إدحية	ʔ i d ħ i j a
هزل	h a z a l a
أحاط	ʔ a ħ aː tˤ a
زعزع	z a ʕ z a ʕ a
عنزروت	ʕ a n z a r uː t
أخوية	ʔ a x a w i j j a
ركف	r a k a f
دولاب	d a w l aː b
زوفا	z uː f aː
لاءم	l aː ʔ a m a
بريد	b a r iː d
أصدأ	ʔ a sˤ d a ʔ
تجرع	t a d͡ʒ a r r a ʕ a
استفزاز	i s t i f z aː z
جذوع	d͡ʒ u ð uː ʕ
سليلى	s u l a j l aː
أوحد	ʔ a w ħ a d
رغيفات	r a ɣ iː f aː t
اعتمد	i ʕ t a m a d a
جاورجيوس	d͡ʒ aː w u r d͡ʒ i j uː s
نادل	n aː d i l
فادي	f aː d iː
لاث	l aː θ a
تطفل	t a tˤ a f f a l a
سكة	s i k k a
محول	m u ħ a w w i l
رؤوس	r u ʔ uː s
سقراط	s u q r aː tˤ
ضاجع	dˤ aː d͡ʒ a ʕ a
مدرسة	m a d r a s a
وزغة	w a z a ɣ a
فلفل	f i l f i l
ساحل	s aː ħ i l
العراق	a l ʕ i r aː q
نفخ	n a f a x a
قيثارات	q iː θ aː r aː t
ابنة	i b n a
آشوري	ʔ aː ʃ uː r i j j
تقرير	t a q r iː r
شاط	ʃ aː tˤ a
خصية	x i sˤ j a
اتبع	i t t a b a ʕ a
غمى	ɣ a m m aː
ارتقب	i r t a q a b a
رابط	r aː b i tˤ
تنرفز	t a n a r f a z a
البرازيل	a l b a r aː z iː l
مسموح	m a s m uː ħ
الخميس	a l x a m iː s
شامخ	ʃ aː m i x
محجوب	m a ħ d͡ʒ uː b
ابتسامة	i b t i s aː m a
سحلب	s a ħ l a b
جنب	d͡ʒ a n a b
سبب	s a b a b
النيجر	a n n iː d͡ʒ a r
غرلة	ɣ u r l a
مذهبي	m a ð h a b i j j
منتظم	m u n t a ðˤ a m
بربخ	b a r b a x
مدرك	m u d r a k
تحوط	t a ħ a w w a tˤ a
حصان	ħ i sˤ aː n
قول	q a w l
آنسة	ʔ aː n i s a
ارتاع	i r t aː ʕ a
السبت	a s s a b t
إتلاف	ʔ i t l aː f
صفع	sˤ a f a ʕ a
موريتانيا	m uː r iː t aː n i j aː
غالبية	ɣ aː l i b i j j a
كرح	k i r ħ
بيداء	b a j d aː ʔ
إغريقي	ʔ i ɣ r iː q i j j
كان	k aː n a
ماجور	m aː d͡ʒ uː r
أنزل	ʔ a n z a l a
حمصيص	ħ a m a sˤ iː sˤ
زريبة	z a r iː b a
مداخلة	m u d aː x a l a
تناوم	t a n aː w a m a
مطبعة	m a tˤ b a ʕ a
صنبور	sˤ u n b uː r
الصين	a sˤ sˤ iː n
معانقة	m u ʕ aː n a q a
بعلبك	b a ʕ l a b a k k
قنبيل	q a n b iː l
كزمازج	k a z m aː z a d͡ʒ
خادم	x aː d i m
ديس	d iː s
علقم	ʕ a l q a m
بالوعات	b aː l uː ʕ aː t
دركي	d a r a k i j j
ساء	s aː ʔ a
كوز	k uː z
بساط	b i s aː tˤ
آفات	ʔ aː f aː t
فانيذ	f aː n iː ð
عتيق	ʕ a t iː q
صحي	sˤ a ħ i j a
وطني	w a tˤ a n i j j
مجموع	m a d͡ʒ m uː ʕ
مائدة	m aː ʔ i d a
شراب	ʃ a r aː b
رمادي	r a m aː d i j j
قطبي	q u tˤ b i j j
أسري	ʔ u s r i j j
حافظة	ħ aː f i ðˤ a
تصفح	t a sˤ a f f a ħ a
مفروشات	m a f r uː ʃ aː t
فاجأ	f aː d͡ʒ a ʔ a
رمان	r u m m aː n
لهى	l a h h aː
غدير	ɣ a d iː r
نخالة	n u x aː l a
معركة	m a ʕ r a k a
إسماعيل	ʔ i s m aː ʕ iː l
مغاث	m u ɣ aː θ
فأل	f a ʔ l
واحة	w aː ħ a
بزم	b a z a m a
ياسمين	j aː s a m iː n
بخير	b i x a j r
كتان	k a t t aː n
ندى	n a d aː
ملوخية	m u l uː x i j j a
تدريب	t a d r iː b
شفاف	ʃ a f f aː f
ثدياء	θ a d j aː ʔ
كأب	k a ʔ b
يقظة	j a q a ðˤ a
تشاعر	t a ʃ aː ʕ a r a
صابورة	sˤ aː b uː r a
ممتلكات	m u m t a l a k aː t
بروناي	b r uː n aː j
خوخ	x a w x
زكام	z u k aː m
حلكة	ħ u l k a
استجار	i s t a d͡ʒ aː r a
تنديل	t a n d iː l
حماض	ħ a m m aː dˤ
ضمني	dˤ i m n i j j
اصطدأ	i sˤ tˤ a d a ʔ a
عريان	ʕ u r j aː n
قاد	q aː d a
صفيراء	sˤ u f a j r aː ʔ
مقصف	m a q sˤ a f
أصغى	ʔ a sˤ ɣ aː
خزان	x a z z aː n
مسمار	m i s m aː r
اليرموك	a l j a r m uː k
أوحال	ʔ a w ħ aː l
صبرة	sˤ a b a r a
هزيل	h a z iː l
انتبه	i n t a b a h a
كثافة	k a θ aː f a
مضيرة	m a dˤ iː r a
هذا	h aː ð a
أجيال	ʔ a d͡ʒ j aː l
أقرأ	ʔ a q r a ʔ a
صحافة	sˤ a ħ aː f a
تكلم	t a k a l l a m a
دعاء	d u ʕ aː ʔ
اليونان	a l j uː n aː n
سوراني	s uː r aː n i j j
بولاد	b uː l aː d
مبارز	m u b aː r a z
سكي	s a k k i j j
ألمانيا	ʔ a l m aː n i j aː
نشيد	n a ʃ iː d
جزء	d͡ʒ u z ʔ
أعجم	ʔ a ʕ d͡ʒ a m a
أمان	ʔ a m aː n
جلاد	d͡ʒ a l l aː d
مجسمة	m u d͡ʒ a s s a m a
سفيه	s a f iː h
خرفة	x u r f a
مائت	m aː ʔ i t
تسعمائة	t i s ʕ u m i ʔ a
سطع	s a tˤ a ʕ a
تجربة	t a d͡ʒ r i b a
لكنة	l u k n a
دعموص	d u ʕ m uː sˤ
فعالية	f a ʕ ʕ aː l i j j a
رسول	r a s uː l
فكر	f a k a r a
ضفة	dˤ a f f a
رائع	r aː ʔ i ʕ
ثوب	θ a w b
عنكبوت	ʕ a n k a b uː t
إيصاء	ʔ iː sˤ aː ʔ
أسمر	ʔ a s m a r
أنواع	ʔ a n w aː ʕ
ارتدع	i r t a d a ʕ a
أنسون	ʔ a n s uː n
رعراع	r a ʕ r aː ʕ
تبحر	t a b a ħ ħ a r a
صتم	sˤ a t a m
تساوى	t a s aː w aː
دبج	d a b b a d͡ʒ a
تحرش	t a ħ a r r a ʃ a
فاشرا	f aː ʃ i r aː
خيار	x i j aː r
ضاحية	dˤ aː ħ i j a
إشغال	ʔ i ʃ ɣ aː l
مساومة	m u s aː w a m a
تحذير	t a ħ ð iː r
أناغاليس	ʔ a n aː ɣ aː l iː s
حماس	ħ a m aː s
مراوغة	m u r aː w a ɣ a
لولا	l a w l aː
نعامة	n a ʕ aː m a
قلقديس	q a l q a d iː s
راود	r aː w a d a
اكتئاب	i k t i ʔ aː b
علني	ʕ a l a n i j j
وسد	w a s s a d a
غزاوة	ɣ a z aː w a
ساط	s aː tˤ a
اشتهى	i ʃ t a h aː
مصباح	m i sˤ b aː ħ
خلفي	x a l f i j j
حجرة	ħ u d͡ʒ r a
بهلول	b u h l uː l
انقلاب	i n q i l aː b
صنان	sˤ u n aː n
محايد	m u ħ aː j i d
شرق	ʃ a r q
فلسطين	f i l a s tˤ iː n
الحارث	a l ħ aː r i θ
نير	n a j j i r
ثريد	θ a r iː d
تدريس	t a d r iː s
دفاع	d i f aː ʕ
الأرجنتين	a l ʔ a r d͡ʒ a n t iː n
راحل	r aː ħ i l
قاليقلا	q aː l iː q a l aː
مفسر	m u f a s s i r
قرطم	q u r tˤ u m
جريب	d͡ʒ a r iː b
فوطة	f uː tˤ a
نفقة	n a f a q a
شعرى	ʃ a ʕ r aː
بكين	b i k iː n
بئسما	b i ʔ s a m aː
انتفخ	i n t a f a x a
مردي	m u r d i j j
واعد	w aː ʕ a d a
أدحوة	ʔ u d ħ u w w a
مرأة	m a r ʔ a
كوم	k a w m
ورق	w a r a q
كسا	k a s aː
عنوسة	ʕ u n uː s a
تكفيري	t a k f iː r i j j
اقتصر	i q t a sˤ a r a
تاوريرت	t aː w r iː r t
راكب	r aː k i b
جلهم	d͡ʒ a l h a m
موسيقى	m uː s iː q aː
مخيم	m u x a j j a m
مشى	m a ʃ aː
تخم	t a x m
قسوة	q a s w a
مشعل	m a ʃ ʕ a l
تاق	t aː q a
إقناع	ʔ i q n aː ʕ
سقم	s a q a m
أسف	ʔ a s a f f a
أرسطوطاليس	ʔ a r i s tˤ uː tˤ aː l iː s
حوب	ħ uː b
تركمانستان	t u r k u m aː n i s t aː n
قايين	q aː j iː n
نضوج	n u dˤ uː d͡ʒ
مشرقان	m a ʃ r i q aː n
تمساح	t i m s aː ħ
تقية	t a q i j j a
مبرهنة	m u b a r h a n a
شوح	ʃ uː ħ
صقيع	sˤ a q iː ʕ
مساطر	m a s aː tˤ i r
قاسم	q aː s i m
عاشق	ʕ aː ʃ i q
ملف	m i l a f f
زبرجد	z a b a r d͡ʒ a d
ضائنة	dˤ aː ʔ i n a
استغرق	i s t a ɣ r a q a
أغوى	ʔ a ɣ w aː
لغة	l u ɣ a
إبريق	ʔ i b r iː q
دقع	d a q i ʕ a
عاطفي	ʕ aː tˤ i f i j j
أغلفة	ʔ a ɣ l i f a
ألغى	ʔ a l ɣ aː
وغل	w a ɣ a l a
أليس	ʔ a l iː s
جريدة	d͡ʒ a r iː d a
كاراطي	k aː r aː tˤ iː
طعام	tˤ a ʕ aː m
زواج	z a w aː d͡ʒ
مغلوب	m a ɣ l uː b
تسعون	t a s ʕ a w n a
ذمة	ð i m m a
مسخ	m a s a x a
وارث	w aː r i θ
عطاء	ʕ a tˤ aː ʔ
منار	m a n aː r
باطية	b aː tˤ i j a
عبيثران	ʕ a b a j θ a r aː n
زوفرا	z a w f a r aː
عبق	ʕ a b b a q a
خطيئة	x a tˤ iː ʔ a
غصة	ɣ u sˤ sˤ a
غار	ɣ aː r a
تعفج	t a ʕ a f f a d͡ʒ a
لثم	l a θ a m a
بابونج	b aː b uː n a d͡ʒ
سياسة	s i j aː s a
بتاتا	b a t aː t aː
قبائلي	q a b aː ʔ i l i j j
جانرك	d͡ʒ aː n a r i k
تانبول	t aː n a b uː l
ديان	d a j j aː n
باص	b aː sˤ
جورجيا	d͡ʒ uː r d͡ʒ i j aː
حلتيث	ħ i l t iː θ
مخطئ	m u x tˤ i ʔ
فيل	f iː l
ولى	w a l l aː
ركبة	r a k a b a
براق	b a r r aː q
بطالة	b a tˤ aː l a
بعث	b a ʕ a θ a
ديانات	d i j aː n aː t
شراء	ʃ i r aː ʔ
خزف	x a z a f
كينيا	k iː n i j aː
هزج	h a z i d͡ʒ a
ساحة	s aː ħ a
نعال	n i ʕ aː l
زاي	z aː j
جدع	d͡ʒ a d a ʕ a
ظليم	ðˤ a l iː m
بينما	b a j n a m aː
قرظ	q a r a ðˤ
فتوى	f a t w aː
وفاء	w a f aː ʔ
علاجي	ʕ i l aː d͡ʒ iː
فواق	f u w aː q
ناعور	n aː ʕ uː r
عميق	ʕ a m iː q
جدوى	d͡ʒ a d w aː
تصهين	t a sˤ a h j a n a
ركع	r a k a ʕ a
صغار	sˤ i ɣ aː r
مشروع	m a ʃ r uː ʕ
عود	ʕ a w d
إحسان	ʔ i ħ s aː n
أكب	ʔ a k a b b a
تفاح	t u f f aː ħ
شبهة	ʃ u b h a
طحين	tˤ a ħ iː n
نحال	n a ħ ħ aː l
تزعزع	t a z a ʕ z a ʕ a
تايوان	t aː j w aː n
نعجة	n a ʕ d͡ʒ a
عقيدة	ʕ a q iː d a
عواري	ʕ a w aː r i j j
قورح	q uː r a ħ
فكرة	f i k r a
صعوبة	sˤ u ʕ uː b a
انتقم	i n t a q a m a
رطوبة	r u tˤ uː b a
احتفل	i ħ t a f a l a
بهرج	b a h r a d͡ʒ
ياسين	j aː s iː n
خطام	x i tˤ aː m
غين	ɣ a j n
رصفان	r u sˤ f aː n
شاشية	ʃ aː ʃ i j j a
مؤسس	m u ʔ a s s a s
معاينة	m u ʕ aː j a n a
استيقظ	i s t a j q a ðˤ a
مستفرغ	m u s t a f r a ɣ
تحسس	t a ħ a s s a s a
جوذاب	d͡ʒ uː ð aː b
جحفل	d͡ʒ a ħ f a l
شفنين	ʃ i f n iː n
أنهى	ʔ a n h aː
أندراوس	ʔ a n d a r aː w u s
مكون	m u k a w w i n
سائمة	s aː ʔ i m a
سنبل	s u n b u l
كوسوفو	k uː s uː f uː
اكترى	i k t a r aː
أساس	ʔ a s aː s
رأسمال	r a ʔ s m aː l
قنبلة	q u n b u l a
شليل	ʃ a l iː l
مهم	m u h i m m
حمص	ħ a m m a sˤ a
مماثلة	m u m aː θ a l a
مبكر	m u b a k k i r
العاصي	a l ʕ aː sˤ iː
بحيرة	b u ħ a j r a
قصاب	q a sˤ sˤ aː b
نطل	n a tˤ a l a
مدبر	m u d a b b i r
ثلاثون	θ a l aː θ uː n a
لكن	l aː k i n
أسرة	ʔ a s i r r a
الصومال	a sˤ sˤ uː m aː l
حزاء	ħ a z aː ʔ
إبريل	ʔ i b r iː l
صفر	sˤ a f a r
صحل	sˤ a ħ i l a
أموي	ʔ u m a w i j j
تقرح	t a q a r r a ħ a
تاء	t aː ʔ
فنطاس	f i n tˤ aː s
بيد	b a j d a
بذج	b a ð a d͡ʒ
مرجان	m a r d͡ʒ aː n
شظية	ʃ a ðˤ i j j a
قنديل	q a n d iː l
جواد	d͡ʒ a w aː d
توتيا	t uː t i j aː
سورينام	s uː r iː n aː m
لكمة	l a k m a
مفوف	m u f a w w a f
استمر	i s t a m a r r a
سلسل	s a l s a l a
حنظلة	ħ a n ðˤ a l a
عبادة	ʕ i b aː d a
أول	ʔ a w w a l
جاف	d͡ʒ aː f a
إفريقية	ʔ i f r iː q i j a
جربوز	d͡ʒ a r b uː z
أيقن	ʔ a j q a n a
خزز	x u z a z
فاسد	f aː s i d
مكالمة	m u k aː l a m a
باريس	b aː r iː s
أيرلندا	ʔ a j i r l a n d aː
غريب	ɣ a r iː b
نهائي	n i h aː ʔ i j j
ليرة	l a j r a
مقطر	m u q a tˤ tˤ i r
أعجوبة	ʔ u ʕ d͡ʒ uː b a
معقل	m a ʕ q i l
جيء	d͡ʒ a j ʔ
نساء	n a s aː ʔ
بوصير	b uː sˤ iː r
شنجار	ʃ a n d͡ʒ aː r
فيروز	f a j r uː z
مستشرق	m u s t a ʃ r i q
غافث	ɣ aː f a θ
الهند	a l h i n d
منبر	m i n b a r
قرصان	q u r sˤ aː n
عظيم	ʕ a ðˤ iː m
أردمون	ʔ a r d a m uː n
بقدونس	b a q d uː n a s
رزداق	r u z d aː q
ناسور	n aː s uː r
إسوة	ʔ i s w a
قفاز	q u f aː z
أهدى	ʔ a h d aː
حاشا	ħ aː ʃ aː
ظلف	ðˤ i l f
نمر	n a m i r
جربوع	d͡ʒ a r b uː ʕ
جزئي	d͡ʒ u z ʔ i j j
مومس	m uː m i s
سلامتك	s a l aː m t a k
بامية	b aː m i j a
عائشة	ʕ aː ʔ i ʃ a
اعوج	i ʕ w a d͡ʒ d͡ʒ a
منقرض	m u n q a r i dˤ
محمد	m a ħ m a d
سويسري	s u w iː s r i j j
طمث	tˤ a m θ
جرثوم	d͡ʒ u r θ uː m
بورسودان	b uː r s uː d aː n
غزال	ɣ a z aː l
سلطوي	s u l tˤ a w i j j
لبان	l u b aː n
نافورة	n aː f uː r a
سابيائي	s aː b i j aː ʔ i j j
استفرغ	i s t a f r a ɣ a
حصرم	ħ a sˤ r a m
لواط	l i w aː tˤ
عار	ʕ aː r
ورس	w a r a s
مقولة	m a q uː l a
شربوش	ʃ a r b uː ʃ
سعي	s a ʕ j
رقيق	r a q iː q
قشعريرة	q u ʃ a ʕ r iː r a
أصخر	ʔ a sˤ x a r a
شعيب	ʃ u ʕ a j b
عظمى	ʕ u ðˤ m aː
معبر	m a ʕ b a r
تحدى	t a ħ a d d aː
جلباب	d͡ʒ i l b aː b
أعتاب	ʔ a ʕ t aː b
استقلال	i s t i q l aː l
كناب	k i n aː b
فناء	f a n aː ʔ
احتاز	i ħ t aː z a
سبسب	s a b s a b
مثار	m u θ aː r
متواضع	m u t a w aː dˤ i ʕ
عجرفة	ʕ a d͡ʒ r a f a
وحل	w a ħ l
فرمل	f a r m a l a
وجنة	w a d͡ʒ n a
فيتق	f a j t a q
أركنساس	ʔ a r k a n s aː s
توجه	t a w a d͡ʒ d͡ʒ a h a
صهيوني	sˤ a h j uː n i j j
سرط	s a r a tˤ a
وهلة	w a h l a
شهاب	ʃ i h aː b
جاء	d͡ʒ aː ʔ a
عمان	ʕ a m m aː n
هذيان	h a ð a j aː n
أسمرة	ʔ a s m a r a
يونيو	j uː n i j uː
رقف	r a q a f
رداء	r i d aː ʔ
حاذق	ħ aː ð i q
مليق	m a l iː q
فريسة	f a r iː s a
مالق	m aː l a q
وجدة	w a d͡ʒ d a
بنفسج	b a n a f s a d͡ʒ
تململ	t a m a l m a l a
تواقف	t a w aː q a f a
شريان	ʃ a r j aː n
اكتفى	i k t a f aː
مشاورة	m u ʃ aː w a r a
معماري	m i ʕ m aː r i j j
بطرخ	b a tˤ r a x
قلل	q a l l a l a
تصادف	t a sˤ aː d a f a
حنبلي	ħ a n b a l i j j
جمان	d͡ʒ u m aː n
عنى	ʕ a n aː
صيد	sˤ a j d
مخفر	m a x f a r
اصطك	i sˤ tˤ a k k a
لطم	l a tˤ a m a
حكومة	ħ u k uː m a
برهة	b u r h a
غضاضة	ɣ a dˤ aː dˤ a
رشفة	r a ʃ f a
زوم	z uː m
كهرومغناطيسي	k a h r uː m i ɣ n aː tˤ iː s i j j
كره	k a r h
يوسف	j uː s i f
إهداء	ʔ i h d aː ʔ
زنزانة	z i n z aː n a
وقت	w a q a t
بليحا	b a l iː ħ aː
باقة	b aː q a
كفاح	k i f aː ħ
كادس	k aː d i s
ذنب	ð a n a b
صاحب	sˤ aː ħ i b
ساف	s aː f
جادل	d͡ʒ aː d a l a
أبش	ʔ a b a ʃ a
أوقية	ʔ uː q i j j a
أزب	ʔ a z a b b
بارد	b aː r i d
بركري	b a r k a r i j j
أبله	ʔ a b l a h
كهف	k a h f
اندفاع	i n d i f aː ʕ
نيجيريا	n iː d͡ʒ iː r i j aː
صهيونية	sˤ a h j uː n i j j a
قشدي	q i ʃ d i j j
زردخانة	z a r a d x aː n a
قشمير	q i ʃ m iː r
زميل	z a m iː l
معجزات	m u ʕ d͡ʒ i z aː t
غواصة	ɣ a w w aː sˤ a
كسيح	k a s iː ħ
سلة	s a l l a
ارتفع	i r t a f a ʕ a
مغناطيسية	m a ɣ n aː tˤ iː s i j j a
الفلبين	a l f i l i b b iː n
اتعاظ	i t t i ʕ aː ðˤ
رحيل	r a ħ iː l
قمح	q a m ħ
رأي	r a ʔ j
قشع	q a ʃ a ʕ a
أبهج	ʔ a b h a d͡ʒ a
ندبة	n a d b a
ممسح	m i m s a ħ
مطحنة	m a tˤ ħ a n a
فرث	f a r a θ a
ودج	w a d a d͡ʒ
مداومة	m u d aː w a m a
إرهابي	ʔ i r h aː b i j j
منهج	m a n h a d͡ʒ
أدهش	ʔ a d h a ʃ a
زفن	z a f a n a
أسبوع	ʔ u s b uː ʕ
أرومة	ʔ a r uː m a
جنطيانا	d͡ʒ a n tˤ i j aː n aː
اتفاق	i t t i f aː q
متجر	m a t d͡ʒ a r
بين	b a j n a
حيران	ħ a j r aː n
قوض	q a w w a dˤ a
تفادى	t a f aː d aː
هرنوة	h a r n u w a
خدش	x a d a ʃ a
هيبة	h a j b a
نقحر	n a q ħ a r a
نبذة	n u b ð a
شبيه	ʃ a b iː h
تزحلق	t a z a ħ l a q a
خربش	x a r b a ʃ a
سعدان	s a ʕ d aː n
فلسفة	f a l s a f a
يانصيب	j aː n a sˤ iː b
إصقنقور	ʔ i sˤ q a n q uː r
كفالة	k a f aː l a
شيهم	ʃ a j h a m
ابتلى	i b t a l aː
عبودية	ʕ u b uː d i j j a
دائرة	d aː ʔ i r a h
طبخة	tˤ a b x a
عران	ʕ i r aː n
ياء	j aː ʔ
اكتسب	i k t a s a b a
كدس	k a d a s a
مسيحي	m a s iː ħ i j j
فرهد	f a r h a d
شعبة	ʃ i ʕ b a
مخصصات	m u x a sˤ sˤ a sˤ aː t
عاشب	ʕ aː ʃ i b
صبحة	sˤ a b ħ a
خصوصي	x u sˤ uː sˤ i j j
دزينة	d a z z iː n a
باغت	b aː ɣ a t a
غلاء	ɣ a l aː ʔ
خيزران	x a j z u r aː n
وصيد	w a sˤ iː d
عنيف	ʕ a n iː f
جاب	d͡ʒ aː b a
شهادة	ʃ a h aː d a
صخدان	sˤ a x a d aː n
استهجان	i s t i h d͡ʒ aː n
غليون	ɣ a l j uː n
دارويني	d aː r w iː n i j j
تساقط	t a s aː q a tˤ a
كمان	k a m aː n
مجرفة	m i d͡ʒ r a f a
شحاذة	ʃ i ħ aː ð a
آخر	ʔ aː x a r
قائد	q aː ʔ i d
حصبة	ħ a sˤ b a
كرى	k a r aː
مبرة	m a b a r r a
دواسة	d a w w aː s a
اختلال	i x t i l aː l
نار	n aː r
جثة	d͡ʒ u θ θ a
أنيسون	ʔ a n iː s uː n
غلب	ɣ a l a b
فتخاء	f a t x aː ʔ
فدان	f a d d aː n
زمن	z a m a n
استفراغ	i s t i f r aː ɣ
طحال	tˤ i ħ aː l
شرشيري	ʃ a r ʃ iː r i j j
هطلس	h a tˤ a l l a s
بقي	b a q i j a
فعل	f a ʕ a l a
بطريك	b a tˤ r iː k
هبيد	h a b iː d
نفاخة	n u f f aː x a
إسكاف	ʔ i s k aː f
راء	r aː ʔ
حرير	ħ a r iː r
يوم	j a w m
منفور	m a n f uː r
صورة	sˤ uː r a
تخطى	t a x a tˤ tˤ aː
قلقطار	q a l q a tˤ aː r
تقدس	t a q a d d a s a
مستدير	m u s t a d iː r
اعتزام	i ʕ t i z aː m
اتحاد	i t t i ħ aː d
شيطاني	ʃ a j tˤ aː n i j j
وعدة	w a ʕ d a
دهشة	d a h ʃ a
فرن	f u r n
طفولة	tˤ u f uː l a
لينينية	l iː n iː n i j j a
حفيد	ħ a f iː d
إشفى	ʔ i ʃ f aː
تحاشى	t a ħ aː ʃ aː
دبلجة	d a b l a d͡ʒ a
ثمانون	θ a m aː n uː n
خطئ	x a tˤ i ʔ a
لهي	l a h i j a
أولى	ʔ a w l aː
مفرد	m u f r a d
اختنق	i x t a n a q a
جرو	d͡ʒ a r w
صحا	sˤ a ħ aː
جنينة	d͡ʒ u n a j n a
دبي	d i b b iː
باضع	b aː dˤ i ʕ
براغ	b r aː ɣ
زراعي	z i r aː ʕ i j j
لازوردي	l aː z u w a r d i j j
راجل	r aː d͡ʒ i l
إمامة	ʔ i m aː m a
رقبة	r a q a b a
تفاحة	t u f f aː ħ a
مخبول	m a x b uː l
مقارنة	m u q aː r a n a
جور	d͡ʒ a w r
فحم	f a ħ m
أشابة	ʔ u ʃ aː b a
سقيم	s a q iː m
صاج	sˤ aː d͡ʒ
أقر	ʔ a q a r r a
دفلى	d i f l aː
ليل	l a j l
الأردن	a l ʔ u r d u n
غبار	ɣ u b aː r
توفيق	t a w f iː q
آذريون	ʔ aː ð a r j uː n
إعراب	ʔ i ʕ r aː b
صفد	sˤ a f a d
باطني	b aː tˤ i n i j j
احتفال	i ħ t i f aː l
أدب	ʔ a d a b
طمى	tˤ a m aː
عصب	ʕ a sˤ a b a
أحيلى	ʔ u ħ a j l aː
خضخض	x a dˤ x a dˤ a
شاء	ʃ aː ʔ
رخيص	r a x iː sˤ
وزراء	w u z a r aː ʔ
بلاعة	b a l l aː ʕ a
حصاد	ħ a sˤ aː d
قداد	q a d aː d
زاح	z aː ħ a
عقلن	ʕ a q l a n a
جني	d͡ʒ i n n i j j
تلم	t a l a m
بلاذر	b a l aː ð i r
تأرجح	t a ʔ a r d͡ʒ a ħ a
راءى	r aː ʔ aː
طشقند	tˤ a ʃ q a n d
ملموم	m a l m uː m
ديناميكا	d iː n aː m iː k aː
زحف	z a ħ a f a
طما	tˤ a m aː
رئاسي	r i ʔ aː s i j j
دند	d a n d
قراد	q u r aː d
كنزة	k a n z a
أوريغون	ʔ uː r iː ɣ uː n
بزاق	b u z aː q
دمغة	d a m ɣ a
نواكشوط	n a w aː k ʃ uː tˤ
ترميم	t a r m iː m
نتف	n a t a f
فحص	f a ħ a sˤ a
أبث	ʔ a b a θ a
هول	h a w l
موقد	m a w q i d
مباراة	m u b aː r aː h
مرش	m a r a ʃ a
اقتضى	i q t a dˤ aː
أوضح	ʔ a w dˤ a ħ a
جبانات	d͡ʒ a b aː n aː t
خربز	x i r b i z
زايلفون	z aː j l u f uː n
مقداد	m i q d aː d
بلوة	b i l w a
بخت	b a x t
خصيب	x a sˤ iː b
هابيل	h aː b iː l
غنيمة	ɣ a n iː m a
سراق	s a r r aː q
صؤل	sˤ a ʔ u l a
مخاض	m a x aː dˤ
اختل	i x t a l l a
زوقال	z uː q aː l
مشرب	m a ʃ r a b
انزعاج	i n z i ʕ aː d͡ʒ
حنيف	ħ a n iː f
جسر	d͡ʒ i s r
عباءة	ʕ a b aː ʔ a
ساحلي	s aː ħ i l i j j
أغافث	ʔ a ɣ aː f i θ
وأد	w a ʔ a d a
ممرض	m u m a r r i dˤ
وصفة	w a sˤ f a
رمل	r a m l
مساحة	m a s s aː ħ a
إبريز	ʔ i b r iː z
بربري	b a r b a r i j j
إسحاق	ʔ i s ħ aː q
أصيص	ʔ a sˤ iː sˤ
كوسى	k uː s aː
أوقف	ʔ a w q a f a
منشار	m a n ʃ aː r
أكمون	ʔ a k m uː n
جريد	d͡ʒ a r iː d
تعس	t a ʕ a s a
ابرغش	i b r a ɣ a ʃ ʃ a
متماد	m u t a m aː d d
شدد	ʃ a d d a d a
عدمية	ʕ a d a m i j j a
حديقة	ħ a d iː q a
مريمية	m a r j a m i j j a
عقل	ʕ a q l
فنجنكشت	f a n d͡ʒ a n k u ʃ t
دهس	d a h a s a
اختصر	i x t a sˤ a r a
تخدر	t a x a d d a r a
شجا	ʃ a d͡ʒ aː
منون	m a n uː n
يسوع	j a s uː ʕ
أتقن	ʔ a t q a n a
ليث	l a j θ
معدات	m u ʕ a d d aː t
جلب	d͡ʒ a l a b
ثاودسيوس	θ aː w u d u s i j uː s
خشخاش	x a ʃ x aː ʃ
ناعم	n aː ʕ i m
استثناء	i s t i θ n aː ʔ
وضح	w a dˤ a ħ
آلة	ʔ aː l a
بشرة	b a ʃ a r a
تبرع	t a b a r r a ʕ a
لاسلطوية	l aː s u l tˤ a w i j j a
هوة	h u w w a
شيلثا	ʃ iː l θ aː
سهول	s u h uː l
مستقبلي	m u s t a q b a l i j j
نهب	n a h a b a
هجاء	h a d͡ʒ d͡ʒ aː ʔ
تناعس	t a n aː ʕ a s a
عرعر	ʕ a r ʕ a r
رسداق	r u s d aː q
عالي	ʕ aː l iː
فضح	f a dˤ a ħ a
جبل	d͡ʒ a b a l
فهرس	f i h r i s
شيء	ʃ a j ʔ
سقطرة	s u q u tˤ r a
جدار	d͡ʒ i d aː r
أمس	ʔ a m a s s a
مقاص	m a q aː sˤ sˤ
خلر	x u l l a r
وعليكم	w a ʕ a l a j k u m
استهلك	i s t a h l a k a
أوكلاهوما	ʔ uː k l aː h uː m aː
تبريز	t a b r iː z
مناخي	m a n aː x i j j
غاشم	ɣ aː ʃ i m
عمودي	ʕ a m uː d i j j
رمش	r a m a ʃ a
أيوب	ʔ a j j uː b
يشوع	j a ʃ uː ʕ
حطم	ħ a tˤ a m a
كراني	k a r r aː n i j j
قميحة	q a m iː ħ a
ازدان	i z d aː n a
دبغ	d a b a ɣ a
غبط	ɣ a b a tˤ a
كفى	k a f aː
مقطع	m a q tˤ a ʕ
أمازيغي	ʔ a m aː z iː ɣ i j j
إيران	ʔ iː r aː n
مضاربة	m u dˤ aː r a b a
نافذة	n aː f i ð a
مرقشيتا	m a r q a ʃ iː t aː
هريرة	h u r a j r a h
وبل	w a b a l a
فضول	f dˤ uː l
فوض	f a w w a dˤ a
أزأم	ʔ a z ʔ a m a
سنان	s i n aː n
هرول	h a r w a l
استئمارة	i s t i ʔ m aː r a
لثغة	l u θ ɣ a
سكون	s u k uː n
شلال	ʃ a l l aː l
بديهي	b a d iː h i j j
بلغاري	b u l ɣ aː r i j j
مقالة	m a q aː l a
طبقات	tˤ a b a q aː t
نساب	n a s s aː b
تكديس	t a k d iː s
مقاولة	m u q aː w a l a
مطرانية	m u tˤ r aː n i j j a
عصيان	ʕ i sˤ j aː n
عفيف	ʕ a f iː f
بيطرة	b a j tˤ a r a
فالودق	f aː l uː d a q
فجائي	f u d͡ʒ aː ʔ i j j
حنجري	ħ a n d͡ʒ a r i j j
سائح	s aː ʔ i ħ
أطل	ʔ a tˤ a l l a
مرتعب	m u r t a ʕ i b
عمل	ʕ a m a l
نافى	n aː f aː
فور	f a w r
شنع	ʃ a n n a ʕ a
نورج	n a w r a d͡ʒ
فوضى	f a w dˤ aː
هنيهة	h u n a j h a
ملعقة	m i l ʕ a q a
عشيرة	ʕ a ʃ iː r a
مواطنة	m u w aː tˤ a n a
إبيقوري	ʔ i b iː q uː r i j j
شخشيخة	ʃ u x ʃ iː x a
اقتصاد	i q t i sˤ aː d
بندقاني	b u n d u q aː n iː
بغاء	b i ɣ aː ʔ
مغرفة	m i ɣ r a f a
حالة	ħ aː l a
ضرة	dˤ a r r a
تعشيقة	t a ʕ i ʃ iː q a
عسكر	ʕ a s k a r
حرباء	ħ i r b aː ʔ
جنازة	d͡ʒ a n aː z a
ضمة	dˤ a m m a
شهوة	ʃ a h w a
ناخوذاة	n aː x uː ð aː h
مغنيسيا	m a ɣ n iː s i j aː
ضمور	dˤ u m uː r
ركن	r u k n
استخدم	i s t a x d a m a
أسياخ	ʔ a s j aː x
ثوم	θ uː m
استصح	i s t a sˤ a ħ ħ a
محيط	m u ħ iː tˤ
منفي	m a n f i j j
أشترغار	ʔ u ʃ t u r ɣ aː r
شراع	ʃ i r aː ʕ
أنكر	ʔ a n k a r a
احتقر	i ħ t a q a r a
إلحاق	ʔ i l ħ aː q
فقس	f a q a s a
مجادلة	m u d͡ʒ aː d a l a h
استمارة	i s t i m aː r a
زنبور	z a n b uː r
قراص	q u r r aː sˤ
استجاب	i s t a d͡ʒ aː b a
هنالك	h u n aː l i k a
أهلي	ʔ a h l i j j
أرز	ʔ a r a z z a
بغل	b a ɣ l
وسع	w a s i ʕ a
معقود	m a ʕ q uː d
هعخع	h u ʕ x u ʕ
رتينج	r a t iː n a d͡ʒ
غمود	ɣ u m uː d
توارى	t a w aː r aː
سلح	s a l a ħ a
جمانة	d͡ʒ u m aː n a
نياط	n i j aː tˤ
قابلة	q aː b i l a
سعال	s u ʕ aː l
رائب	r aː ʔ i b
مغلاق	m i ɣ l aː q
جاذبية	d͡ʒ aː ð i b i j j a
اشتباه	i ʃ t i b aː h
ردد	r a d d a d a
ازدهر	i z d a h a r a
صؤول	sˤ a ʔ uː l
نقطة	n u q tˤ a
مرقص	m a r q a sˤ
كلوتة	k a l l a w t a
جثجاث	d͡ʒ a θ d͡ʒ aː θ
تبشير	t a b ʃ iː r
استنفد	i s t a n f a d a
قفة	q u f f a
شعلة	ʃ u ʕ l a
بؤر	b u ʔ a r
شمشم	ʃ a m ʃ a m a
راقص	r aː q a sˤ a
قصيبة	q u sˤ a j b a
سلاطين	s a l aː tˤ iː n
فوضوي	f a w dˤ a w i j j
دغدغ	d a ɣ d a ɣ a
استدل	i s t a d a l l a
إسرنج	ʔ i s r i n d͡ʒ
حانوت	ħ aː n uː t
أباسخيرون	ʔ a b aː s x iː r uː n
كأس	k a ʔ s
أندر	ʔ a n d a r
دودة	d uː d a
زكريا	z a k a r i j j aː
تداعى	t a d aː ʕ aː
تقوض	t a q a w w a dˤ a
عربيزي	ʕ a r a b iː z i j j
استحضر	i s t a ħ dˤ a r a
كويكب	k u w a j k i b
أيهقان	ʔ a j h a q aː n
إريس	ʔ i r r iː s
باحث	b aː ħ a θ a
إدارة	ʔ i d aː r a
تغمى	t a ɣ a m m aː
استخرج	i s t a x r a d͡ʒ a
طبيبة	tˤ a b iː b a
سامور	s aː m uː r
استنتاج	i s t i n t aː d͡ʒ
أصفهان	ʔ a sˤ f a h aː n
أكثرية	ʔ a k θ a r i j j a
طالما	tˤ aː l a m aː
جذاب	d͡ʒ a ð ð aː b
جندية	d͡ʒ u n d i j j a
أغيد	ʔ a ɣ j a d
الكاميرون	a l k aː m iː r uː n
عمرة	ʕ u m r a
رقيب	r a q iː b
فرفيري	f i r f iː r i j j
رفس	r a f a s a
شوحة	ʃ uː ħ a
معجم	m u ʕ d͡ʒ a m
زحافة	z a ħ ħ aː f a
أنثوي	ʔ u n θ a w i j j
واقعة	w aː q i ʕ a
تدثر	t a d a θ θ a r a
حذلقة	ħ a ð l a q a
آمين	ʔ aː m iː n a
نموذجي	n a m uː ð a d͡ʒ i j j
عيد	ʕ a j j a d a
بصير	b a sˤ iː r
أمهل	ʔ a m h a l a
فودنج	f uː d a n a d͡ʒ
بطارخ	b a tˤ aː r i x
فيما	f iː m aː
حدوة	ħ a d w a
بسباس	b a s b aː s
أغلف	ʔ a ɣ l a f
قسيس	q i s s iː s
سمكة	s a m a k a
يافوخ	j aː f uː x
استغفر	i s t a ɣ f a r a
مشقة	m a ʃ a q q a
براين	b r aː j a n
تدريج	t a d r iː d͡ʒ
صوة	sˤ u w w a
إيا	ʔ i j j aː
مشحذ	m i ʃ ħ a ð
تنزانيا	t a n z aː n j aː
خطف	x a tˤ a f a
اتهم	i t t a h a m a
نبوغ	n u b uː ɣ
مزر	m i z r
جمع	d͡ʒ a m a ʕ a
ذئب	ð i ʔ b
محاضرة	m u ħ aː dˤ a r a
نسيم	n a s iː m
قطعة	q a tˤ a ʕ a
أتى	ʔ a t aː
سخبر	s a x b a r
انطلق	i n tˤ a l a q a
استثنائي	i s t i θ n aː ʔ i j j
واجهة	w aː d͡ʒ i h a
بعيثران	b a ʕ a j θ a r aː n
عثور	ʕ u θ uː r
منقار	m a n q aː r
أدبة	ʔ a d a b a
أصم	ʔ a sˤ a m m
رضوخ	r u dˤ uː x
اعتنى	i ʕ t a n aː
عشرات	ʕ a ʃ a r aː t
صدق	sˤ a d a q a
فلس	f a l a s a
أعصر	ʔ a ʕ sˤ a r a
اصطخم	i sˤ tˤ a x a m a
صداقة	sˤ a d aː q a
مضمار	m i dˤ m aː r
أرهب	ʔ a r h a b a
تعليق	t a ʕ l iː q
شهق	ʃ a h a q a
تمتم	t a m t a m a
تقزز	t a q a z z a z a
غلقة	ɣ a l q a
هانم	h aː n i m
إجباري	ʔ i d͡ʒ b aː r i j j
زرع	z a r a ʕ a
حربث	ħ u r b u θ
دعوة	d a ʕ w a
مورد	m a w r i d
طمأن	tˤ a m ʔ a n a
تشخيصي	t a ʃ x iː sˤ i j j
قاووش	q aː w uː ʃ
مقعدة	m a q ʕ a d a
جزع	d͡ʒ a z a ʕ a
اليسع	a l j a s a ʕ
شقة	ʃ a q q a
كمأ	k a m a ʔ
فالودج	f aː l uː d a d͡ʒ
مارس	m aː r a s a
أتون	ʔ a t t uː n
شركة	ʃ a r i k a
خلنجان	x a l a n d͡ʒ aː n
أفطس	ʔ a f tˤ a s
إجبار	ʔ i d͡ʒ b aː r
ضمران	dˤ a m r aː n
ضالين	dˤ aː l l iː n
برلمان	b a r l a m aː n
معاداة	m u ʕ aː d aː h
عصير	ʕ a sˤ iː r
شفة	ʃ a f a
هجرة	h i d͡ʒ r a
أشهل	ʔ a ʃ h a l
أحبك	ʔ u ħ i b b u k a
فراولة	f a r aː w i l a
صراط	sˤ i r aː tˤ
فاض	f aː dˤ a
مناعة	m a n aː ʕ a
سطوة	s a tˤ w a
مشرق	m a ʃ r i q
شمات	ʃ a m aː t
قبطان	q u b tˤ aː n
عطاط	ʕ a tˤ aː tˤ
شرسوف	ʃ u r s uː f
تلاشى	t a l aː ʃ aː
إناء	ʔ i n aː ʔ
صحح	sˤ a ħ ħ a ħ a
صدغ	sˤ a d ɣ
شاهدانق	ʃ aː h d aː n a q
لماذا	l i m aː ð aː
مفاجأة	m u f aː d͡ʒ a ʔ a
قرن	q a r a n a
هجليج	h a d͡ʒ l iː d͡ʒ
اتجه	i t t a d͡ʒ a h a
علامة	ʕ a l aː m a
معيار	m i ʕ j aː r
كستج	k a s t a d͡ʒ
قدوم	q a d d uː m
أشنان	ʔ u ʃ n aː n
فاجرة	f aː d͡ʒ i r a
وقود	w a q uː d
مميثا	m a m m iː θ aː
تقدم	t a q a d d a m a
مصعد	m i sˤ ʕ a d
رادف	r aː d a f a
شحاذ	ʃ a ħ ħ aː ð
انتهى	i n t a h aː
تاريخية	t aː r iː x i j j a
قيلولة	q a j l uː l a
باح	b aː ħ a
قذيفة	q a ð iː f a
سواكن	s a w aː k i n
قداحة	q a d d aː ħ a
كلخ	k a l x
ينع	j a n a ʕ a
زرزر	z u r z u r
محادثة	m u ħ aː d a θ a
بنجر	b a n d͡ʒ a r
بيرق	b a j r a q
مقود	m i q w a d
نهق	n a h a q a
لومي	l uː m i j j
كرج	k a r i d͡ʒ a
استعمر	i s t a ʕ m a r a
بيش	b iː ʃ
افترى	i f t a r aː
فتاة	f a t aː h
تصادم	t a sˤ aː d a m a
بهمن	b a h m a n
لاوس	l aː w s
داخل	d aː x a l a
لاتفي	l aː t f i j j
حجة	ħ i d͡ʒ d͡ʒ a
جحر	d͡ʒ u ħ r
قاء	q aː ʔ a
كذينق	k u ð iː n a q
الذي	a l l a ð iː
إعلامي	ʔ i ʕ l aː m i j j
إحصائي	ʔ i ħ sˤ aː ʔ i j j
أجل	ʔ a d͡ʒ a l
معلم	m a ʕ l a m
رجع	r a d͡ʒ a ʕ a
اقتاد	i q t aː d a
سقلاطون	s i q i l l aː tˤ uː n
شعبية	ʃ a ʕ b i j j a
استفسار	i s t i f s aː r
مزدهر	m u z d a h i r
تغلب	t a ɣ a l l a b a
حرج	ħ a r i d͡ʒ a
شتاء	ʃ i t aː ʔ
مخبأ	m a x b a ʔ
إلياس	ʔ i l j aː s
أصفاد	ʔ a sˤ f aː d
أوحل	ʔ a w ħ a l a
حشيش	ħ a ʃ iː ʃ
جعل	d͡ʒ a ʕ a l a
قفلوط	q a f a l uː tˤ
سنوت	s a n n uː t
غلا	ɣ a l aː
تصبصب	t a sˤ a b sˤ a b a
زرقطونا	z a r q a tˤ uː n aː
هبد	h a b d
رائس	r aː ʔ i s
استضاف	i s t a dˤ aː f a
عوج	ʕ i w a d͡ʒ
خرطال	x a r tˤ aː l
جيد	d͡ʒ a j j i d
بصل	b a sˤ a l
يتيم	j a t iː m
خفى	x a f aː
استعارة	i s t i ʕ aː r a
علم	ʕ a l a m
شيعة	ʃ iː ʕ a
معارضة	m u ʕ aː r a dˤ a
إرتريا	ʔ i r i t r i j aː
ملقن	m u l a q q i n
مغلق	m i ɣ l a q
فصيل	f a sˤ iː l
عدالة	ʕ a d aː l a
تنظيم	t a n ðˤ iː m
حديد	ħ a d iː d
نكاح	n i k aː ħ
اشتق	i ʃ t a q q a
يهوه	j a h w a h
فرجون	f i r d͡ʒ a w n
عطارد	ʕ u tˤ aː r i d
باطس	b aː tˤ u s
جنين	d͡ʒ a n iː n
معروف	m a ʕ r uː f
شاكرة	ʃ aː k i r a
سجستان	s a d͡ʒ i s t aː n
كوخ	k uː x
مكسور	m a k s uː r
سلبي	s a l b i j j
مكمل	m u k a m m a l
صفن	sˤ a f a n
وتدي	w a t a d i j j
عاصف	ʕ aː sˤ i f
دردق	d a r d a q
أرخبيل	ʔ a r x a b iː l
تربية	t a r b i j a
كعك	k a ʕ k
تأمور	t a ʔ m uː r
صحصح	sˤ a ħ sˤ a ħ
طرخون	tˤ a r x uː n
اتهام	i t t i h aː m
دون	d a w w a n a
جولق	d͡ʒ a w l a q
ملحن	m u l a ħ ħ i n
تذمر	t a ð a m m a r a
سريع	s a r iː ʕ
انفتح	i n f a t a ħ a
مراكش	m u r r aː k u ʃ
سروال	s i r w aː l
سقمونيا	s a q a m uː n i j aː
هود	h a w d
غيبة	ɣ a j b a
رحى	r a ħ aː
زحل	z u ħ a l
صعيد	sˤ a ʕ iː d
بضعة	b i dˤ ʕ a
بوسكورة	b uː s k uː r a
لبلاب	l a b l aː b
ثقبة	θ u q b a
غاص	ɣ aː sˤ a
كوسا	k uː s aː
ومض	w a m a dˤ a
الوداع	a l w a d aː ʕ
برقوق	b a r q uː q
رقم	r a q m
محادث	m u ħ aː d a θ
جلس	d͡ʒ a l a s a
عيادة	ʕ i j aː d a
وثيقة	w a θ iː q a
قيطون	q a j tˤ uː n
اقتسم	i q t a s a m a
درأ	d a r a ʔ a
وقع	w a q a ʕ a
مشجب	m i ʃ d͡ʒ a b
عرين	ʕ a r iː n
كوالا	k u w aː l aː
صغير	sˤ a ɣ iː r
بخص	b a x a sˤ
يعني	j a ʕ n iː
مستعرب	m u s t a ʕ r i b
مديرة	m u d iː r a
مشعاع	m i ʃ ʕ aː ʕ
مثنوية	m a θ n a w i j j a
رغيفة	r a ɣ iː f a
إدريس	ʔ i d r iː s
أجلح	ʔ a d͡ʒ l a ħ
انسجام	i n s i d͡ʒ aː m
ميويزج	m a j w iː z a d͡ʒ
قطة	q i tˤ tˤ a
ابتذل	i b t a ð a l a
رجينة	r a d͡ʒ iː n a
غمامة	ɣ a m aː m a
مدقة	m i d a q q a
أهيف	ʔ a h j a f
ضمخ	dˤ a m a x a
مسابقة	m u s aː b a q a
مجراف	m i d͡ʒ r aː f
رتيلاء	r u t a j l aː ʔ
موحش	m uː ħ i ʃ
نيلج	n a j l a d͡ʒ
قابلية	q aː b i l i j j a
مقدونس	m a q d uː n i s
فؤاد	f u ʔ aː d
تمنى	t a m a n n aː
كاذب	k aː ð i b
الأرض	a l ʔ a r dˤ
رافعة	r aː f i ʕ a
جذام	d͡ʒ u ð aː m
لبى	l a b b aː
أبيدجان	ʔ a b iː d d͡ʒ aː n
الجمعة	a l d͡ʒ u m a ʕ a
سكران	s a k r aː n
أعل	ʔ a ʕ a l l a
مخمل	m u x m a l
مغسلة	m a ɣ s a l a
سفود	s a f f uː d
طيفور	tˤ a j f uː r
مالك	m aː l i k
زمجر	z a m d͡ʒ a r a
أسس	ʔ a s s a s a
فوتنج	f uː t a n a d͡ʒ
مطار	m a tˤ aː r
ثابت	θ aː b i t
كبكب	k a b k a b a
ترجمة	t a r d͡ʒ a m a
أعطى	ʔ a ʕ tˤ aː
بطانة	b i tˤ aː n a
أحسن	ʔ a ħ s a n
مذاق	m a ð aː q
اشتاق	i ʃ t aː q a
أنعل	ʔ a n ʕ u l
نصاب	n a sˤ sˤ aː b
أرضة	ʔ a r a dˤ a
انشق	i n ʃ a q q a
متسامح	m u t a s aː m i ħ
عالمي	ʕ aː l a m i j j
قعد	q a ʕ a d a
ماحق	m aː ħ i q
حيطة	ħ a j tˤ a
سنط	s a n tˤ
أعتن	ʔ a ʕ t a n a
سندس	s u n d u s
ديبوذ	d a j b uː ð
ابتل	i b t a l l a
كراويا	k a r aː w i j aː
دثر	d a θ r
لأن	l i ʔ a n n a
صنارة	sˤ i n aː r a
إيريناوس	ʔ iː r iː n aː w u s
أنعم	ʔ a n ʕ a m
ارتعش	i r t a ʕ a ʃ a
إقامة	ʔ i q aː m a
زربطانة	z a r b a tˤ aː n a
أمسوخ	ʔ u m s uː x
حرقوص	ħ a r q uː sˤ
لؤلؤ	l u ʔ l u ʔ
برذون	b i r ð a w n
اعتقل	i ʕ t a q a l a
حجن	ħ a d͡ʒ a n a
دنر	d a n n a r a
سلجم	s a l d͡ʒ a m
بهر	b a h a r a
خلقي	x a l l i q iː
مصدق	m u sˤ a d d a q
البهاما	a l b a h aː m aː
مصاب	m a sˤ aː b b
مسطح	m u s a tˤ tˤ a ħ
بحار	b a ħ ħ aː r
بحر	b a ħ a r
إعلان	ʔ i ʕ l aː n
منالاوس	m i n aː l aː w u s
هالك	h aː l i k
تراجيديا	t r aː d͡ʒ iː d j aː
لقمة	l u q m a
طول	tˤ a w l
تفرغ	t a f a r r a ɣ a
ستارة	s i t aː r a
غطس	ɣ a tˤ a s a
طربوش	tˤ a r b uː ʃ
سلام	s a l aː m
زانية	z aː n i j a
لذلك	l i ð aː l i k a
ضوء	dˤ a w ʔ
تطوان	t a tˤ w aː n
غرور	ɣ u r uː r
قذارة	q a ð aː r a
فدائي	f i d aː ʔ i j j
قاوق	q aː w u q
درياق	d i r j aː q
رياضة	r i j aː dˤ a
معمل	m a ʕ m a l
أزعج	ʔ a z ʕ a d͡ʒ a
غرق	ɣ a r i q a
اشهل	i ʃ h a l l a
لبوس	l a b uː s
شرقي	ʃ a r q i j j
كمء	k a m ʔ
حورس	ħ uː r u s
صيخود	sˤ a j x uː d
صأل	sˤ a ʔ a l a
طلب	tˤ a l a b
زفر	z a f a r a
سيرج	s a j r a d͡ʒ
فسقية	f a s q i j j a
فسافس	f a s aː f i s
تصميم	t a sˤ m iː m
مصنع	m a sˤ n a ʕ
سوس	s a w i s a
كاعب	k aː ʕ i b
أمهري	ʔ a m h a r i j j
فردي	f a r d i j j
ظرفية	ðˤ a r f i j j a
شموخ	ʃ u m uː x
حنجرة	ħ a n d͡ʒ a r a
قاعة	q aː ʕ a
أكشف	ʔ a k ʃ a f a
رتيلة	r u t a j l a
فتة	f a t t a
نارجيل	n aː r a d͡ʒ iː l
عليق	ʕ u l l a j q
دشداشة	d i ʃ d aː ʃ a
خيزان	x iː z aː n
مقدر	m u q a d d a r
تباطأ	t a b aː tˤ a ʔ a
سلطانية	s u l tˤ aː n i j j a
كوبا	k uː b aː
قوق	q uː q
ثقيل	θ a q iː l
ركلات	r a k a l aː t
أبريل	ʔ a b r iː l
حدد	ħ a d d a d a
خيمة	x a j m a
اعتاض	i ʕ t aː dˤ a
نقض	n a q a dˤ a
أغار	ʔ a ɣ aː r a
أسطمة	ʔ u s tˤ u m m a
مقدار	m i q d aː r
إندونيسي	ʔ i n d uː n iː s i j j
زمانذاك	z a m aː n a ð aː k a
نهار	n a h aː r
بتليس	b i t l iː s
سفارة	s i f aː r a
قشف	q a ʃ i f a
انشقاق	i n ʃ i q aː q
فأس	f a ʔ s
قرقع	q a r q a ʕ a
إيثار	ʔ iː θ aː r
إسكتلندا	ʔ i s k u t l a n d aː
إصبع	ʔ i sˤ b a ʕ
منافس	m u n aː f i s
منتخب	m u n t a x a b
دراسي	d i r aː s i j j
اشهلال	i ʃ h i l aː l
تسعة	t i s ʕ a
إملاء	ʔ i m l aː ʔ
فالود	f aː l uː d
طنجير	tˤ a n d͡ʒ iː r
هذه	h aː ð i h
إرادي	ʔ i r aː d i j j
تزامن	t a z aː m a n a
شاور	ʃ aː w a r a
قتلة	q a t l a h
برذعة	b a r ð a ʕ a
خزانة	x i z aː n a
تصغير	t a sˤ ɣ iː r
سئم	s a ʔ i m a
غرد	ɣ a r a d
قرصعنة	q a r sˤ a ʕ a n n a
رتيل	r u t a j l
مرقاق	m i r q aː q
استقتل	i s t a q t a l a
سليقة	s a l iː q a
بسبايج	b a s b aː j a d͡ʒ
سعة	s a ʕ a
تراب	t u r aː b
مفتعل	m u f t a ʕ a l
أخصائي	ʔ a x i sˤ sˤ aː ʔ i j j
رقابة	r a q aː b a
مرسم	m a r s a m
تناقض	t a n aː q a dˤ a
گھڑیال	ɡʱ ə ɽ ɪ j ɑː l
پڑھنا	p ə ɽʱ n ɑː
چھینک	t͡ʃʰ ĩː k
نکالنا	n ɪ k ɑː l n ɑː
ابھیلاشا	ə bʱ iː l ɑː ʃ ɑː
کوتلماں	k oː t̪ ʊ l m ɑː n
سوکھ	s ʊ kʰ
کیمپ	k eː m p
کیمیا	k iː m ɪ j ɑː
ایمان	iː m ɑː n
جہازی	d͡ʒ ə ɦ ɑː z iː
لئے	l ɛː
ماہر	m ɑː ɦ ɪ ɾ
بسس	b ə s s
دلربا	d̪ ɪ l ɾ ʊ b ɑː
پستان	p ɪ s t̪ ɑː n
گارڈیولا	ɡ aː ɽ ɖ iː oː l aː
قدرت	q ʊ d ɾ ɑː t̪
محبت	m ʊ ɦ ə b b ə t̪
سائبان	s ɑː iː b ɑː n
جیون	d͡ʒ iː ʋ ə n
رجوران	r ə d͡ʒ ʊ r ɑː n
مظاہرہ	m ʊ z ɑː ɦ ɪ ɾ ɑː
منصور	m ə n s ʊ ɾ
دھوم	d̪ʱ uː m
چور	t͡ʃ oː ɾ
آئیرن	ɑː ɪ ɾ ə n
معین	m ʊ ʔ iː n
فتنہ	f ə t̪ n ə
نمبو	n ɪ m b uː
موعود	m oː ʕ uː d̪
کشما	k ʂ ə m ɑː
پیٹرسن	p eː ʈ ə ɾ s ə n
دکن	d̪ ʊ k n
چرخہ	t͡ʃ ə ɾ x ɑː
سناتن	s ə n ɑː t̪ ə n
جاپان	d͡ʒ ɑː p ɑː n
نفاذ	n ə f ɑː z
مایوس۔کن	m aː j oː s k ʊ n
اشبیلیہ	ə ʃ b iː l ɪ j ɑː ɦ
چہرہ	t͡ʃ ɪ ɦ ɾ ɑː
سويمور	s ʋ ə j ə m ʋ ə ɾ
کراہیت	k ɾ ɑː ɦ iː t̪
دوستی	d oʊ s t iː
مسجد	m ə s d͡ʒ ɪ d̪
ثبوت	s ə b uː t̪
آشکارا	ɑː ʃ k ɑː ɾ ɑː
دیرینہ	d̪ eɪ r iː n ɑː
دامودر	d ɑː m uː d̪ a r
تنازع	t̪ ə n ɑː z oː ʔ
ڈھانچہ	ɖʱ ɑː n t͡ʃ ɑː
بھائی	bʱ ɑː iː
ڈابسن	ɖ ɑː b s ə n
روزگار	r oː z ɡ ɑː r
کھیل	kʰ eː l
اسٹیون	ɪ s t̪ iː ʋ ə n
مظفر	m ʊ z f ə r
اسٹیڈیم	ə s t̪ iː d̪ iː m
رہنمائے	ɾ ə ɦ n ə m aː ɪ
دیویندر	d̪ eː ʋ iː n d̪ ɾ
ساحل	s ɑː ɦ ɪ l
گنت	ɡ ə n ɪ t̪ ə
مکہ	m ə kː ə
مباین	m ʊ b ɑː j n
دوری	d̪ oː r iː
بہاؤالدین	b ə ɦ ɑː ʔ ʊ d̪ d̪ iː n
شہلا	ʃ ə ɦ l ɑː
مہنگائی	m ə ɦ ə ŋ ɡ ɑː iː
سندھ	s ɪ n d̪ʱ
العبیدی	ʔ ɛː l ʕ ɛː b iː d̪ iː
دلجمعی	d ə l d͡ʒ ʊ m ʕ iː
معصوم	m ʕ ʊ s uː m
یوہان	j uː ɦ aː n
فلو	f l oː
علامہ	ʕ ə l aː m ə
ابوعبدالرحمن	ə b ʊ ʕ ə b d̪ ə l ɾ ɑː ɦ m ə n
سینا	s iː n ɑː
داڑم	d̪ ɑː ɽ ɪ m
پری	p ə ɾ iː
مرمت	m ə ɾ ə mː ə t̪
لاما	l ɑː m ɑː
صحابہ	s ʊ ɦ ɑː b ɑː
سرپنچ	s ə ɾ p ə n t͡ʃ
آیوکت	ɑː j oː k t̪
رب	ɾ ə b
پرمکھ	p ɾ ə m ʊ kʰ
مانے	m aː n eː
بوائز	b oʊ z
جاسوس	d͡ʒ ɑː s uː s
صبح	s ʊ b ɦ
ملک	m ʊ l k
رشادی	r ə ʃ ɑː d iː
اگرچیکہ	ə ɡ ə ɾ t͡ʃ iː k ɛː
شک	ʃ ʊ k
کھلاڑی	kʰ l ɑː ɽ iː
البتہ	a l b ə t̪ ɑː
چاول	t͡ʃ ɑː ʋ ə l
خبر	x ə b ə ɾ
رازداری	ɾ ɑː z d̪ ɑː ɾ iː
مدیرا	m ə d̪ iː ɾ ɑː
بنزین	b ə n z iː n
رخ	r ʊ x
امداد	ɪ m d̪ ɑː d̪
کورٹ	k ɔː r ʈ
سمپرداے	s ə m p ɾ ə d̪ ɑː eː
روپوش	r uː p oː ʃ
گندمی	ɡ ə n d̪ ʊ m iː
شانی	ʃ ɑː n iː
پابند	p ɑː b ə n d̪
الزہرہ	a l z ə h r ə
برکت	b ə ɾ k ə t̪
اڈوائزری	ə ɖ ʋ ɑː ɪ z ə ɾ iː
جڑواں	d͡ʒ ʊ ɽ ʋ ɑ̃ː
شاعر	ʃ ɑː j ə ɾ
ٹکٹس	ʈ ɪ k ʈ s
لغت	l ʊ ɣ ə t̪
انارکلی	ə n ɑː ɾ k ə l iː
سنہ	s ɪ̃ ŋ ɦ
مکین	m ʊ k iː n
مینہ	m ẽː ɦ
وفاقی	w ʊ f ɑː q iː
کھانگ	kʰ ɑ̃ː ɡ
سنتوش	s ʊ n t̪ oʊ ʃ
عالمی	ʕ ɑː l ə m iː
ضرور	z ə ɾ uː ɾ
پےنٹ	p eː n ʈ
ایل	ɑː ɪ l
سری	s ɾ iː
سدابہار	s ə d̪ ɑː b ə ɦ ɑː ɾ
خریدوانا	x ə ɾ iː d̪ ʋ ɑː n ɑː
بازو	b ɑː z uː
گلاس	ɡ l ɑː s
توہین	t̪ ɔː ɦ iː n
خودمختاری	x ʊ d̪ m ʊ x t̪ ɑː ɾ iː
کٹی	k ə ʈ iː
پھیلاو	pʰ ɛː l ɑː ʋ
بمبہ	b ə m bᵊ
منسلک	m ʊ n s ʊ l k
شناخت	ʃ ɪ n ɑː x t̪
سموسہ	s ə m oː s ɑː
ایرانڈیا	a iː r aː n d̪ iː aː
ٹھہراؤ	ʈʰ ɛ ɦ r ɑː oʊ
اتھان	ʊ t̪ t̪ʰ ɑː n
رنگاریڈی	ɾ ə ŋ g ɑː ɾ iː d̪ iː
انھیں	ʊ nʱ ẽː
یہودنی	j ə ɦ uː d̪ ɪ n iː
فولک	f oː l k
ارادہ	ʔ ɪ ɾ ɑː d̪ ə
متواتر	m ʊ t̪ ʋ ɑː t̪ ɾ
اضطراری	ɪ z t̪ ɪ ɾ ɑː ɾ iː
ایوان	ɛː ʋ ɑː n
غنہ	ɣ ʊ n n ə
الھند	ʔ ə l ɦ ɪ n d̪
سونا	s uː n ɑː
راکٹ	ɾ ɑː k ɪ ʈ
رسٹورنٹس	ɾ ə s ʈ ɔː ɾ ə n ʈ s
اجازت	ɪ d͡ʒ ɑː z ə t̪
صد	s ʊ d
خراش	x ə ɾ ɑː ʃ
کارخانہ	k ɑː r x ɑː n ə
ذاکر	z ɑː k ə r
مراکیش	m ɾ ɑː k ɛː ʃ
نبی	n ə b iː
گولی	ɡ oː l iː
معضون	m aː z uː n
تاڑ	t̪ ɑː ɽ
ڈوری	ɖ oː ɾ iː
چوتڑ	t͡ʃ uː t̪ ə ɽ
کیلے	k ɛː l eː
یوم	j oː m
جائپھل	d͡ʒ ɑː ɪ pʰ ə l
بھنڈاری	bʱ ʊ n ʈʰ ɑː r iː
شرع	ʃ ʊ r ʕ
عاقد	ʕ aː q ə d
آئندہ	ɑː ɪ n d̪ ə
نادیہ	n ɑː d̪ iː ɑː
شرینگر	ʃ ɾ iː n ə ɡ ə ɾ
اغوا	ɪ ɣ ʋ ɑː
ورزش	ʋ ə ɾ z ɪ ʃ
جمعہ	d͡ʒ ʊ m ʔ ɑː
شکایات	ʃ iː k aː j aː t̪
حرف	ɦ ɛː ɾ f
افرادی	ɑː f ɾ ɑː d̪ iː
تعاقب	t̪ ʕ ɑː q ʊ b
کلومیٹر	k ɪ l oʊ m iː t̪ ə ɾ
دوچار	d̪ ʊ t͡ʃ ɑː ɾ
کانفرنس	k ɑː n f ɾ ə n s
سمجھ	s ʊ m d͡ʒʱ
ادھو	a d̪ʱ oʊ
مسٹرسنہا	m ɪ s ʈ ə r s n ə h ɑː
سیرت	s iː r ə t̪
روس	ɾ uː s
تلوار	t̪ ə l ʋ ɑː ɾ
ترپاٹھی	t̪ ə ɾ p ɑː t̪ʰ iː
نذرآتش	n ɛː z ɾ ɑː t̪ ɪ ʃ
چوتر	t͡ʃ uː t̪ ə ɾ
مراکش	m ə ɾ ɑː k e ʃ
کارپوریٹر	k aː ɾ p ɔː ɾ iː ʈ ə ɾ
انتہاپسند	ɪ n t̪ e ɦ ɑː p ə s ə n d̪
اشتمالیت	ɪ ʃ t̪ e m ɑː l ɪ j ə t̪
سرشت	s ə ɾ ɪ ʃ t̪
پالیسی	p ɑː l iː s iː
منشیہ	m ə n ʊ ʂ j ə
عکس	a k s
جانور	d͡ʒ ɑː n ʋ ə ɾ
انتخاب	ɪ n t̪ ɪ x ɑː b
چائے	t͡ʃ aɪ ə
اوقافی	oː q aː f iː
اجتماع	ɪ d͡ʒ t̪ ɪ m aː ʕ
گرفتارشدہ	ɡ ɛ r f t̪ ɑː r ʃ ʊ d̪ ɑː
اتم	ɪ t̪ ə m
چھتیس	t͡ʃʰ a t iː s
معلم	m ʊ ʔ ə l l ɪ m
شاپر	ʃ ɑː p ə ɾ
سہل	s ə ɦ l
مروڑ	m ɛ ɾ ʋ ɔː ɽ
صالح	s ɑː l ɪ ɦ
درس	d ə r s
مہابھارت	m ə ɦ ɑː bʱ ɑː ɾ ə t̪
بجلی	b ɪ d͡ʒ l iː
گندھاری	g ʊ n d̪ ɦ ɑː ɾ iː
مندر	m ə n d̪ ɪ ɾ
پہن	p ɛː n
بونا	b ɔː n ɑː
غلام	ɣ ʊ l ɑː m
نافذالعمل	n aː f iː z ʔ ə l ʕ ə m ə l
پٹیل	p ʈ iː l
نسبت	n ɪ s b ə t̪
خریدار	x ə r iː d ɑː r
جسور	d͡ʒ ə s uː ɾ
ایکسپریس	aɪ k s p ɾ iː s
انڈیا	ɪ n ɖ ɪ j ɑː
تھکا	t̪ʰ ə k ɑː
تحریر	t̪ ʊ ħ r iː r
بہکا	b ə ɦ k ɑː
خدا	x ʊ d̪ ɑː
راہبہ	ɾ ɑː ɦ ɪ b ɑː
خادم	x ɑː d̪ ɪ m
کھانی	kʰ ɑː n iː
زہر	z ə ɦ ə ɾ
کے	k eː
رات	ɾ ɑː t̪
کمرے	k ə m ɾ eː
دارالقضات	d̪ ɑː ɾ ʊ l q ʊ z ɑː t̪
اندرا	ɪ n d r ɑː
کہاکہ	k ə ɦ ɑː k ə
انشاء	ɪ n ʃ ɑː ʔ
برسر	b ə r s ə r
رائلس	ɾ ɑː ɪ l s
دانیال	d ɑː n iː ɑː l
فوری	f ɔː r iː
پار	p ɑː ɾ
سیر	s ɛː ɾ
مسلمان	m ʊ s ə l m ɑː n
باقاعدہ	b ɑː q ɑː ɪ d̪ ɑː
فلسطین	f ɪ l ɪ s t̪ iː n
اگزامنیشن	a ɡ z ɑː m n ɪ ʃ ə n
ریکارڈس	ɾ eː k ɑː ɾ ʈ s
سے	s eː
کیڑا	k iː ɽ ɑː
ایرانی	iː ɾ ɑː n iː
معاملہ	m ʊ ɑː m l ɑː
تئیں	t̪ ɛː ɪ n
سوہال	s uː h aː l
الماس	ə l m ɑː s
سورج	s uː r d͡ʒ
آگ	aː ɡ
متقاضی	m ʊ t̪ q aː z iː
مشرق	m ɪ ʃ ɾ ɪ q
حصول	ɦ ʊ s uː l
مینا	m eː n ɑː
کوششیں	k oː ʃ ɪ ʃ ẽː
میزان	m iː z ɑː n
بارش	b ɑː ɾ ɪ ʃ
قواعد	q ə ʋ ɑː ɪ d̪
ڈھانک	ɖʱ ɑː n k
انگلی	ʊ ŋ ɡ l iː
امکانی	ə m k ɑː n iː
خنجر	x ə n d͡ʒ ə ɾ
طرابلس	t̪ ɾ ɑː b ʊ l s
کمپنی	k ə m p n iː
دھوپ	d̪ʱ uː p
کسی	k ə s iː
دانش	d̪ ɑː n ɪ ʃ
نظرانداز	n ʊ z ɾ ɑː n d̪ ɑː z
دستاویز	d ʊ s t aː ʋ iː z
رمضان	ɾ ə m z ɑː n
لکشمن	l ʊ k ʃ m ʊ n
رفت	ɾ ə f t̪
آکرمن	ɑː k ɾ ə m ə ɳ
پوت	p uː t̪
پردیب	p ə ɾ d̪ iː b
ترنمول	t ə r n m uː l
چھاڑ	t͡ʃʰ ɑː ɽ
نگرانی	n ɪ ɡ ɾ ɑː n iː
اکٹھا	ə k ʈʰ ɑː
پانی	p ɑː n iː
سنت	s a n t̪
پیکیج	p eː k iː d͡ʒ
برتن	b ə ɾ t̪ ə n
کارن	k ɑː ɾ ə n
متحدہ	m ʊ t̪ ɦ ɛ d̪ ɑː
مسئلہ	m ə s l ɑː
سابقہ	s ɑː b iː q ɑː
جوس	d͡ʒ oʊ s
ٹائلٹ	ʈ ɑː ɪ l ʈ
دال	d ɑː l
ڈاکٹر	ɖ ɑː k ʈ ə ɾ
نبردآزما	n ə b ɾ d̪ ɑː z m ɑː
اندلس	ʊ n d̪ ʊ l ʊ s
بانچنا	b ɑ̃ː t͡ʃ n ɑː
خزاں	x ɪ z ɑ̃ː
ون	ʋ ʊ n
فصل	f a s l
خسرہ	x ə s ɾ ɑː
ایجنٹ	eː d͡ʒ ə ɳ ʈ
سنوائی	s ʊ n oː ɑː iː
یکجا	j ə k d͡ʒ aː
کارنی	k aː r n iː
ڈکار	ɖ ə k ɑː ɾ
سلام	s ə l ɑː m
تسلیم	t̪ ə s l iː m
باہری	b ɑː ɦ ɪ r iː
نعرہ	n ɑː ɾ ɑː ɦ
ایشیا	ɑː ɪ ʃ iː ɑː
شیوشنکر	ʃ iː ʋ ʃ ə n k ə ɾ
سکنا	s ə k n ɑː
بکھراو	b ɪ kʰ ɾ ɑː ʋ
رامائن	ɾ ɑː m ɑː j ə n
اظہر	ʔ ɪ z ʱ ə r
رسول	ɾ ə s uː l
سہواس	s ə ɦ ʋ ɑː s
ببھکشا	b ʊ bʱ ʊ k ʂ ɑː
سبقت	s ʊ b q ʊ t̪
بشمول	b ə ʃ m ʊ l
آزمانا	ɑː z m ɑː n ɑː
ادعاء	ʔ ə d̪ ʕ aː
گروداس	ɡ ə r uː d̪ ɑː s
سنور	s ɪ n ʋ ɔː ɾ
جنت	d͡ʒ ə nː ə t̪
آسیب	ɑː s eː b
تحریک	t̪ ə ɦ ɾ iː k
ماک	m ɑː k
بپتسمہ	b ə p t̪ ɪ s m ɑː
راس	ɾ aː s
تنگ	t̪ ə ŋ ɡ
چوکا	t͡ʃ oʊ k ə
پتلون	p ə t̪ l uː n
پشاور	p e ʃ ɑː ʋ ə ɾ
ہرانا	ɦ ə ɾ ɑː n ɑː
انکاؤنٹر	ɪ n k aʊ n t̪ ɛ r
پرجا	p ɛ ɾ d͡ʒ ɑː
رومس	ɾ uː m s
مانکیا	m ɑː n k iː ɑː
صحافی	s ɪ ɦ ɑː f iː
مخملی	m ə x m ə l iː
چھونا	t͡ʃʰ uː n ɑː
سندر	s ʊ n d̪ ə ɾ
سمیع	s ə m iː ʕ
راضی	ɾ ɑː z iː
نصاب	n ɪ s ɑː b
اورمعیاری	ɔː ɾ m a ɪ j ɑː ɾ iː
مرتیو	m ɾ ɪ t̪ j uː
سننا	s ʊ n n ɑː
کمیونٹی	k a m j uː n ɪ ʈ iː
قلندر	q ə l ə n d̪ ə ɾ
ٹرینس	ʈ ɾ eː n s
ہمنوائی	ɦ ə m ‿ n ə ʋ ɑː iː
چھٹا	t͡ʃʰ ʊ ʈ ʈ ɑː
چیز	t͡ʃ iː z
لاکھ	l ɑː kʰ
انہ	ɑː n ɑː
کاپی	k ɑː p iː
بھالو	bʱ ɑː l uː
سوستک	s ʋ ə s t̪ ɪ k
ہاتھی	ɦ ɑː t̪ʰ iː
آکھیٹ	ɑː kʰ eː ʈ
آسام	ɑː s ɑː m
ہائیکورٹ	ɦ aː iː k ɔː ɾ ʈ
سمن	s ʊ m ə n
فورٹ	f ɔː ɾ ʈ
کونکنی	k uː n k n iː
مختصر	m ʊ x t̪ ə s ɪ ɾ
ذات	z ɑː t̪
ادھار	ʊ d̪ʱ ɑː ɾ
پٹی	p ʈ iː
لکیج	l ə k iː d͡ʒ
تتلی	t̪ ɪ t̪ l iː
مند	m ʊ n d
احمق	ə ɦ m ə q
خاطیوں	x ɑː t̪ iː j oː n
جن	d͡ʒ ɪ n n
بناوٹی	b ə n ɑː ʋ ə ʈ iː
نہا	n ə ɦ ɑː
دجلہ	d̪ ə d͡ʒ l ɑː
کوچ	k ʊ t͡ʃ
ہے	ɦ ɛː
زندگی	z ɪ n d̪ ə ɡ iː
النکار	ə l ə ŋ k ɑː ɾ
اتصال	ɪ t̪ t̪ ɪ s ɑː l
آخرت	ɑː x ɪ ɾ ə t̪
سوغات	s ɔː ɣ ɑː t̪
سرمئی	s ʊ ɾ m ə iː , s ə ɾ m ə iː
بکس	b ə k s
اطمینان	ɪ t̪ m iː n ɑː n
برمنگھم	b ə ɾ m ɪ n ɡʱ ə m
ہوس	ɦ ə ʋ ə s
آذربائیجان	ɑː z ə ɾ b ɑː ɪ d͡ʒ ɑː n
سہیل	s ə ɦ iː l
تولیہ	t̪ ɔː l ɪ j ə
بادشاہت	b ɑː d̪ ʃ ɑː ɦ ə t̪
کپوت	k ə p oː t̪
ارش	ə ɾ ʃ
سرور	s ʊ ɾ uː ɾ
باشاہ	b ɑː ʃ ɑː ɦ
جوہر	d͡ʒ ɔː ɦ ə ɾ
دلی	d̪ ɪ lː iː
پٹول	p ə ʈ oː l
کمی	k ə m iː
عروس	ʕ ʊ ɾ ʊ s
گرہن	ɡ ɾ ə ɦ ə n
عموما	ʊ m uː m ə n
اڈے	ə ɖ ɛː
یمن	j ə m ə n
نقشہ	n a k ʃ ɑː
تاڑی	t̪ ɑː ɽ iː
ٹائیلس	ʈ ɑː ɪ l s
ایتھنز	iː t̪ʰ ə n z
اگرچہ	ə ɡ ə ɾ t͡ʃ eː
بیمار	b eː m ɑː ɾ
اسپانچ	ɪ s p ɑː n t͡ʃ
زیرقیادت	z ɪː r q iː ɑː d̪ t̪
مچھلی	m ə t͡ʃʰ l iː
بہیمانہ	b ə h iː m aː n ə
ڈھا	ɖʱ ɑː
معاشرہ	m ʊ ʔ ɑː ʃ ɪ ɾ ɑː
اشبھ	ə ʃ ʊ bʱ
پذیرائی	p ə z iː r aː iː
چندناکھن	t͡ʃ ʊ n d̪ n ɑː kʰ n
سی	s iː
یونیورسٹی	j uː n iː ʋ a r s ʈ iː
میگھ	m eː ɡʱ
کولکاتا	k oː l k ɑː t̪ ɑː
یونٹس	j ʊ n ɪ t̪ s
دونا	d̪ uː n ɑː
علوم	ʔ ʊ l uː m
چیارٹیبل	t͡ʃ iː ɑː ɾ ʈ iː b ʊ l
ئن	ʔ ɪ n
نبھانے	n ʊ bʱ ɑː n eː
شریر	ʃ ə ɾ iː ɾ
بالخصوص	b ɑː l x a s ʊ s
داردر	d̪ ɑː ɾ ɪ d̪ ɾᵊ
اصیل	ə s iː l
بلغاریہ	b ʊ l ɣ ɑː ɾ ɪ j ɑː
اپلبدھ	ʊ p l ə b d̪ʱ
آوشيکتا	ɑː ʋ ə ʃ j ə k t̪ ɑː
مکواوگر	m a k ʋ ɑː ʋ ɡ ə ɾ
عہدہ	ʕ ɛː d̪ ɑː
الشیخ	ʔ ʊ l ʃ eː x
تاپنا	t̪ ɑː p n ɑː
میڈیم	m eː d̪ iː ə m
نیلا	n iː l ɑː
گزارش	ɡ ʊ z ɑː ɾ ɪ ʃ
سالومان	s ɑː l oː m ɑː n
رابطہ	ɾ ɑː b t̪ ɑː
چاندی	t͡ʃ ɑ̃ː d̪ iː
پسماندگی	p ə s m ɑː n d̪ ɡ iː
الگ	ə l ə ɡ
چانسلر	t͡ʃ ɑː n s ə l ə ɾ
اصغر	ɪ s ɣ ə ɾ
گمانا	ɡ ʊ m ɑː n ɑː
مجرمانہ	m ʊ d͡ʒ ɾ ɪ m ɑː n ɑː
آزادی	ɑː z ɑː d̪ iː
اچانک	ə t͡ʃ ɑː n ə k
ہچکنا	ɦ ɪ t͡ʃ ə k n ɑː
ڈگیس	ɖ ɪ ɡ iː s
تال	t̪ ɑː l
شہد	ʃ ə ɦ d̪
احمد	ʔ ə ɦ m ə d̪
سمجھنا	s ə m ə d͡ʒʱ n ɑː
برف	b ɛː ɾ f
ساحلی	s ɑː ɦ l iː
خربوزہ	x ə ɾ b uː z ɑː
اوہ	uː ɦ
کشور	k ə ʃ ʊ r
ڈسمبر	ɖ ə s m b ə ɾ
سلیور	s ʊ l j ɔː ɾ
چین	t͡ʃ iː n
انتہا	a n t̪ a ɑː
اخبار	ə x b ɑː ɾ
آسٹریا	ɔː s ʈ ɾ ɪ j ɑː
تبدیلی	t̪ a b d̪ iː l iː
تبریز	t̪ ə b ɾ eː z
تعداد	t̪ ə ʔ d̪ ɑː d̪
اکائی	ɑː k ɑː iː
رکشا	ɾ ə k ʂ ɑː
حرج	ħ ʊ r d͡ʒ
عابد	ʔ ɑː b ɪ d̪
مارنا	m ɑː ɾ n ɑː
عسکریت۔پسند	a s k ɛ ɾ iː t̪ p ʊ s n ʊ n d̪
ٹرانسکو	ʈ ɾ ɑː n s k oː
انت	ə n t̪
پہاڑ	p ə ɦ ɑː ɽ
ایران	iː ɾ ɑː n
طلبہ	ʈ ə l b ə ɦ
روزی	r oː z iː
آٹھواں	ɑː ʈʰ ʋ ɑ̃ː
قاتل	q ɑː t̪ ɪ l
کشادہ	k ə ʃ aː d̪ ə
بلکہ	b ə l k iː
تار	t̪ ɑː ɾ
بنفشی	b ə n ə f ʃ iː
اصلاح	ɪ s l ɑː ɦ
لنگایت	l ɪ ŋ ɡ ɑː j ə t̪
آسمانی	ɑː s m ɑː n iː
شام	ʃ ɑː m
پانڈو	p ɑː ɳ ɖ ə ʋ
روپیا	ɾ uː p iː ɑː
سالگرہ	s ɑː l ɡ ɪ ɾ ə ɦ
الیکٹریسٹی	æ l iː k t̪ r ɪ s t̪ iː
لیکھنی	l eː kʰ ə n iː
مہنگا	m ə ɦ ə̃ ɡ ɑː
پوشاک	p oː ʃ ɑː k
کفایتی	k ə f aː j t̪ iː
ایت	ə j ʊ t̪
ہائی	ɦ aɪ
اضافہ	ɪ z ɑː f ə
دھرم	d̪ʱ ə ɾ m
ناقد	n ɑː q ə d̪
لٹیرا	l ʊ ʈ iː ɾ ɑː
میڑچل	m eː ɽ t͡ʃ l
جوت	d͡ʒ oː t̪
کھنک	kʰ ə n ə k
راجا	ɾ ɑː d͡ʒ ɑː
اتحادی	ɪ t̪ t̪ ɪ ɦ ɑː d̪ iː
چاہت	t͡ʃ ɑː ɦ ə t̪
ساڑی	s ɑː ɽ iː
جراثیم	d͡ʒ ə ɾ ɑː s iː m
کھیلا	kʰ eː l ɑː
آموزش	ɑː m oː z ɪ ʃ
بنچ	b ə n t͡ʃ
کومٹ	k oː m ʈ
سہولت	s ʊ ɦ ʊ l t̪
اختیارکردہ	ə x t̪ iː j aː ɾ k ə ɾ d̪ ə ɦ
بےپناہ	b eː p n aː ɦ
رامچندر	ɾ ɑː m t͡ʃ ə n d̪ ɾ ə
نشر	n a ʃ r
آمریت	ɑː m ɪ ɾ ɪ j ə t̪
کمائی	k ə m ɑː iː
ژالہ	ʒ ɑː l ə
ڈیویژنل	ɖ iː ʋ iː ʒ n l
جوڑا	d͡ʒ oʊ ɽ ɑː
پٹل	p ə ʈ ə l
مفت	m ʊ f t̪
پوجنا	p uː d͡ʒ n ɑː
صارفین	s ɑː ɾ ɪ f iː n
پیام	p j ɑː m
افسوسناک	a f s oː s n ɑː k
چکنا	t͡ʃ ʊ k n ɑː
رکھا	ɾ ʊ kʰ ɑː
بدھیا	b ə d̪ʱ ɪ j ɑː
انتہاپسندی	ɪ n t̪ ɦ ɑː p s ə n d̪ iː
فالکن	f ɑː l k ə n
ریڈ	ɾ eː d̪
للاٹ	l ə l ɑː ʈ
گھرنا	ɡʱ ɾ ɪ n ɑː
وصال	ʋ ɪ s ɑː l
تیسرا	t̪ iː s ɾ ɑː
کو	k oː
بدن	b ə d̪ ə n
مستحکم	m ʊ s t̪ a ɦ k a m
اداس	ʊ d̪ ɑː s
چینلس	t͡ʃ iː n ə l s
میاتھمیٹکس	m j ɑː t̪ʰ m iː ʈ ɪ k s
تجارتی	t̪ ɪ d͡ʒ ɑː r t̪ iː
بااثر	b ɑː ʔ s ɛ ɾ
مطابق	m ʊ t̪ ɑː b ɪ q
بحر	b ə ɦ ɾ
موہنی	m oː h n iː
کنواری	k ʊ̃ ʋ ɑː ɾ iː
شترو	ʃ ə t̪ ɾ uː
کہنا	k ə ɦ n ɑː
منشیات	m ʊ n ə ʃː ɪ j ɑː t̪
تدریسی	t̪ ə d̪ ɾ iː s iː
ڈیولس	ɖ iː oː l s
ارمان	ə ɾ m ɑː n
انقلاب	ɪ n q ɪ l ɑː b
نادان	n ɑː d̪ ɑː n
بارہا	b ɑː ɾ ɦ ɑː
اثبات	ɪ s b ɑː t̪
جائیداد	d͡ʒ ɑː ɪ d̪ ɑː d̪
پہلا	p ə ɦ l ɑː
اوقاف	ɔː q ɑː f
اخراجات	ɑː x r ɑː d͡ʒ ɑː t
جلوس	d͡ʒ ʊ l uː s
لیگ	l iː ɡ
بادل	b ɑː d̪ ə l
اجگر	ə d͡ʒ ɡ ə ɾ
چال	t͡ʃ ɑː l
احترام	e ɦ t̪ ɪ ɾ ɑː m
واریرس	ʋ aː ɾ iː ɾ s
منڈا	m ʊ ɳ ɖ ɑː
کرکٹرس	k ɪ r k ɪ t̪ ɾ ʊ s
تحدید	t̪ ə h d̪ iː d̪
عناصر	ʕ ɪ n ɑː s ə r
پرچی	p ə ɾ ɪ t͡ʃ ə j
پپاسا	p ɪ p ɑː s ɑː
لیاپس	l iː ɑː p s
افراد۔سازی	ɑː f ɾ ɑː d̪ . s ɑː z iː
صدرجمہوریہ	s ʊ d ə r d͡ʒ ʊ m ʰ uː r iː ə
مسدود	m ʊ s d̪ uː d̪
گنبھیر	ɡ ə̃ m bʱ iː ɾ
شماری	ʃ ʊ m ɑː ɾ iː
مولا	m ɔː l ɑː
چھڑا	t͡ʃʰ ɽ aː
شاداب	ʃ ɑː d̪ ɑː b
چاشنی	t͡ʃ ɑː ʃ n iː
دکھ	d̪ ʊ kʰ
برخلاف	b ɪ ɾ x ɪ l ɑː f
قینچی	q ɛ̃ː t͡ʃ iː
مترا	m ʊ t̪ r ɑː
کاٹ	k ɑː ʈ
ربوہ	ɾ ə b ʋ ɑː ɦ
غرض	ɣ ʊ r d̪ z
کیئر	k iː ɛ ɾ
الارض	ʔ ʊ l ɑː ɾ z
میتو	m iː t̪ ʊ
ثالث	s ɑː l ɪ s
پٹھان	p ə ʈʰ ɑː n
وین	ʋ eː n
عبادت	ɪ b ɑː d̪ ə t̪
ورون	ʋ ə ɾ uː n
الم	ə l ə m
عبدالعزیز	ʕ ʊ b d ʊ l ʕ ʊ z iː z
باعزت	b ɑː ʕ ɪ z z ə t̪
کھاتا	kʰ ɑː t̪ ɑː
اخلاق	ə x l ɑː q
معلوم	m aː l uː m
مصیبت	m ʊ s iː b ə t̪
کشیدگی	k ə ʃ iː d̪ ɡ iː
پان	p ɑː n
انگور	ə n ɡ uː ɾ
ساتھ	s ɑː t̪ʰ
سلجوق	s ə l d͡ʒ uː q
فرمانا	f ə ɾ m ɑː n ɑː
فیصد	f iː s ə d̪
سردیاں	s ə ɾ d̪ ɪ j ɑ̃ː
جزیرہ	d͡ʒ a z iː r a
حامدالاحمر	ɦ ɑː m ɪ d̪ ʔ ɑː l ɑː ɦ m ɛː ɾ
آبی	ɑː b iː
تعمیراتی	t̪ ʕ ə m iː r ɑː t̪ iː
پلانٹ	p l ɑː n ʈ
امدادی	ə m d ɑː d̪ iː
پیرس	p ɛː ɾ ɪ s
کرس	k ɾ ʊ s
جغرافیائی	d͡ʒ ʊ ɣ ɾ ɑː f ɪ j ɑː iː
اوقات	ɔː q ɑː t̪
جھوٹی	d͡ʒ ʱ uː ʈ iː
شائد	ʃ ɑː ɪ d̪
بھونگیر	bʱ ʊ ŋ g iː r
پھلنا	pʰ ə l n ɑː
روزہ	ɾ oː z ɑː
ایووکیڈو	ɛ j uː k iː d oʊ
عزیز	ə z iː z
وجیہ	ʋ ə d͡ʒ iː ɦ
ایٹمی	ɛː ʈ m iː
گنی	ɡ ɪ n iː
واڑی	ʋ aː ɽ iː
دہی	d̪ eː ɦ iː
پرکلا	p ɛ ɾ k l ɑː
رنگت	ɾ ə ŋ ɡ ə t̪
غیرمحفوظ	ɣ ɛː ɾ m ɦ ʊ f ʊ z
نسبتا	n ɪ s b ə t̪ ə n
ایرلائینس	ɛː r l aɪ n s
انشورنس	ɪ n ʃ ʊ r ə n s
دھن	d̪ʱ ʊ n
خلفا	x ʊ l ə f ɑː
ڈنکرک	ɖ ə n k ə ɾ k
شین	ʃ iː n
لوتھ	l oː t̪ʰ
کوبائلوبہ	k ʋ ʊ b ɑː iː l ʋ ʊ b ɑː
کمھڑا	k ʊ mʱ ə ɽ ɑː
ڈگ	ɖ ə ɡ
موڈ	m oː d̪
دباؤ	d̪ ə b ɑː oː
پوچیا	p oː t͡ʃ iː ɑː
جوں	d͡ʒ ũː
پراکرت	p ɾ ɑː k ɾ ɪ t̪
بچپن	b ə t͡ʃ p ə n
ڈرونس	ɖ ɾ oː n s
راجیم	r ɑː d͡ʒ iː m
سوانگ	s ʋ ɑː ŋ ɡ
عوامی	ʕ ʋ aː m iː
کپڑا	k ə p ɽ ɑː
کنی	k ə n iː
قسط	q ɪ s t̪
حیاتیات	ɦ ə j ɑː t̪ ɪ j ɑː t̪
نکتہ	n ʊ k t̪ ɑː
تجدید	t̪ ə d͡ʒ d̪ iː d̪
لہسن	l ə ɦ s ʊ n
گھیرنے	ɡʱ iː r n eɪ
انڈکوش	ə ɳ ɖ ə k oː ʃ
تاجکستان	t̪ ɑː d͡ʒ ɪ k ɪ s t̪ ɑː n
بدعنوانی	b ə d̪ a n ʋ ɑː n iː
پارلیمنٹ	p aː ɾ l iː m ə n ʈ
لداخ	l ə d̪ː ɑː x
آتما	ɑː t̪ m ɑː
ننگا	n ə̃ ŋ ɡ ɑː
ہتیارا	ɦ ə t̪ j ɑː ɾ ɑː
نہ	n ɑː
لکشمیا	l ə k ʃ m iː aː
مرنا	m ə ɾ n ɑː
میوہ	m eː ʋ ɑː
کوششں	k oː ʃ ɪ ʃ a n
ممتا	m ʊ m t̪ ɑː
بندر	b ə n d̪ ə ɾ
کتاب	k ɪ t̪ ɑː b
ہنڈی	ɦ ʊ n ɖ iː
یروشلم	j ə ɾ uː ʃ ə l ə m
سوان	s ʋ ɑː n
خیرسگالی	x eː r s ɡ ɑː l iː
صرفہ	s ʊ ɾ f ɑː
مانچسٹر	m ɑ̃ː t͡ʃ ə s ʈ ə ɾ
خوبانی	x uː b ɑː n iː
چوتھا	t͡ʃ ɔː t̪ʰ ɑː
گیند	ɡ eː n d̪
جامعہ	d͡ʒ ɑː m ɪ ʔ ɑː
میٹرس	m eː t̪ ə r s
باولی	b aː oː l iː
کندرا	k ə n d̪ ə ɾ ɑː
جھنڈا	d͡ʒʱ ə n ɖ ɑː
نارائن	n ɑː ɾ ɑː ɪ n
خلاف	x ɪ l ɑː f
اللہ	ə l l ɑː ɦ
چوٹکی	t͡ʃʰ ʊ ʈ k iː
طلاق	t̪ ə l ɑː q
شہزادہ	ʃ ə ɦ z ɑː d̪ ɑː
صدی	s ə d̪ iː
بلاآواز	b a l ɑː ɑː ʋ ɑː z
نماز	n ə m ɑː z
ٹورسٹ	ʈ ɔː ɾ s ʈ
برچھا	b ə ɾ t͡ʃʰ ɑː
در	d ɑː ɾ
اشتقاق	ɪ ʃ t̪ ɪ q ɑː q
ٹیلی	ʈ iː l iː
انظر	ɪ n z ɾ
انتظام	ɪ n t̪ ɪ z ɑː m
بریہ	b ə ɾ j ə
حراست	ɦ ɪ ɾ ɑː s ə t̪
پریسیڈنٹ	p ɾ eː s iː ɖ ə n ʈ
بٹورنا	b ə ʈ oː ɾ n ɑː
قسمت	q ɪ s m ə t̪
ترجمہ	t̪ ə ɾ d͡ʒ ʊ m ɑː
محشر	m ə ɦ ʃ ə ɾ
آدھنک	ɑː d̪ʱ ʊ n ɪ k
دھواں	d̪ʱ uː ɑ̃ː
قابل	q ɑː b ɪ l
گہہ	ɡ ə ɦ ɦ
مڈبھیڑ	m ʊ d̪ bʱ iː ɽ
ایسی	aɪ s iː
شیر	ʃ iː ɾ
صائب	s ɑː ɪ b
چنانچہ	t͡ʃ ʊ n ɑː n t͡ʃ ɑː
چھٹپٹانا	t͡ʃʰ ə ʈ p ə ʈ ɑː n ɑː
میرا	m eː ɾ ɑː
اسکینڈلس	ə s k iː n d̪ ə l s
دیش	d̪ eː ʃ
فارمس	f ɑː r m s
ریکارڈز	ɾ eɪ k ɑː ɾ ɖ z
کنٹک	k ə n ʈ ɪ k
طبیعیات	t̪ ə b iː ʔ j ɑː t̪
مہاراشٹر	m ə ɦ ɑː ɾ ɑː ʃ ʈ ə ɾ
انفراسٹرکچر	ɪ n f r ɑː s t̪ ɾ ʊ k t̪ʃ ʊ ɾ
دستی	d̪ ə s t̪ iː
الیکشن	a l iː k ʃ a n
تقلید	t̪ ə q l iː d̪
ہمیں	ɦ ə m ẽː
حملہ	ɦ ə m l ɑː
عجائب	ə d͡ʒ ɑː ɪ b
کھڑی	kʰ ə ɽ iː
تمام	t̪ ə m ɑː m
رامو	ɾ ɑː m ʊ
گنیش	ɡ ə ɳ eː ʃ
کس	k ʊ s
حریت	ħ ʊ r iː t̪
پون	p ə ʋ ə n
شبانہ	ʃ ə b ɑː n ɑː
باز	b ɑː z
سربرآوردہ	s ɛ r b ɛ r ɑː ʋ ɛ r d̪ ɑː
عجائبات	ə d͡ʒ ɑː ɪ b ɑː t̪
نشریات	n ə ʃ ɾ ɪ j ɑː t̪
حفاظت	ɦ ɪ f ɑː z ə t̪
سبھا	s ə bʱ ɑː
ہوشیار	ɦ oː ʃ ɪ j ɑː ɾ
لگانا	l ə ɡ ɑː n ɑː
صلیب	s ə l iː b
تمھارا	t̪ ʊ mʱ ɑː ɾ ɑː
دیوناگری	d̪ eː ʋ n ɑː ɡ ɾ iː
لیکچرر	l iː k t͡ʃ ə ɾ ɾ
پرندہ	p ə ɾ ɪ n d̪ ɑː
ہمارا	ɦ ə m ɑː ɾ ɑː
صحت	s ɪ ɦ ə t̪
ایڈس	ɑː iː d̪ s
عنابی	ʊ n n ɑː b iː , ə n ɑː b iː
کا	k ɑː
سنجیدہ	s ʊ n d͡ʒ iː d a
مجسٹریل	m ʊ d͡ʒ s t̪ ɪ r iː l
اخذ	ə x z
مقدر	m ʊ q d̪ ɑː ɾ
حویلی	ɦ ə ʋ eː l iː
ڈپارٹمنٹ	ʈ p ɑː ɾ ʈ m ʊ n ʈ
شلپا	ʃ ʊ l p ɑː
بیزار	b eɪ z ɑː r
بھارتیہ	bʰ ɑː r t iː ə
مسلح	m ʊ s l ɛ ɦ
ایلینا	ʔ eː l iː n ɑː
انتقال	ɪ n t̪ iː q ɑː l
ٹاکیوو	ʈ ɑː k j oː v
صحیح	s ə ɦ iː
لرزاں	l ə ɾ z ɑ̃ː
تعمیری	t̪ ʕ ə m iː r iː
واقعاتی	ʋ ɑː q eː ɑː t̪ iː
پارٹنر	p aː ɾ ʈ n ə ɾ
چنگال	t͡ʃ ə ŋ ɡ ɑː l
ثقافت	s ə q ɑː f ə t̪
مینار	m iː n aː r
خریدی	x ə r iː d iː
اسٹیم	ɪ s ʈ iː m
بادامی	b ɑː d̪ ɑː m iː
انٹرنیشنل	ɪ n ʈ ə r n iː ʃ ə n ə l
نمائند	n ʊ m aː ɪ n d̪
ورنگل	ʋ ɔː r n ɡ a l
ویژن	ʋ iː ʒ ə n
چشتی	t͡ʃ ɪ ʃ t̪ iː
پرابین	p ə ɾ aː b iː n
تھوک	t̪ʰ uː k
چنگل	t͡ʃ ʊ ŋ ɡ ʊ l
دہلی	d̪ ɛ ɦ l iː
چای	t͡ʃ ɑː j
فلاحی	f l ɑː ɦ iː
چابی	t͡ʃ ɑː b iː
سستی	s ʊ s t̪ iː
جس	d͡ʒ ʊ s
کمبلے	k ə m b l eː
آغوش	ɑː ɣ oː ʃ
کشدھا	k ʂ ʊ d̪ʱ ɑː
سرزنش	s ə ɾ z n ɪ ʃ
بقرعید	b ə q ɾ iː d̪
خدمت	x ɪ d̪ m ə t̪
دھماکہ	d̪ʱ ə m ɑː k ɑː ɦ
بہن	bʱ ɛː n
پینل	p eː n l
راو	r aː ʋ
گرفتاری	ɡ ɾ ɪ f t̪ ɑː ɾ iː
قابض	q ɑː b ɪ z
عیسیٰ	iː s ɑː
مواقع	m ə ʋ ɑː q eː
شاہی	ʃ ɑː ɦ iː
طینت	ʈ ɪ n t̪
غرناطہ	ɣ ə ɾ n ɑː t̪ ɑː ɦ
رد	ɾ ə d̪ d̪
نسق	n ɪ s q
ضبط	z a b t
دعائے	d̪ʊ ɑː ɪ eː
ندیو	n ə d̪ ɪ j oː
گردوارہ	ɡ ʊ ɾ d̪ ʋ ɑː ɾ ɑː
دو	d̪ oː
سوز	s ʊ z
لہذا	l ɪ ɦ ɑː z ɑː
راکھ	ɾ ɑː kʰ
گرجنا	ɡ ə ɾ ə d͡ʒ n ɑː
پھوڑا	pʰ oː ɽ ɑː
بےہوش	b eː ɦ oː ʃ
راجو	ɾ ɑː d͡ʒ oː
چاٹ	t͡ʃ ɑː ʈ
ملائیشیا	m ə l ə j ʃ ɪ j ɑː
روایاتی	ɾ ʋ ɑː j ɑː t̪ iː
خودکش	x ʊ d̪ k ʊ ʃ
ہمسفر	ɦ ə m s ə f ə ɾ
گینڈا	ɡ ɛː ɳ ɖ ɑː
کاری	k ɑː ɾ iː
بےحیائی	b eː ɦ j ɑː iː
بھوت	bʱ uː t̪
مرد	m ə ɾ d̪
ٹسکرس	ʈ s k ə ɾ s
شادی	ʃ ɑː d̪ iː
استفسار	a s t a f s aː r
چوڑائی	t͡ʃ ɔː ɽ ɑː iː
مباحثہ	m ʊ b aː h a tʰ a
پاکستان	p ɑː k ɪ s t̪ ɑː n
غیرضروری	ɣ eː ɾ z ə ɾ uː ɾ iː
تندرستی	t̪ ə n d̪ ʊ ɾ ʊ s t̪ iː
سفارتخانہ	s ɪ f ɑː ɾ ə t̪ x ɑː n ɑː
مکرجی	m a k ɾ d͡ʒ iː
کھاگ	kʰ ɑː ɡ
یہود	j ə ɦ uː d̪
محتاجی	m ʊ h t̪ ɑː d͡ʒ iː
ساری	s ɑː r iː
پارٹنرشپ	p ɑː r t n ɛ r ʃ ɪ p
اپستھت	ʊ p ə s t̪ʰ ɪ t̪
تلخ	t̪ ə l̪ ə x
کھڑا	kʰ ə ɽ ɑː
سربیائی	s ʊ r b iː ɑː iː
عوام	ə ʋ ɑː m
نور	n ʊ r
اومیش	oː m iː ʃ
جہازرانی	d͡ʒ ə ɦ ɑː z r ɑː n iː
علاج	ʔ ɪ l ɑː d͡ʒ
الجھن	ʔ ə l d͡ʒ ʱ ʊ n
داغ	d̪ ɑː ɣ
داستان	d̪ ɑː s t̪ ɑ̃ː
بھوک	bʱ uː k
سانپ	s ɑ̃ː p
احسان	ə ɦ ə s ɑː n
یونیسیف	j uː n iː s iː f
کیمیکل	k iː m iː k ə l
ترجیح	t̪ ə ɾ d͡ʒ iː ɦ
پستہ	p ɪ s t̪ ɑː
بهیس	bʱ eː s
گودھرا	ɡ oː d̪ʱ ɾ aː
لیٹنا	l eː ʈ n ɑː
گھرا	ɡʱ ɛː ɾ ɑː
نشست	n ə ʃ ɪ s t̪
باضابطہ	b ɑː z ɑː b ɪ t̪ ɦ ɑː
روانہ	ɾ ə ʋ ɑː n ɑː
سماس	s ə m ɑː s
کم	k a m
گنگ	ɡ ʊ ŋ ɡ
خصوص	x ʊ s uː s
یومی	j oː m iː
مینڈس	m eː n ɖ s
روشنی	ɾ ɔː ʃ n iː
گوناگوں	ɡ oː n ɑː ɡ oː n
بریگیڈیر	b ɾ iː ɡ eɪ d̪ iː r
جدا	d͡ʒ ʊ d̪ ɑː
وفا	ʋ ə f ɑː
بجٹ	b ə d͡ʒ ʈ
سمئے	s ə m ə j
اروکھ	aː r oː kʰ
سفر	s ə f ə ɾ
آگاہ	ɑː ɡ aː ɦ
سات	s ɑː t̪
اسپائس	ɪ s p aɪ s
لیفٹیننٹ	l iː f ʈ iː n ə n ʈ
قاعدہ	q ɑː ʔ ɪ d̪ ɑː ɦ
ویرنمنٹ	ʋ iː ɾ n ə m ə n t̪
کنسلٹنگ	k a n s a l t̪ ɪ ŋ ɡ
خود	x ʊ d̪
جہنم	d͡ʒ ə ɦ ə n n ə m
ونڈے	ʋ ʊ n ʈ eː
یوگیتا	j oː g iː t̪ ɑː
فائر	f aː ɪ ɾ
یوں	j ʊː n
بکری	b ə k ɾ iː
کھجلی	kʰ ʊ d͡ʒ l iː
نسچل	n ə s t͡ʃ ə l
بیٹے	b eː ʈ eː
پنجاب	p ə n d͡ʒ ɑː b
ہنس	ɦ ə n s
بھکت	bʱ ə k t̪
وینکٹیش	ʋ eː n k ʈ iː ʃ
غیرموسمی	ɣ ɛː ɾ m oː s m iː
ہوڑا	ɦ ʊ r ɑː
ادعا	ɑː d̪ ʊ ɑː
خاکستری	x ɑː k ɪ s t̪ ə ɾ iː
علما	ʕ ə l m ɑː
اگان	ə ɡ ɑː n
ککش	k ə k ʃ
انگلانگ	ɪ ŋ g l ɑː ŋ g
بھکتی	bʱ ə k t̪ iː
تھیلا	t̪ʰ iː l ɑː
حنا	ɦ ɪ n ɑː
بینچ	b iː n t͡ʃ
امیت	a m iː t̪
سوتیلا	s ɔː t̪ eː l ɑː
پھیلی	pʰ eː l iː
گورو	ɡ ɔː ɾ ə ʋ
حافظ	ħ ɑː f ɪ z
پیلاگو	p iː l aː ɡ oː
زائد	z ɑː ɪ d
ہاں	ɦ ɑ̃ː
غزہ	ɣ ə z ə
مہاجرت	m ʊ ɦ ɑː d͡ʒ ə ɾ ə t̪
فاروق	f ɑː ɾ ʊ q
سائنسی	s ɑː ɪ n s iː
خراج	x ə r ɑː d͡ʒ
آنجہانی	ɑː n d͡ʒ ə h aː n iː
مچھرکش	m ʊ t͡ʃʰ ɾ k ɪ ʃ
ہسپانیہ	ɦ ə s p ɑː n ɪ j ə ɦ
برما	b ə ɾ m ɑː
قانون	q ɑː n uː n
بجائے	b ʊ d͡ʒ aː ɪ ə
جاننا	d͡ʒ ɑː n n ɑː
خاتون	x ɑː t̪ uː n
شہادت	ʃ ə ɦ ɑː d̪ ə t̪
ہنومان	ɦ ə n ʋ oː m aː n
بھانگ	bʱ ɑː ŋ ɡ
تلبیہ	t̪ ə l b iː ə
ڈین	ɖ iː n
سلجھ	s ʊ l d͡ʒ ɦ
مفاہمت	m ʊ f ɑː ɦ ɪ m ə t̪
فرق	f ɾ q
سختی	s a x t̪ iː
گرڈ	ɡ ə ɾ ʊ ɖ
فیریرو	f eɪ r iː r oʊ
اونٹ	ũː ʈ
لڑکی	l ə ɽ k iː
رفتہ	r a f t ə
صحافت	s ɪ ħ ɑː f ə t̪
باشندہ	b ɑː ʃ ɪ n d̪ ɑː
ہفتہ	ɦ ə f t̪ ɑː ɦ
آواز	ɑː ʋ ɑː z
خوبصورت	x uː b s uː ɾ ə t̪
اپاہج	ə p ɑː ɦ ɪ d͡ʒ
ٹم	t̪ a m
جسونت	d͡ʒ ʊ s ʊ n t̪
فٹچ	f ʈʃ
ابتر	ə b t̪ ə ɾ
واحد	ʋ ɑː ɦ ɪ d̪
قدر	q a d r
ترجمان	t̪ ə ɾ d͡ʒ ʊ m ɑː n
پور	p uː ɾ
سینکڑہ	s eː n k ɽ ə ɦ
ویٹرنری	w eː ʈ ə r n ə r iː
گین	ɡ eː n
صفائی	s ɪ f ɑː iː
ایمبرسمنٹ	ɛ m b ɾ ɛ s m ɛ n ʈ
محروسی	m ʊ ɦ r uː s iː
آکسیجن	ɑː k s iː d͡ʒ ə n
بھرن	bʱ ə ɾ ə n
درگاہ	d ə r ɡ ɑː ɦ
دیواکر	d̪ iː ʋ ɑː k ə ɾ
جگر	d͡ʒ ə ɡ ə r
الطاف	a l t̪ ɑː f
کرن	k ɪ ɾ ə n
سرسوتی	s ə ɾ ə s ʋ ə t̪ iː
کامرس	k aː m ə ɾ s
مانشیرا	m ɑː n ʃ iː ɾ ɑː
سرمہ	s ʊ ɾ m ɑː
ثروت	s ə ɾ ʋ ə t̪
چدمبرم	t͡ʃ ʊ d̪ m b ʊ ɾ m
دیوانہ	d̪ iː ʋ ɑː n ə
کلاونت	k ə l ɑː ʋ ə n t̪
سنوار	s ʊ n ʋ ɑː r
دستبردار	d̪ ʊ s t̪ b ɛ r d̪ ɑː r
کبج	k ʊ b d͡ʒ
تہائی	t̪ ɪ ɦ ɑː iː
آپ	ɑː p
اصل	ə s ə l
قدوائی	q ʊ d̪ ʋ aː ɪ
انجانا	ə n d͡ʒ ɑː n ɑː
بیٹسمےن	b eː ʈ s m ɛ n
اولمپک	ʔ aʊ l m p ɪ k
خون	x uː n
مکرم	m ʊ k r ʊ m
سائنسداں	s ɑː ɪ n s d̪ ɑː n
شیواجی	ʃ iː ʋ ɑː d͡ʒ iː
میدان	m eː d̪ ɑː n
وامن	ʋ ɑː m ə n
ندیم	n ə d̪ iː m
زینت	z eɪ n ə t̪
فورسٹ	f ɔː r s t̪
لڑکا	l ə ɽ k ɑː
شوٹنگ	ʃ oː ʈ ɪ ŋ
اقتصادی	ɪ q t̪ ɪ s ɑː d̪ iː
وہ	ʋ oː
بابرہ	b ɑː b ɾ ɑː
انعام	ɪ n ʕ aː m
للن	l ʊ l ə n
دھو	d̪ʱ uː
ماہرین	m ɑː ɦ ɪ ɾ iː n
جٹا	d͡ʒ ə ʈ ɑː
اقامت	ɪ q ɑː m ə t̪
کھنکنا	kʰ ə n ə k n ɑː
غلطی	ɣ ə l ə t̪ iː
دھاندلی	d̪ʱ ɑː n d̪ l iː
بلز	b ə l z
کیسی	k eɪ s iː
طوطی	ʈ ɔː ʈ iː
خواب	x ɑː b
کتا	k ʊ t̪ t̪ ɑː
جاپانی	d͡ʒ ɑː p ɑː n iː
رائے	ɾ ɑː j
کمل	k ə m ə l
یافتہ	j ɑː f t̪ ɑː
پاؤں	p ɑ̃ː ũː
دھوج	d̪ʱ ʋ ə d͡ʒ
لوشیا	l oː ʃ iː ɑː
فائدہ	f ɑː ɪ d̪ ə
اوباما	ɔː b ɑː m ɑː
قلعہ	q ɪ l ɑː
ایشیائی	ɑː iː ʃ iː ɑː iː
بش	b ʊ ʃ
جنیئو	d͡ʒ ə n eː uː
بحسن	b ɦ ʊ s n
کالم	k aː l ʊ m
ازاں	ɑː z ɑː n
خریدنا	x ə ɾ iː d̪ n ɑː
اکثریت	a k s ʊ ɾ iː t̪
اطالیہ	ɪ t̪ ɑː l ɪ j ɑː ɦ
خطیر	x ə t̪ iː r
ماریشیس	m ɑː r iː ʃ iː s
جھک	d͡ʒʱ ə k
ارتعاش	ɪ ɾ t̪ eː ɑː ʃ
برت	b ə r t̪
ریشی	r eː ʃ iː
فانی	f ɑː n iː
ہچکی	ɦ ɪ t͡ʃ k iː
فرمائش	f ə ɾ m ɑː ɪ ʃ
طالبا	t̪ ɑː l ɪ b ɑː
نوٹ	n oʊ t
درسگاہ	d̪ ə r s ɡ ɑː ɦ
آدمی	ɑː d̪ m iː
بھال	bʱ ɑː l
تخلیہ	t ə x l iː ə
اطلاقی	ɪ t̪ l ɑː q iː
اترپردیش	ʊ t̪ ə ɾ p ə ɾ d̪ eː ʃ
ٹیکسی	ʈ iː k s iː
کڑپہ	k a r p a
چنتا	t͡ʃ ɪ n t̪ ɑː
کالجس	k ɑː l d͡ʒ ə s
بہشت	b ɪ ɦ ɪ ʃ t̪
دلیل	d ɪ l iː l
مربع	m ʊ ɾ b ɑː
رگھوناتھ	r ʊ gʱ oʊ n ɑː t̪ʰ
پلانڈو	p ə l ɑː ɳ ɖ uː
گانا	ɡ ɑː n ɑː
گاڑی	ɡ ɑː ɽ iː
برادرنسبتی	b ɾ ɑː d̪ ə r n ɪ s b ə t̪ iː
کوچس	k oː t͡ʃ ə s
سلامی	s ə l aː m iː
کری	k ə ɾ iː
اصول	ʊ s uː l
چھال	t͡ʃʰ ɑː l
گرانٹس	ɡ r ɑː n t s
ہنوز	ɦ ə n oː z
خصوصا	x ʊ s uː s ə n
گھڑی	ɡʱ ə ɽ iː
قرآن	q ʊ ɾ ʔ ɑː n
تكميل	t̪ ə k m iː l
باقاعدگی	b ɑː q ɑː ʔ ɪ d̪ ɡ iː
غیر	ɣ ɛː ɾ
جینت	d͡ʒ iː n t̪
اجوائن	ə d͡ʒ ʋ ɑː ɪ n
سنجیدگی	s ʊ n d͡ʒ iː d̪ ɡ iː
دس	d̪ ə s
کردنت	k ɾ ɪ d̪ ə n t̪
لاگو	l ɑː ɡ ʊ
سمترا	s ə m t̪ r ɑː
عراق	ɪ ɾ ɑː q
غلبہ	ɡʱ ʊ l b ɑː
نخرا	n ə x ɾ ɑː
ورما	ʋ ɔː ɾ m ɑː
کمان	k ə m ɑː n
انگلستان	ɪ ŋ ɡ l ɪ s t̪ ɑː n
بادشاہ	b ɑː d̪ ʃ ɑː ɦ
مکل	m ʊ k l
المقدس	ʔ ə l m ʊ q d̪ ə s
لہرانا	l ɛ ɦ ɾ ɑː n ɑː
جمہوریہ	d͡ʒ ʊ m ɦ uː ɾ ɪ j ɑː
کرانیکل	k ə r ɑː n iː k ə l
آس	ɑː s
ڈاکیہ	ɖ ɑː k ɪ j ɑː
کون	k ɔː n
جنسی	d͡ʒ ʊ n s iː
طور	t̪ ɔː ɾ
انہوں	ʔ ʊ n ɦ ʊ n
اسم	ɪ s m
چھاونی	t͡ʃʰ ɑː ʋ n iː
لدھیانہ	l ʊ d̪ʱ ɪ j ɑː n ɑː
پسینہ	p ə s iː n ɑː
متعلق	m ʊ t̪ ʕ ʊ l ɪ q
تماریڈی	t̪ ə m ɑː ɾ iː ɖ iː
سوالیہ	s uː aː l iː ə
سپریمو	s ʊ p ɾ iː m oː
چندربند	t͡ʃ ə n d̪ ə ɾ ə b ɪ n d̪ ʊ
فارسی	f ɑː ɾ s iː
سؤر	s uː ə ɾ
گرمیاں	ɡ ə ɾ m ɪ j ɑ̃ː
کھجور	kʰ ə d͡ʒ uː ɾ
انہدامی	ʔ ʊ n ɦ d ɑː m iː
بھی	bʱ iː
بڑھوتری	b a ɽ ʊ t̪ ɾ iː
دھمکا	d̪ʱ ʊ m k ɑː
پرشنسا	p ɾ ə ʃ ə n s ɑː
ارجت	ə ɾ d͡ʒ ɪ t̪
پڈوچیری	p ə ɖ oː t͡ʃ iː ɾ iː
تمنا	t̪ ə m ə n n ɑː
شکتی	ʃ ə k t̪ iː
بکاؤ	b ɪ k ɑː uː
افزائش	ə f z ɑː ɪ ʃ
خسارہ	x ɪ s ɑː ɾ ɑː ɦ
دبئی	d̪ ʊ b ə iː
سینگ	s iː ŋ ɡ
ڈپٹی	ɖ ə p ʈ iː
اجناس	ə d͡ʒ n ɑː s
نہس	n ɛ h s
بھوگ	bʱ ʊ ɡ
آدھا	ɑː d̪ʱ ɑː
ققنس	q ə q n ʊ s
سنجها	s ə n d͡ʒʱ ɑː
اجمیر	ɑː d͡ʒ m iː r
جارجن	d͡ʒ ɑː r d͡ʒ ə n
پاور	p ɑː ʋ ə ɾ
بلے	b ʊ l eː
نمائندہ	n ʊ m ɑː ɪ n d ə ɦ
شب	ʃ a b
قرمزی	q ɪ ɾ m ɪ z iː
افق	ɑː f ə q
مکھن	m ə kːʰ ə n
فیکلٹی	f iː k l ʈ iː
کارنامہ	k aː r n aː m ə
ترکی	t̪ ʊ ɾ k iː
تیرا	t̪ eː ɾ ɑː
سونگھ	s uː ŋ ɦ
جادھوپور	d͡ʒ ɑː d̪ʱ oː p ʊ ɾ
آریامن	ɑː ɾ j ə m ə n
سرشپ	s ə ɾ ʂ ə p
مرحومہ	m ə ɾ ɦ uː m ə
ابیان	ɑː b j ɑː n
ہوٹل	ɦ oː ʈ ə l
یوگانڈا	j ʊ ɡ ɑː n ʈ ɑː
تحفظ	t̪ ə ɦ f ə z
عبری	ɪ b ɾ iː
چنی	t͡ʃ ʊ n iː
اختتام۔پزیر	ɑː x t̪ t̪ ɑː m p ə z iː ɾ
آیا	ɑː j ɑː
طاقتور	t̪ ɑː q t̪ ʋ ɔː ɾ
اسٹیونس	ə s ʈ iː ʋ oː n s
سامنے	s ɑː m n eɪ
تندور	t̪ ə n d̪ uː ɾ
مالک	m ɑː l ə k
پجرنا	p ə d͡ʒ ɾ n ɑː
چترویدی	t͡ʃ ə t̪ ɾ ʊ ʋ eː d̪ iː
عینی	ʕ eː n iː
جاؤں	d͡ʒ ɑː ʊ̃
چٹس	t͡ʃ ə ʈ s
دھرنہ	dʱ ʊ r n a
کٹرپسند	k ʈ ə ɾ p s ʊ n d̪
ملزمین	m ʊ l z ɪ m iː n
تصویر	t̪ ə s ʋ iː ɾ
بدھا	b ʊ d̪ʱ ɑː
قوانین	q ʋ aː n iː n
فوارے	f oʊ ɑː r eɪ
برڈ	b ɾ ʊ d̪
ششن	ʃ ɪ ʃ n
مسقط	m ə s q ə t̪
فی۔الحال	f eː ɑː l ɦ ɑː l
تن	t̪ ə n
حقیئقت	ɦ ə q iː q ə t̪
آبشار	ɑː b ʃ ɑː ɾ
دھونا	d̪ʱ uː n ɑː
دانت	d̪ ə n t̪
نکل	n ɪ k ə l
اناج	ɑː n ɑː d͡ʒ
استاد	ʊ s t̪ ɑː d̪
کچرہلز	k ʊ t͡ʃ r ə h l z
گرما	ɡ ɾ m aː
گولہ	ɡ oː l a
مہنت	m ʊ h n a t
فکر	f ɪ k ɾ
نطرثانی	n a t̪ r s aː n iː
خلل	x ʊ l l
لوری	l oː ɾ iː
نان	n ɑː n
ساتواں	s ɑː t̪ ʋ ɑ̃ː
باغ	b ɑː ɣ
پرفتن	p ʊ ɾ f t̪ ʊ n
ناصرت	n ɑː s ə ɾ ə t̪
ناظم	n ɑː z ɪ m
ادب	ɪ d̪ b
ٹھکانا	tʰ ɪ k ɑː n ɑː
لیبرمن	l iː b ə r m ə n
کنٹیشور	k a n ʈ iː ʃ ɔː r
پوٹےشیم	p oʊ ʈ eɪ ʃ iː m
عمر	a m r
بھاجن	bʱ ɑː d͡ʒ ə n
سفید	s ə f eː d̪
کینیڈانژاد	k eː n iː d̪ ɑː n ʒ ɑː d̪
نا	n ɑː
بیدر	b iː d r
خواجہ	x ɑː d͡ʒ ɑː
فورا	f ɔː ɾ ə n
آلنگن	ɑː l ɪ ŋ ɡ ə n
خارج	x aː r ɪ d͡ʒ
ٹھوس	ʈʰ oː s
سیوریج	s iː ʋ ə ɾ ɪ d͡ʒ
پرزور	p ə ɾ z ʊ ɾ
دھارا	d̪ʱ ɑː ɾ ɑː
نزول	n ə z uː l
معدنیات	m ʊ ʔ d̪ ə n iː ɑː t̪
ڈاک	ɖ ɑː k
ڈارا	ɖ ɑː ɾ ɑː
سترویں	s t̪ ɾ oː v eː n
کاپوریشن	k ɑː p oː ɾ iː ʃ ə n
بےحد	b eː ɦ ə d̪
بہاراں	b ə ɦ ɑː ɾ ɑ̃ː
اپرادھی	ə p ɾ ɑː d̪ʱ iː
ایف	eː f
بتدریج	b ə t̪ d̪ ɾ iː d͡ʒ
موٹر	m oː ʈ ɾ
خط	x a t̪
سرگرم	s ə ɾ ɡ ə ɾ m
برتر	b ɪ ɾ t̪ ɾ
ہاتھ	ɦ ɑː t̪ʰ
ادھورا	ə d̪ʱ uː ɾ ɑː
ہونا	ɦ oː n ɑː
شرم	ʃ ə ɾ m
تنظیم	t̪ ə n z iː m
پھلکی	pʰ ʊ l k iː
رتن	ɾ ə t̪ ə n
قبول	q ʊ b uː l
دھاندل	d̪ʱ ɑː n d̪ ə l
تعاونی	t̪ a ɑː ʋ n iː
قربت	q ʊ r b ə t̪
دینے	d̪ eː n eː
لمبائی	l ə̃ m b ɑː iː
بنجر	b ʊ n d͡ʒ ɛ r
یچوری	j ɛ t͡ʃ oː r iː
نبض	n ə b z
ڈیوڈ	ɖ iː oʊ ɖ
ظہیرآباد	z ə ɦ iː ɾ aː b aː d̪
تیزاب	t̪ eː z aː b
صارف	s ɑː ɾ ɪ f
ٹسکالوسکا	ʈ s k ɑː l ʊ s k ɑː
جاہی	d͡ʒ ɑː ɦ iː
ٹیوب	ʈ iː ʋ b
چربی	t͡ʃ ə ɾ b iː
النظر	ʔ ʊ l n ʊ z ɾ
شیو	ʃ iː ʋ
دوپہر	d̪ uː p ɛː ɾ
شوق	ʃ ɔː q
ارسال	ə ɾ s ɑː l
ہتھیلی	ɦ ə t̪ʰ eː l iː
سہمنا	s ə ɦ ə m n ɑː
چوبے	t͡ʃ oː b eː
گردن	ɡ ə ɾ d̪ ə n
محمدو	m ʊ ɦ ə m ə d̪ ʋ oʊ
ٹکر	ʈ ə k k ə ɾ
موسم	m ɔː s ə m
شری	ʃ ɾ iː
دلچسپی	d̪ ɪ l t͡ʃ ʊ s p iː
ساتھی	s ɑː t̪ʰ iː
احتجاج	eː ɦ t̪ ɪ d͡ʒ ɑː d͡ʒ
لفظ	l ə f z
ہمیشگی	ɦ ə m eː ʃ ɡ iː
دایاں	d̪ ɑː j ɑ̃ː
انتم	ə n t̪ ɪ m
غیرسرکاری	ɣ ɪ r s ʊ r k ɑː r iː
چاہیئے	t͡ʃ ɑː ɦ iː ɛ
ڈوگر	ɖ oː ɡ ɛː ɾ
گرانا	ɡ ɪ ɾ ɑː n ɑː
بگاڈیا	b ʊ g ɑː ɖ iː ɑː
ہانک	ɦ ɑ̃ː k
وطن	ʋ ə t̪ ə n
سنا	s ʊ n ɑː
کوشاں	k ʊ ʃ ɑː n
ساکری	s ɑː k ɾ iː
کمیشن	k a m iː ʃ a n
میزبان	m eː z b ɑː n
مصارف	m ʊ s ɑː ɾ ɪ f
اداہرن	ʊ d̪ ɑː ɦ ɾ ə ɳ
آفریدی	ɑː f ɾ iː d̪ iː
چھت	t͡ʃʰ ə t̪
نورین	n ʊ ɾ iː n
قوت	q ʊ ʋ ʋ ə t̪
امتحان	ɪ m t̪ ɪ ɦ ɑː n
بے۔چین	b eː t͡ʃ eː n
پولیت	p oː l iː t̪
ذرا	z ɪ ɾ ɑː
مکانپور	m ə k ɑː n p ɔː ɾ
وہی	ʋ ə ɦ iː
احد	ɑː ɦ ə d̪
کارکرد	k ɑː r k ə r d̪
گلابی	ɡ ʊ l ɑː b iː
کشیدہ	k a ʃ iː d̪ ɑː
سکو	s k uː
شہر	ʃ ɛ ɦ ɛ ɾ
مروانا	m ə ɾ ʋ ɑː n ɑː
پیچھا	p iː t͡ʃʰ ɑː
جوہری	d͡ʒ ɔː ɦ ɾ iː
ترانه	t̪ ə ɾ ɑː n ə
شنید	ʃ ə n iː d
مشاعرہ	m ʊ ʃ ɑː ɪ r ə
سرحد	s ə ɾ ɦ ə d̪
یرموک	j ɪ r m uː k
تکنیکی	t̪ a k n iː k iː
حیران	ɦ ɛː ɾ ɑː n
لفٹ	l ɪ f t̪
کھانا	kʰ ɑː n ɑː
مذاکراہ	m ʊ z ɑː k ɾ ɑː ɦ
شکایت	ʃ ɪ k ɑː j ə t̪
گھنٹہ	ɡʱ ʊ n ʈ ɑː
چیرپرسن	t͡ʃ eː ɾ p ə ɾ s ə n
سرزمین	s ʊ ɾ z ə m iː n
سکریٹری	s ə k ɾ iː ʈ ə ɾ iː
بیٹھ	b eː ʈʰ
وضو	ʋ ʊ z uː
ثناخوان	θ n ɑː x w ɑː n
نااہلیت	n ɑː ɑː ɦ l iː t̪
طورپر	t̪ ʊ ɾ p ʊ ɾ
آلودگی	ɑː l uː d̪ ə ɡ iː
انڈا	ə ɳ ɖ ɑː
خونریز	x ʊ n r iː z
ڈیسک	ɖ iː s k
شیفیلڈ	ʃ ɛː f iː l ɖ
کنٹراکٹر	k a n ʈ r ɑː k ʈ a r
سبزی	s ə b z iː
مذمت	m ə z ə mː ə t̪
قبضہ	q ə b z ə
مسیحی	m ə s iː ɦ iː
اسپاٹ	ɪ s p ɑː ʈ
منٹ	m ɪ n ə ʈ
جوا	d͡ʒ ʊ ɑː
چلچتر	t͡ʃ ə l t͡ʃ ɪ t̪ ɾ ə
چودنا	t͡ʃ oː d̪ n ɑː
پرکاش	p ɾ ə k ɑː ʃ
بستی	b ə s t̪ iː
ٹھہرنا	ʈʰ ə ɦ ə ɾ n ɑː
دام	d̪ ɑː m
سلم	s ʊ l m
نوواں	n ə̯ u ʋ ɑ̃ː
جہدکار	d͡ʒ ə ɦ d̪ k ɑː ɾ
چولھا	t͡ʃ uː l ɦ ɑː
دھول	d̪ʱ uː l
گز	ɡ ʊ z
یقینا	j ə q iː n ə n
گھاو	ɡʱ ɑː ʋ
رائےدہی	ɾ aː ɪ ə d̪ ɦ iː
کمپ	k ə m p
رونا	ɾ oː n ɑː
چھان	t͡ʃʰ ɑː n
آکرشت	ɑː k ə ɾ ʂ ɪ t̪
گرکیرت	g ɾ k iː ɾ t̪
آفسیر	ɑː f s iː ɾ
ھما	ɦ m ɑː
پرگی	p ə r ɡ iː
شارجہ	ʃ ɑː ɾ d͡ʒ ɑː ɦ
دھات	d̪ʱ ɑː t̪
وصولی	ʋ ʊ s uː l iː
پرنم	p ɛ r n a m
پنکھڑی	p ə ŋ kʰ ʊ ɽ iː
نر	n ə ɾ
اجالا	ʊ d͡ʒ ɑː l ɑː
امان	ə m ɑː n
چیٹا	t͡ʃ iː ʈ ɑː
قیمتی	q iː m ə t̪ iː
نقصان	n ʊ q s ɑː n
ننھا	n ə nʱ ɑː
روزنامہ	ɾ oː z n ɑː m ə
مذکور	m ʊ z k ʊ r
نذرانہ	n ɪ z r ɑː n ɑː
ایذارسانیوں	ɑː ɪ ð ɑː ɾ s ɑː n iː ʊ n
ہانکنا	ɦ ɑː ŋ k n ɑː
جنتی	d͡ʒ ə nː ə t̪ iː
شداد	ʃ ə d aː d̪
برسلز	b ɾ ə s ə l z
سلنڈر	s ə l ə n ɖ ə ɾ
ایموٹو	ɛː m oʊ ʈ oʊ
نصبین	n ə s b iː n
سیاستدان	s ɪ j ɑː s ə t̪ d̪ ɑː n
ثانوی	θ ɑː n ʋ iː
جانی	d͡ʒ ɑː n iː
آستین	ɑː s t̪ iː n
جی	d͡ʒ iː
مہندی	m ɪ ɦ ə̃ d̪ iː
فکسنگ	f ə k s ɪ ŋ
تقریباً	t̪ ə q ɾ iː b ə n
بینالاقوامی	b eɪ n ɑː l ɑː q ʋ ɑː m iː
کودانڈارام	k uː d ɑː n ɖ ɑː ɾ ɑː m
کیابس	k j ɑː b s
شعار	ʃ a ɑː ɾ
ندی	n ə d̪ iː
ذلت	z ɪ lː ə t̪
پرجوش	p ʊ r d͡ʒ oː ʃ
کاج	k ɑː d͡ʒ
کیلی	k eː l iː
مواصلات	m ʊ ʋ ɑː s ə l ɑː t̪
ماسٹر	m ɑː s ʈ ə ɾ
مرتبہ	m ə ɾ t̪ ə b ɑː
مےئر	m eː ɪ ɾ
ش	ʃ
مفتاحی	m uː f t̪ aː ɦ iː
اڈمیرل	ə d̪ m iː r l
فیڈنگ	f iː d̪ ɪ ŋ ɡ
سمراٹ	s ə m ɾ ɑː ʈ
پرسکون	p ə ɾ s k uː n
سامل	s ɑː m ə l
کلکٹر	k ʊ l k ʈ ɛ ɾ
چھوٹنا	t͡ʃʰ uː ʈ n ɑː
شوارع	ʃ oː aː r ʕ
دیا	d̪ ɪ j ɑː
احمدآباد	ɑː ɦ m ɛː d̪ ɑː b ɑː d̪
لنگ	l ɪ ŋ ɡ
مذہب	m ə z ɦ ə b
انجنئیر	ɪ n d͡ʒ ɪ n ɪː ɾ
نے	n eː
معجزہ	m o ʔ d͡ʒ ɪ z ɑː ɦ
سدھارنا	s ʊ d̪ʱ ɑː ɾ n ɑː
انفورسمنٹ	ɪ n f ɔː r s m ə n ʈ
ستاری	s t̪ ɑː ɾ iː
ارے	ə ɾ eː
آرڈر	ɑː ɾ ʈ ɾ
پدما	p ə d̪ m ɑː
كر	k ə r
حیوانیات	ɦ ɛː ʋ ɑː n ɪ j ɑː t̪
اوراد	ɔː ɾ ɑː d̪
جرأت	d͡ʒ ʊ ɾ ɾ ə t̪
شراب	ʃ ə ɾ ɑː b
انڈیوگونزیلویس	a n ɖ iː ʋ a ɡ a n z iː l a ʋ iː s
جھگڑا	d͡ʒʱ ə ɡ ɽ ɑː
گائیڈنس	ɡ ɑː iː d̪ n s
جامن	d͡ʒ ɑː m ə n , d͡ʒ ɑː m ʊ n
امن	ə m ə n
انجنیئرنگ	ɪ n d͡ʒ ə n iː ə ɾ n ɡ
کیمرہ	k ɛː m ɾ ɑː
سسرال	s a s r ɑː l
چھوٹا	t͡ʃʰ oː ʈ ɑː
امام	ɪ m ɑː m
کشتی	k ə ʃ t̪ iː
الیکٹرولائٹ	ə l j eː k ʈ r oː l aː ɪ ʈ
ٹیوٹ	ʈ iː uː ʈ
کھڑے	kʰ ə ɽ eː
کروانا	k ə ɾ ʋ ɑː n ɑː
اسپیکٹرم	ə s p eː k ʈ r ʊ m
اتحاد	ɪ t̪ː ɪ ɦ ɑː d̪
بال	b ɑː l
دشواری	d̪ ʊ ʃ ʋ ɑː ɾ iː
دریا	d̪ ə ɾ iː ɑː
گج	ɡ ə d͡ʒ
دعوہ	d̪ ʊ ʔ ɑː
مدینہ	m ə d̪ iː n ɑː
ٹیکس	ʈ iː k s
اخاہ	ə xː ɑː
ابهار	ʊ bʱ ɑː ɾ
آرٹیکل	ɑː r ʈ iː k ə l
درجہ	d̪ ə r d͡ʒ ɑː
بیدی	b eɪ d̪ iː
ٹرانزیشنل	ʈ r ɑː n z iː ʃ a n l
اگر	ə ɡ ə ɾ
عبدالحمید	ʕ b d̪ ʊ l ɦ ə m iː d̪
اور	ɔː ɾ
عبرانی	ɪ b ɾ ɑː n iː
چکرورتی	t͡ʃ ə k r ʊ r t iː
مورتی	m uː ɾ t̪ iː
نورانی	n ʊ r aː n iː
روانڈا	ɾ ə ʋ ɑː ɳ ɖ ɑː
ٹانگ	ʈ ɑː ŋ ɡ
اسکولس	ə s k uː l s
جیت	d͡ʒ iː t̪
یورپ	j oː ɾ ə p
لحاظ	l ɪ ɦ ɑː z
تضاد	t̪ ʊ z ɑː d̪
ولائتی	ʋ ɪ l ɑː j ə t̪ iː
گفتگو	ɡ ʊ f t ɡ oʊ
قابلیت	q ɑː b l ɪ j ə t̪
مولین	m oː l iː n
شعب	ʃ a ʕ b
قبض	q ə b ə z
لکشمی	l ə k ʃ m iː
ہوا	ɦ ə ʋ ɑː
تشنہ	t̪ ɪ ʃ n ɑː
مجرم	m ʊ d͡ʒ ɾ ɪ m
دھمال	d̪ʱ ə m m ɑː l
ہائی۔ٹیکس	ɦ aɪ t̪ ɛ k s
دوستانہ	d̪ oː s t̪ ɑː n ɑː
ململ	m ə l m ə l
نصرانی	n ə s ɾ ɑː n iː
کیلئے	k eː l ɪ j eː
نظیف	n ə z iː f
باون	b ɑː ʊ n
دینا	d̪ eː n ɑː
پیشاب	p eː ʃ ɑː b
لاشعوری	l ɑː ʃ eː ʋ oː ɾ iː
لوگ	l̪ oː ɡ
چکت	t͡ʃ ə k ɪ t̪
گنگولی	ɡ ʊ ŋ ɡ ɔː l iː
دگنا	d̪ ʊ ɡ n ɑː
شجرکاری	ʃ ʊ d͡ʒ r k ɑː r iː
انگلینڈ	ɪ ŋ ɡ l ɛː n ɖ
کھنن	kʰ ə n ə n
جھانجھ	d͡ʒʱ ɑ̃ː d͡ʒʱ
قیام	q iː ɑː m
آندھی	ɑː n d̪ʱ iː
معلنہ	m ʕ ə l ə n ə ɦ
ڈنکی	ɖ ə ŋ k iː
پورم	p ʊ r m
بغير	b ə ɣ ɛː ɾ
توحیدیت	t̪ ɔː ɦ iː d̪ ɪ j ə t̪
مقدار	m ɪ q d̪ ɑː ɾ
غداری	ɣ ə d̪ aː ɾ iː
فوجداری	f ʊ d͡ʒ d̪ ɑː ɾ iː
لامتناہی	l ɑː m ʊ t̪ ə n ɑː ɦ iː
قلم	q ə l ə m
ندیوں	n ə d̪ ɪ j õː
نصیب	n ə s iː b
اشارہ	ɪ ʃ ɑː ɾ ɑː
آگار	ɑː ɡ ɑː ɾ
انکڈل	ɪ n k ə ɖ l
نظامت	n ɪ z ɑː m ə t̪
ایمباسیٹرس	ɪ m b ɑː s iː ʈ ʊ ɾ s
لہنگا	l ɛː ɦ ɛː ŋ ɡ ɑː
آٹو	ɑː ʈ oʊ
فلک	f ə l ə k
لازم	l ɑː z ə m
بدلنا	b ə d̪ ə l n ɑː
درخت	d̪ ə ɾ ə x t̪
ہنساتمک	ɦ ɪ̃ n s ɑː t̪ m ə k
افسانہ	ə f s ɑː n ə
انپم	ə n ʊ p ə m
خاصکر	x ɑː s k ə ɾ
منہ	m ʊ̃ ɦ
میراں	m iː r aː n
مزہ	m ə z ɑː
ینگ	j ɪ ŋ
نظم	n ə z ə m
تمھیں	t̪ ʊ mʱ ẽː
الہی	ʔ ɛː l ɦ iː
خوف	x ɔː f
تبادلہ	t̪ ə b ɑː d̪ ɪ l ɑ ɦ
وزیرستان	ʋ ə z iː ɾ ə s t̪ ɑː n
انگوری	ə ŋ ɡ uː ɾ iː
غیرانسانی	ɣ ɛː r ɪ n s ɑː n iː
راشٹرپتی	r ɑː ʃ t r p a t iː
لوسان	l oː s ɑː n
جرثومہ	d͡ʒ ʊ ɾ s uː m ɑː
اٹاچی	ə ʈ ɛː t͡ʃ iː
کنٹرولرس	k ə n ʈ r oː l ə r s
کدو	k ə d̪ uː
نکاح	n ɪ k ɑː ɦ
گمنام	ɡ ʊ m n ɑː m
بہادر	b ə ɦ ɑː d̪ ə ɾ
ناتھولا	n ɑː t̪ʱ oː l ɑː
گڈا	ɡ ʊ ɖ ɖ ɑː
سواری	s ʋ ɑː ɾ iː
اذیت	ə z iː t̪
سوچنا	s oː t͡ʃ n ɑː
نمستے	n ə m ə s t̪ eː
منتر	m ə n t̪ ə ɾ
وزیر	ʋ ə z iː ɾ
چارجس	t͡ʃ ɑː r d͡ʒ ɪ s
بھوتنی	bʱ uː t̪ ɪ n iː
اچاریہ	ə t͡ʃ ɑː ɾ iː ə
بھورا	bʱ uː ɾ ɑː
مالٹا	m ə l ʈ ɑː
ٹریژری	ʈ r iː ʒ ɛ r iː
قمیض	q ə m iː z
مزدور	m ʊ z d̪ ʊ r
سنگاپور	s ɪ ŋ ɡ ɑː p uː ɾ
اترنا	ʊ t̪ ə ɾ n ɑː
تیز	t̪ eː z
ملازم	m ʊ l ɑː z ə m
مناسب	m ʊ n ɑː s ɪ b
افتخار	ɑː f t̪ ɪ x ɑː r
فلکیات	f ə l k iː j ɑː t̪
جلانا	d͡ʒ ə l ɑː n ɑː
تازہ	t̪ ɑː z ɑː
مچلکہ	m ʊ t͡ʃ a l k ɑː
جمعرات	d͡ʒ ʊ m eː ɾ ɑː t̪
چاٹنا	t͡ʃ ɑː ʈ n ɑː
پستک	p ʊ s t̪ ə k
قاموس	q ɑː m uː s
القاعدہ	ʔ ə l q ɑː ʕ ɪ d̪ ɑː
ایشین	eː ʃ iː n
ابھشیک	ə bʱ ɪ ʂ eː k
نکما	n ɪ k ə m m ɑː
بریلی	b ɾ iː l iː
صفرواں	s ɪ f ə ɾ ʋ ɑ̃ː
موجھی	m oʊ d͡ʒʱ iː
خسر	x ʊ s ɾ
کوکب	k ɔː k ə b
واقفیت	ʋ aː q f iː t̪
میاں	m ɪ j ɑ̃ː
تیاگ	t̪ j ɑː ɡ
ابو	ə b b uː
وشاکھا	ʋ ʊ ʃ ɑː kʰ ɑː
ارجن	ə ɾ d͡ʒ ʊ n
مصر	m ɪ s ə ɾ
وا	ʋ ɑː
گمبھیر	ɡ ə m bʱ iː ɾ
اهہ	ɪ ɦ
ضمانت	z ə m ɑː n ə t̪
دشت	d̪ ə ʃ t̪
بڑا	b ə ɽ ɑː
بتانا	b ɪ t̪ ɑː n ɑː
ساڑھے	s aː r a
جپنا	d͡ʒ ə p n ɑː
پینسل	p eː n s ə l
ہکا	ɦ ɪ k k ɑː
گائے	ɡ ɑː eː
پولیو	p oː l iː oː
سائمن	s ɑː ɪ m ʊ n
سرم	s ə r m
بغیر	b ɪ ɣ ɛː r
میکسیکو	m eː k s iː k oː
عشق	ɪ ʃ q
سمکھ	s ə m m ʊ kʰ
جوفری	d͡ʒ o f r iː
سانولا	s ɑ̃ː ʋ l ɑː
نہیں	n ə ɦ ĩː
عمل	ə m ə l
ہنسا	ɦ ɪ n s ɑː
فٹنس	f ɪ t̪ n ə s
گول	ɡ oː l
العرفائ	ə l a ɾ f ɑː ɪ
عارضی	ʕ ɑː r ɪ z iː
ناٹ	n ɑː ʈ
یزدانی	j ɛ z d ɑː n iː
تلقین	t ə l q iː n
کنگارو	k ə ŋ ɡ ɑː ɾ uː
تفصیل	t̪ ə f s iː l
تمہیں	t̪ ʊ m ɦ ẽː
غیرمعروف	ɣ ɪ ɾ m ɑː ɾ uː f
ملن	m ɪ l ə n
کتراپی	k ʊ t̪ ɾ ɑː p iː
فضاء	f ɪ z ɑː
حبقوق	ɦ ə b ə q q uː q
پتلا	p ʊ t̪ l ɑː
شریعت	ʃ ə ɾ iː ʔ j ə t̪
بدلوانا	b ə d̪ ə l ʋ ɑː n ɑː
رنز	r ə n z
نیاک	n iː ɑː k
جارجیا	d͡ʒ ɑː r d͡ʒ iː ɑː
طاقت	ʈ ɑː q ə t̪
مثلا	m ə s l ə n
انگریزی	ə̃ ŋ ɡ ɾ eː z iː
جبرئیل	d͡ʒ ɪ b r aɪ l
ارجنٹائن	ə ɾ d͡ʒ ə n ʈ ɑː iː n
وجود	ʋ ə d͡ʒ uː d̪
کہرا	k ʊ ɦ ɾ ɑː
مؤذن	m ʊ ə z z ɪ n
کائنات	k ɑː ɪ n ɑː t̪
مت	m ə t̪
بوڑھا	b uː ɽʱ ɑː
رعیتوبازار	ɾ ʕ j ɪ t̪ oː b ɑː z ɑː ɾ
فیڈرر	f eː d̪ ɛː ɾ ɾ
سازش	s ɑː z ɪ ʃ
عورت	ɔː ɾ ə t̪
دودھ	d̪ uː d̪ʱ
موقع	m ɔː q ɑː
کیتیش	k eː t̪ iː ʃ
القرآن	a l q ʊ r aː n
سرسوں	s ə ɾ s õː
دھل	d̪ ɦ ɛː l
بلین	b ɛː l iː n
مکھ	m ʊ kʰ
کرشمہ	k ə ɾ ɪ ʃ m ɑː
وویک	ʋ oː ʋ iː k
ادھنا	ə d̪ʱ ʊ n ɑː
توصیف	t ʋ o s iː f
ہیرو	ɦ iː r uː
رکت	ɾ ə k t̪
ہنگامہ	ɦ ʊ ŋ ɡ ɑː m ə
مذاق	m ə z ɑː q
بیوی	b iː ʋ iː
ریاست	ɾ iː j ɑː s ə t̪
فادر	f ɑː d̪ ə ɾ
ناراض	n ɑː ɾ ɑː z
ذائقہ	z ɑː j q ɑː
تشکیل	t̪ ʊ ʃ k iː l
وار	ʋ ɑː ɾ
منسوخی	m ʊ n s ʊ x iː
مسوری	m ʊ s ʋ ʊ r iː
گیارنٹی	ɡ j ɑː r n ʈ iː
ہلڑ	ɦ ə l ɽ
لکژری	l ʊ k z ʊ r iː
متوازن	m ʊ t̪ ʋ aː z ə n
روچڈیل	ɾ ɔː t͡ʃ ɖ eː l
سج	s ə d͡ʒ
طالب	ʈ ɑː l ɪ b
کپتان	k ə p t̪ ɑː n
خلیفہ	x ə l iː f ɑː ɦ
خاصا	x ɑː s ɑː
مہمان	m ɪ ɦ m ɑː n
مناسبت	m ə n aː s b ə t̪
پراڈکٹس	p ɾ ɑː ʈ k ʈ s
پیاس	p j ɑː s
لینا	l eː n ɑː
ریمارک	r eɪ m ɑː r k
ہومگارڈ	ɦ oː m g aː r ɖ
موسیقی	m oː s iː q iː
گہرا	ɡ ə ɦ ɾ ɑː
تہجی	t̪ ə ɦ ə d͡ʒː iː
نند	n ə n d̪
پرول	p ə ɾ ʋ ə l
ویٹ	ʋ eɪ t
سیکھنا	s iː kʰ n ɑː
کاشف	k ɑː ʃ f
خالق	x ɑː l ɪ q
آگاہی	ɑː ɡ ɑː ɦ iː
شجر	ʃ ə d͡ʒ ə ɾ
سپاہی	s ɪ p ɑː ɦ iː
مٹانا	m ɪ ʈ ɑː n ɑː
خلق	x ə l q
کروڑپتی	k ɾ oː ɽ p a t̪ iː
مناظر	m ə n ɑː z ɪ ɾ
بت	b ʊ t̪
رکوع	ɾ ʊ k uː ʕ
کاویہ	k ɑː ʋ j ə
کپاس	k ə p ɑː s
ادی	ə d̪ jᵊ
خبریں	x ə b ɾ iː n
کیوں	k j ɔː n
جدول	d͡ʒ ʊ d̪ ʊ l
غنڈہ	ɣ ʊ n ɖ ɑː
ارتکاب	ɪ ɾ t̪ k ɑː b
فوج	f ɔː d͡ʒ
فلور	f l oʊ r
محفوظ	m ʊ h f oː z
عقل	ʔ ə q l
المسلمین	ʊ l m ʊ s l iː m iː n
نقلی	n ə q l iː
دیو	d eː ʋ
انڈر۔پاس	ɪ n ɖ ə ɾ p ɑː s
شاعرہ	ʃ ɑː j ɾ ɑː
فلورنگ	f l ɔː r n ɪ ŋ
داخلہ	d̪ ɑː x ɪ l ə
ہونٹھ	ɦ õː ʈʰ
جگاڑ	d͡ʒ ʊ ɡ ɑː ɽ
دفنانا	d̪ ə f n ɑː n ɑː
خواہ	x ɑː ɦ
ہندوستان	ɦ ɪ n d̪ ʊ s t̪ ɑː n
نظام	n ɪ z ɑː m
شنتانو	ʃ ə n t̪ ə n uː
نہایت	n ɪ h ɑː j ə t̪
نردوش	n ɪ ɾ d̪ oː ʂ
خودمحتار	x ʊ d m ʊ h t aː ɾ
کوہیر	k oː ɦ iː ɾ
مردانگی	m ə ɾ d̪ ɑː n ɡ iː
پرچم	p ə ɾ t͡ʃ ə m
سمرتی	ɪ s m ɾ ɪ t̪ iː
ہند	ɦ ɪ n d̪
ہندو	ɦ ɪ n d̪ uː
توقع	t̪ ʋ oː q ʕ
نتائج	n ɪ t̪ aː ɪ d͡ʒ
معمول	m ʕ ə m uː l
پیدائشی	p eː d̪ ɑː ɪ ʃ iː
ابابیل	ə b ɑː b iː l
انفوٹی	ɪ n f oʊ ʈ iː
پوجا	p uː d͡ʒ ɑː
عرض	ə ɾ z
اسرائیل	ɪ s ɾ ɑː iː l
اطباء	ɪ t̪ ɪ b ɑː ɑː
کاروائی	k ɑː ɾ oː ɑː iː
برچھیت	b ə ɾ t͡ʃʰ ɛː t̪
چھاپا	t͡ʃʰ ɑː p ɑː
ریختہ	ɾ eː x t̪ ɑː
مئی	m eː ɪ
کپاسی	k ə p ɑː s iː
اندھیرا	ə n d̪ʱ iː ɾ aː
پریت	p ə ɾ iː t̪
دلیری	d̪ ə l iː ɾ iː
گرمکھی	ɡ ʊ ɾ m ʊ kʰ iː
فورسی	f ɔː ɾ s iː
عیسائی	ʕ iː s ɑː ʔ iː
دشمن	d̪ ʊ ʃ m ə n
جائے	d͡ʒ ɑː ɪ
باہوبلی	b ɑː ɦ ʊ b ə l iː
اپریل	ə p ɾ ɛː l
حلقہ	ɦ ə l q ə
جٹ	d͡ʒ a ʈ
اسپنر	ə s p n ə ɾ
لیسٹر	l ɛː s ʈ ə ɾ
ڈائریا	ɖ ɑː ɪ ɾ iː ɑː
سیاست	s ɪ j ɑː s ə t̪
بچہ	b ə t͡ʃ ɑː
ڈیفنس	ɖ iː f n ɪ s
سرمایہ	s ə r m ɑː j ə
رویئہ	ɾ ə ʋ ə̯ i ɑː
خاتمہ	x ɑː t̪ ɪ m ə
علامت	ʕ ʊ l aː m a t
وسلم	ʋ ʊ s l ʊ m
جامع	d͡ʒ aː m ɛː
وبائی	ʋ ʊ b aː ɪ
گزشتہ	ɡ ʊ z ʃ t̪ ɦ
پیاز	p ɪ j ɑː z
مہر	m ʊ ɦ ə ɾ
کیمیائی	k iː m ɪ j ɑː iː
الفاظ	a l f ɑː z
وسیع	ʋ ʊ s iː ʕ
مخبر	m ʊ x b ɪ ɾ
پرتگیا	p ɾ ə t̪ ɪ ɡ j ɑː
چمو	t͡ʃ ə m uː
پہ	p eː
ٹھیک	ʈʰ iː k
دیانتداری	d iː aː n ə t̪ d aː r iː
مصروف	m ʊ s ɾ ʊ f
پتا	p ɪ t̪ ɑː
دیوبندی	d̪ eː ʋ b ə n d̪ iː
چار	t͡ʃ ɑː ɾ
قومیت	q ɔː m ɪ j j ə t̪
چاند	t͡ʃ ɑ̃ː d̪
ایکڑ	eː k ə r
ذریعہ	z ə ɾ ɪ j ə
خلیج	x ə l iː d͡ʒ
ٹیچر	ʈ iː t͡ʃ ɪ ɾ
ظفر	z ʊ f ə r
اسکام	ə s k ɑː m
سوادو	s ʋ ɑː d̪ uː
نکسلائٹ	n ɪ k s l ɑː iː t̪
اساس	ʔ ə s ɑː s
ناکامی	n ɑː k ɑː m iː
ہیکہ	ɦ eː k ɦ
لمپٹ	l ə m p ə ʈ
کھوکس	kʰ oː k s
اداسی	ʊ d̪ ɑː s iː
ارسطو	ə ɾ ə s t̪ uː
کھٹائی	kʰ ə ʈ ɑː iː
شرائط	ʃ ʊ r ɑː ɪ ʈ
سست	s ʊ s t̪
کلب	k ʊ l b
مورت	m uː ɾ ə t̪
جارحانہ	d͡ʒ ɑː ɾ ɦ ɑː n ɑː
عجیب	ə d͡ʒ iː b
دوش	d̪ oː ʃ
وغیرہ	ʋ ə ɣ ɛː r ə
نوموہیون	n ʊ m ʊ ɦ iː ʊ n
مقدسہ	m ʊ q ə d̪ d̪ ə s ɑː
اند	ɑː n d̪
آفت	ɑː f ə t̪
مصنوعات	m ʊ s n ʊː ʕ ɑː t̪
شیشے	ʃ iː ʃ eː
عاشق	ʕ aː ʃ ɪ q
گھوڑا	ɡʱ oː ɽ ɑː
اجنبی	ə d͡ʒ n ə b iː
مینٹن	m eː n ʈ n
آنسو	ɑ̃ː s uː
مجیب	m ʊ d͡ʒ iː b
روزن	ɾ ɔː z ə n
کچھ	k ʊ t͡ʃʰ
ایکشن	ɛː k ʃ ə n
وسنت	ʋ ʊ s n a t̪
ناساز	n ɑː s ɑː z
ساریامی	s ɑː r iː ɑː m iː
استری	ɪ s t̪ ɾ iː
خاصی	x ɑː s iː
ذوق	z ɔː q
ہندوستانی	ɦ ɪ n d̪ ʊ s t̪ ɑː n iː
زبیر	z ʊ b eː ɾ
روبہ	r oː b ɑː
کمپٹرولر	k a m p j uː t̪ ə ɾ oʊ l ə ɾ
عام	ɑː m
قرطبہ	q ʊ ɾ t̪ ə b ɑː ɦ
دیروز	d̪ iː ɾ oː z
ٹھنڈا	ʈʰ ʊ n ɖ ɑː
عنصر	ʕ ʊ n s ʊ r
لال	l ɑː l
ڈمرو	ɖ ə m ɾ uː
نشور	n ʊ ʃ uː ɾ
مکر	m ʊ k ə ɾ
ومبلڈن	v a m b l d a n
متوفی	m ʊ t̪ ʋ ɔː f iː
سیکڑوں	s iː k ə ɾ ʊ n
یرمیاہ	j ɪ ɾ m ɪ j ɑː ɦ
گرنا	ɡ ɪ ɾ n ɑː
حمیدالدین	ħ ʊ m iː d̪ a l d̪ iː n
ابلاغ	ə b l ɑː ɣ
اوسو	ɔː s o
اولا	oː l ɑː
گنتی	ɡ ɪ n t̪ iː
جمیعتہ	d͡ʒ ʊ m iː ʕ ɑː t̪ ɑː
سڑک	s ə ɽ ə k
مجھ	m ʊ d͡ʒʱ
اودا	uː d̪ ɑː
الداخلہ	ʔ ɛː l d̪ ɑː x l ɑː
لیول	l iː ʋ ə l
گلو	ɡ ʊ l oː , ɡ ʊ l uː , ɡ ə l uː
بڑھتا	b ə ɽ ʈ ɑː
رومن	ɾ uː m ə n
فلپائن	f ɪ l ɪ p ɑː ɪ n
عقبہ	ʕ ɪ q b ɑː
محل	m ɛ ɦ ɛ l̪
محسن	m ʊ ɦ s ə n
شائنی	ʃ ɑː ɪ n iː
تاریخی	t̪ ɑː r ɪ x iː
غزوۂ	ɣ ə z ʋ ə
ولتھاٹی	ʋ ʊ l t̪ʱ ɑː ʈ iː
گدا	ɡ ʊ d̪ ɑː
گائناکالوجی	ɡ ɑː iː n ɑː k ɑː l oː d͡ʒ iː
نسل	n ə s l
اطفال	ə t̪ f ɑː l
سفارت	s ɪ f ɑː ɾ ə t̪
لمبا	l ə m b ɑː
لاپتہ	l ɑː p ə t̪ ə
خانہ	x ɑː n ɑː
شکریہ	ʃ ʊ k ɾ ɪ j ɑː
لوبیا	l oː b ɪ j ɑː
وینکٹ	ʋ eː n k ɪ ʈ
طاق	t̪ ɑː q
نيت	n iː t̪
برائے	b ɾ ɑː ɪ e
پھاڑ	pʰ ɑː ɽ
سنجہا	s ʊ n d͡ʒ ɦ ɑː
کمپت	k ə m p ɪ t̪
سپلی	s ə p l iː
طبیعت	t̪ ə b iː j ə t̪
پیج	p ɛː d͡ʒ
ں	ɳ
پتی	p ə t̪ t̪ iː
اڑا	a ɽ ɑː
گڑیا	ɡ ʊ ɽ ɪ j ɑː
غیرمستحکم	ɣ ɪ r m ʊ s t̪ ɦ a k a m
نکاراتمک	n ə k ɑː ɾ ɑː t̪ m ə k
کنٹرےکٹ	k ʊ n t̪ ɾ eɪ k t̪
اخوت	ə x ʋ oː t̪
اٹارنی	ɑː ʈ ɑː r n iː
انڈسٹریل	ɪ n ɖ ʊ s t̪ r iː l
استقبال	ɪ s t̪ ɪ q b ɑː l
نامی	n ɑː m iː
کمپن	k ə m p ə n
گیڈ	ɡ eː ɖ
کامتھ	k ɑː m t̪ʰ
ویش	v eɪ ʃ
کودنڈا	k ʊ d̪ n ʊ n d̪ ɑː
جوڑ	d͡ʒ oː ɽ
زیادتی	z ɪ j ɑː d̪ t̪ iː
تھیراپی	t̪ʰ eː ɾ ɑː p iː
انش	ə n ʃ
جائزہ	d͡ʒ ɑː ɪ z ɑː
مہاوت	m ə ɦ ɑː ʋ ə t̪
لازمی	l ɑː z m iː
گے	ɡ eː
سنترا	s ə n t̪ ɾ ɑː
اسوسی	ɪ s ʊ s iː
جھنڈ	d͡ʒ ʱ ʊ n ɖ
قدیم	q ə d̪ iː m
سپرد	s ʊ p ə r d̪
نقاب	n ɪ q ɑː b
شمولیت	ʃ ʊ m oʊ l iː t̪
ڈھيٹھ	ɖʱ iː ʈʰ
کرنا	k ə ɾ n ɑː
اکسپریس	ə k s p eɪ r iː s
فرزند	f ə r z ə n d
کھیلنا	kʰ eː l n ɑː
حکمرانی	ɦ ʊ k ʊ m ɾ ɑː n iː
شیوسینا	ʃ iː ʋ s iː n ɑː
قباحت	q ə b ɑː ɦ ə t̪
تولہ	t̪ ʊː l ɑː
پوشیدہ	p oː ʃ iː d̪ ə
بنچس	b ə n t͡ʃ ə s
برن	b ə ɾ n
نانگل	n ɑː ŋ ɡ ə l
عجوبہ	ə d͡ʒ uː b ɑː
انگوٹھا	ə ŋ ɡ uː ʈʰ ɑː
سہمانا	s ə ɦ m ɑː n ɑː
عنب	ɪ n eː b
دینی	d̪ iː n iː
شرط	ʃ ə ɾ t̪
بیورو	b j ʊ ɾ oː
گاؤں	ɡ ɑ̃ː oː
چوبیس	t͡ʃ oː b iː s
حسین	ɦ ʊ s eɪ n
ڈوجی	ɖ oː d͡ʒ iː
جانکاری	d͡ʒ ɑː n k ɑː ɾ iː
تندرست	t̪ ə n d̪ ʊ ɾ ʊ s t̪
ابھیجیت	ə bʱ iː d͡ʒ iː t̪
بکم	b ʊ k m
زیر۔قیادت	z iː ɾ q iː ɑː d̪ ə t̪
ذمہداری	z ə m ɦ d̪ ɑː ɾ iː
ممنوعہ	m ə m n oː ʕ ə ɦ
کیوبا	k iː ʋ b ɑː
کیول	k eː ʋ ə l
انتظار	ɪ n t̪ ɪ z ɑː ɾ
بولنا	b oː l n ɑː
افغانستان	ə f ɣ ɑː n ɪ s t̪ ɑː n
تناظر	t̪ ə n ɑː z ə r
بچھڑی	b ɪ t͡ʃʰ ɽ iː
رنڈی	ɾ ə ɳ ɖ iː
لاپرواہی	l ɑː p ɾ ʋ ɑː ɦ iː
فالسئی	f ɑː l s ə iː
جامنی	d͡ʒ ɑː m n iː
پریشد	p ɪ r eː ʃ d̪
میتھن	m ɛː t̪ʰ ʊ n
باربروسہ	b ɑː r b ə r oː s ə
بےجا	b eː d͡ʒ ɑː
چکنگنیا	t͡ʃ ɪ k ə n ɡ ʊ n ɪ j ɑː
زنانی	z ʊ n ɑː n iː
اودبلاؤ	uː d̪ b ɪ l ɑː oː
سمجھدار	s ə m ə d͡ʒʱ d̪ ɑː ɾ
تگنا	t̪ ɪ ɡ n ɑː
گنا	ɡ ʊ n ɑː
روگردانی	ɾ oː ɡ ə ɾ d̪ aː n iː
متوجہ	m ʊ t̪ ə ʋ ə d͡ʒ d͡ʒ ʊ ɦ
تھوکنا	t̪ʰ uː k n ɑː
بددعا	b ə d̪ d̪ ʊ ɑː
رپورٹرس	ɾ ə p ɔː r ʈ ə r s
کالسانگرا	k ɑː l s ɑː ŋ g r ɑː
پرتبھا	p ə r t̪ ʊ bʱ ɑː
فرار	f a r aː r
قیمہ	q iː m ɑː
نکسیر	n ə k s iː ɾ
گیہوں	ɡ eː ɦ ũː
ختم	x ə t̪ m
مذکرہ	m ʊ z k ɪ ɾ ɑː
ویاکرن	ʋ j ɑː k ə ɾ ə n
ہمدردی	ɦ ə m d̪ ə r d̪ iː
مول	m oː l
خاکسار	x ɑː k s ɑː ɾ
کالا	k ɑː l ɑː
پٹرولیم	p a t̪ ɾ oː l iː m
حلال	ɦ ə l ɑː l
رسالہ	ɾ ɪ s ɑː l ɑː
خودکشی	x ʊ d̪ k ʊ ʃ iː
گیا	ɡ ə j ɑː
توچا	t̪ ʋ ə t͡ʃ ɑː
ابودرداء	ʔ ɑː b uː d ə r d ɑː ʔ
کاڑھا	k ɑː ɽʱ ɑː
انوراللہ	ɑː n ʋ ə r ɑː l l ɑː ɦ
ششی	ʃ ɪ ʃ iː
گجویل	ɡ ə d͡ʒ ʋ ə iː l
چتا	t͡ʃ ʊ t̪ ɑː
گوگرد	ɡ oː ɡ ɪ ɾ d̪
بائیسکل	b ɑː iː s ɪ k ə l
کروڈ	k ə r oː ɖ
جواب	d͡ʒ ə ʋ ɑː b
نقش	n ə q ʃ
سرکار	s ə ɾ k ɑː ɾ
جونیر	d͡ʒ ʊ n iː ɾ
ماہ	m aː ɦ
لیئج	l ɪ j eː d͡ʒ
چیلنجس	t͡ʃ eː l ə n d͡ʒ s
مہربن	m ə ɦ r b ə n
پوزم	p oː z ə m
نستعلیق	n ə s t̪ ɑː l iː q
خاموش	x ɑː m oː ʃ
اپدهان	ʊ p d̪ʱ ɑː n
ری۔ایکٹرس	ɾ eː ɑː ɪ k t̪ ɾ ʊ s
بدھسٹ	b ʊ d̪ʱ s ʈ
کرےگی	k ə r eɪ ɡ iː
توسیعی	t̪ ʊ s iː ʔ iː
تلاش	t ə l ɑː ʃ
مراسم	m ʊ r aː s ɪ m
پہلوان	p ə ɦ l w ə n
تاناشاہ	t̪ ɑː n ɑː ʃ ɑː ɦ
ین	iː n
جواہر	d͡ʒ ʋ ɑː ɦ ə r
چوٹ	t͡ʃ oː ʈ
برطانوی	b ɾ ɪ t̪ ɑː n ʋ iː
شرک	ʃ ɪ ɾ k
پرنسپل	p ə ɾ n s p ə l
نوٹس	n oː ʈ s
نائٹ	n aɪ t̪
سلیکٹر	s ʊ l iː k ʈ ɛ ɾ
ترملگیری	t ɛ r m ʊ l g iː r iː
حیات	ɦ ə j ɑː t̪
بٹور	b ʊ t̪ ɔː ɾ
قیصر	q eː s ɾ
موظف	m ʊ z ə f
پریدا	p ə r iː d̪ ɑː
فرنانڈو	f a r n ɑː n ɖ a uː
ابلیس	ɑː b l iː s
چڑیا	t͡ʃ ɪ ɽ ɪ j ɑː
پنکھا	p ə ŋ kʰ ɑː
اورنمائش	ɔː r n ə m ɑː ɪ ʃ
نارنجی	n ɑː ɾ ə n d͡ʒ iː
رنگولی	ɾ ə ŋ ɡ oː l iː
اڑیوا	ə ɽ eː ʋ ɑː
جبوتی	d͡ʒ ɪ b uː t̪ iː
پانڈے	p ɑː n ʈ e
سزا	s ə z ɑː
بنجارا	b ə n d͡ʒ ɑː ɾ ɑː
بشرط	b ə ʃ ɾ ʈ
بھروسہ	bʱ ə ɾ oː s ɑː
نرمان	n ɪ ɾ m ɑː ɳ
شے۶	ʃ eː ʧʰ ʰ
کواری	k w ɑː r iː
وظیفدار	ʋ ʊ z iː f d̪ ɑː ɾ
اہلیہ	ɑː ɦ l iː ɑː
ہیڈکوارٹر	ɦ iː ʈ k ʋ ɑː ɾ ʈ ə ɾ
آرزو	ɑː ɾ z uː
اسلام	ɪ s l ɑː m
بتایاکہ	b ɪ t̪ ɑː j ɑː k ɛː
غور	ɣ ʊ ɾ
ولایت	ʋ ɪ l ɑː j ə t̪
قیادت	q ɪ j ɑː d̪ ə t̪
منتظم	m ʊ n t̪ ə z ɪ m
کاروبار	k ɑː ɾ oː b ɑː ɾ
عزا	ʕ ɪ z ɑː
منگوانا	m ə n ɡ ʋ ɑː n ɑː
ڈرون	ɖ r oː n
تروپتی	t̪ r oʊ p t̪ iː
پاکستانی	p ɑː k ɪ s t̪ ɑː n iː
لسانیات	l ɪ s ɑː n ɪ j ɑː t̪
دن	d̪ ɪ n
قدرے	q ɪ d̪ r eː
اسٹائسٹکس	ɪ s ʈ ɑː ɪ s ʈ k s
گود	ɡ uː d̪
حقارت	ɦ ʊ q ɑː ɾ ə t̪
ٹیکساس	ʈ iː k s ɑː s
نقطہ	n ʊ q t̪ ɑː
تحصیل	t̪ ɦ ʊ s iː l
خوش	x ʊ ʃ
بادام	b ɑː d̪ ɑː m
دفعہ	d̪ ə f ʔ ɑː
شعر	ʃ eː ɾ
فالحال	f ɪ l ɦ ɑː l
سشما	s ʊ ʃ m ɑː
طبقات	ʈ ɑː b q ɑː t̪
چوگنا	t͡ʃ ɔː ɡ ʊ n ɑː
طلبی	t̪ ɑː l b iː
کینچلی	k ẽː t͡ʃ ʊ l iː
پنیسر	p a n iː s ɛ r
مفاہمانہ	m ʊ f ɑː ɦ m ɑː n ɑː
مالدیپ	m ɑː l d̪ iː p
رنجن	r ə n d͡ʒ ə n
دھوسر	d̪ʱ uː s ə r
آرام	ɑː ɾ ɑː m
ابوغریب	ɑː b ʊ ɣ ɾ iː b
نباتیات	n ə b ɑː t̪ ɪ j ɑː t̪
جبری	d͡ʒ ʊ b r iː
ساتویں	s ɑː t̪ ʋ eː n
تمنچه	t̪ ə m ə n t͡ʃ ɑː
گنبذ	ɡ ʊ m b ə z
نارا	n ɑː ɾ ɑː
حجام	ɦ ə d͡ʒ d͡ʒ ɑː m
پڑوسی	p ɑː r oː s iː
بودھن	b oː d̪ʱ ə n
خانساماں	x ɑː n s ɑː m ɑ̃ː
قرعہ	q ʊ r a ʕ ɑː
اندیشہ	ɪ n d̪ iː ʃ ɑː
ابن	ə b n
آلراؤنڈر	ɑː l r aʊ n d̪ ə r
جنم	d͡ʒ ə n m
جیبھ	d͡ʒ iː bʱ
سنگھ	s ɪ̃ ŋ ɡʱ
چوڑا	t͡ʃ ɔː ɽ ɑː
کوہ	k oː ɦ
بہتر	b ə ɦ ə t̪ t̪ ə ɾ
ولاقو	ʋ ə l aː q oː
غیردستوری	ɣ ɛː r d̪ ʊ s t̪ ʊ ɾ iː
احتمال	eː ɦ t̪ eː m ɑː l
بهنجك	bʱ ə n d͡ʒ ə k
دمشق	d̪ ə m ɪ ʃ q
نمکین	n ə m k iː n
متاثرہ	m ʊ t̪ ɑː s ɪ ɾ ɑː
سندھو	s ɪ n d̪ʱ uː
شان	ʃ aː n
مہلوک	m ə h l oː k
نمبیار	n ə m b j aː r
تین	t̪ iː n
نافرمان	n ɑː f ə ɾ m ɑː n
امی	ə m m iː
تعصبیت	t̪ ʕ a s b iː t̪
کیا	k ɪ j ɑː
بیک	b eː k
راجستھان	ɾ ɑː d͡ʒ s t̪ʰ ɑː n
دفن	d̪ a f n
کہاوت	k ə ɦ ɑː ʋ ə t̪
مارکٹس	m ɑː r k ɪ t̪ s
صلاح	s ʊ l ɑː ɦ
معالجہ	m a ʕ ɑː l ɪ d͡ʒ ɑː
اپنيتر	ʊ p n eː t̪ ɾᵊ
ٹورنمنٹ	ʈ ɔː r n m ə n ʈ
فیالوقت	f iː ɑː l ʋ ʊ q t̪
رواداری	ɾ ʋ ɑː d̪ ɑː ɾ iː
اعتماد	ɪ ʔ t̪ ɪ m ɑː d̪
ناممکن	n ɑː m ʊ m k ə n
رفتار	ɾ ə f t̪ ɑː ɾ
سماعت	s ə m ɑː ʔ ə t̪
اتفاق	ɪ t̪ t̪ ɪ f ɑː q
انحراف	ɪ n ɦ ɪ r ɑː f
بنتی	b ɪ n t̪ iː
مضمون	m ʊ z m uː n
راہداری	ɾ ɑː ɦ d̪ ɑː ɾ iː
پنگھٹ	p ə ŋ ɡʱ ə ʈ
چلا	t͡ʃ ʊ l ɑː
چھوٹ	t͡ʃʰ uː ʈ
سٹی	s ʈ iː
چیتاپور	t͡ʃ iː t̪ aː p ɔː r
سوا	s ʋ aː
ایماندار	iː m ɑː n d̪ ɑː ɾ
ریپھ	ɾ eː pʰ
ریاستہا	ɾ ɪ j ɑː s ə t̪ ɦ ɑː
وانچو	ʋ ɑː n t͡ʃ oː
دکھانا	d̪ ɪ kʰ ɑː n ɑː
تلخی	t̪ ə l x iː
چیلنج	t͡ʃ eː l n d͡ʒ
علم	ɪ l m
کهان	kʰ ɑː n
جوگی	d͡ʒ oː ɡ iː
یعنی	j ɑː ʔ n iː
صابن	s ɑː b ʊ n
حقوق	ɦ ʊ q uː q
دھرتی	d̪ʱ ə ɾ t̪ iː
دوزخ	d̪ oː z ə x
ممبئی	m ʊ m b ə iː
مٹنا	m ɪ ʈ n ɑː
سنسکرت	s ə n s k ɾ ɪ t̪
امرود	ə m ɾ uː d̪
ایونٹ	ɑː j uː n ʈ
پجاری	p ʊ d͡ʒ ɑː r iː
مقبوض	m ə q b uː z
کوشش	k oː ʃ ɪ ʃ
جل	d͡ʒ ə l
خلافت	x ɪ l ɑː f ə t̪
ب	b
ترٹی	t̪ ɾ ʊ ʈ iː
پریمئر	p r eɪ m ɪə r
غفلت	ɣ ə f l ə t̪
خواہش	x ɑː ɦ ɪ ʃ
اطلس	ə t̪ l ə s
ڈال	ɖ ɑː l
ڈاریوس	ɖ ɑː ɾ iː ʊ s
انڈر	ə n ɖ ə ɾ
گجرات	ɡ ʊ d͡ʒᵊ ɾ ɑː t̪
گذارنا	ɡ ʊ z ɑː ɾ n ɑː
برس	b ɛː ɾ s
سگنل	s ɪ g n ə l
توجہی	t̪ ʋ oː d͡ʒ ɦ iː
کالنگ	k ɑː l ə ŋ ɡ
انار	ə n ɑː ɾ
گندہ	ɡ ə n d̪ ɑː
تنازعہ	t̪ ə n ɑː z a ɦ
بھاروپیہ	bʱ ɑː ɾ oː p ɪ j ɑː
بہت	b ə ɦ ʊ t̪
کارگزاری	k ɑː r ɡ ʊ z ɑː r iː
کونسل	k oː n s ə l
سیرسہ	s eː ɾ s ə
ڈھانپنا	ɖʱ ɑ̃ː p n ɑː
موجودہ	m oː d͡ʒ uː d ɑː
گھرانا	ɡʱ ə ɾ ɑː n ɑː
کتی	k ə t̪ iː
دیگر	d̪ eː ɡ ɾ
لاہور	l ə ɦ oː ɾ
حسنی	ɦ ə s n iː
پنا	p ə n n ɑː
کمرہ	k ə m ɾ ɑː
ریکارڈکردہ	r eː k ɑː r ʈ k ʊ r d ə ɦ
مدائن	m ʊ d̪ ɑː ɪ n
غیرمنافع	ɣ ɛː r m ə n ɑː f ɛ
مولانا	m oː l ɑː n ɑː
بیچ	b iː t͡ʃ
عطر	ʔ ɪ t̪ ɾ
سیما	s iː m ɑː
وتر	ʋ ə t̪ ə ɾ
آبادی	ɑː b ɑː d̪ iː
جلسہ	d͡ʒ ə l s ɑ ɦ
پردیپ	p ə r d iː p
گلہری	ɡ ɪ l ə ɦ ɾ iː
بطخ	b ə t̪ː ə x
بدر	b ə d̪ ə ɾ
اگربتی	ə ɡ ə ɾ b ə t̪ t̪ iː
ٹرافک	ʈ r ɑː f ɪ k
بےصبری	b eː s ʊ b ɾ iː
حجر	ɦ ə d͡ʒ ɾ
ناخوش	n ɑː x ʊ ʃ
سائیٹ	s aɪ ʈ
غنچہ	ɣ ʊ n t͡ʃ ɑː
کنجی	k ʊ n d͡ʒ iː
مہاجر	m ʊ ɦ ɑː d͡ʒ ɪ ɾ
ذرہ	z ə rː ə
بوتھا	b oː t̪ʰ ɑː
واکیہ	ʋ ɑː k jᵊ
معبود	m ɑː ʔ b uː d̪
راج	ɾ ɑː d͡ʒ
جدید	d͡ʒ ə d̪ iː d̪
نوبت	n ɔː b ə t̪
گلال	ɡ ʊ l ɑː l
اوز	oː z
رہ	r ə ɦ
منی	m ə n iː
سلوک	s ʊ l uː k
بموجب	b ə m ʊ d͡ʒ ɪ b
ریچھ	ɾ iː t͡ʃʰ
انفرنس	ɪ n f ə r n ə s
راہب	ɾ ɑː ɦ ɪ b
گگن	ɡ ə ɡ ə n
دیپکا	d̪ iː p ɪ k ɑː
اجالنا	ʊ d͡ʒ ɑː l n ɑː
لکھنا	l ɪ kʰ n ɑː
ریشم	ɾ eː ʃ ə m
ووٹ	ʋ uː ʈ
شاہراہ	ʃ ɑː ɦ ɾ ɑː ɦ
تمہارا	t̪ ʊ m ɦ ɑː ɾ ɑː
ونا	ʋ ɪ n ɑː
وہاں	ʋ ə ɦ ɑ̃ː
اینٹی	ʔ eː n ʈ iː
تیرھواں	t̪ ɪ ɾ ʊ w ɑː n
پریم	p ɾ eː m
اگلا	ə ɡ l ɑː
میں	m ẽː
انوکھا	ə n oː kʰ ɑː
جوان	d͡ʒ ʋ ɑː n
یونان	j uː n ɑː n
تم	t̪ ʊ m
فرضی	f ə ɾ z iː
گولمیز	g oː l m iː z
عیادت	ə j ɑː d̪ ə t̪
مالگاڑی	m ɑː l ɡ ɑː ɽ iː
مارون	m ɑː ɾ oː n
جشن	d͡ʒ ə ʃ ə n
توبہ	t̪ ə ʊ b ɑː
شبھ	ʃ ʊ bʱ
جوانی	d͡ʒ ə ʋ ɑː n iː
كا	k ɑː
پیڑ	p eː ɽ
ڈبہ	ɖ ɪ b b əᵊ
سوامی	s ʊ ɑː m iː
راہ	ɾ ɑː ɦ
چنانکه	t͡ʃ o n ɑː n k e
مخاطب	m o x ɑː t a b
واکسن	v ɑ k s a n
نااهل	n ɑː ʔ a h l
بینی	b i n iː
جانباز	d͡ʒ ɑː m b ɑː z
موی	m uː j
دوست	d oː s t
فرق	f a ɾ q
زود	z u d
لوبیا	l oː b i i̯ ɑː
تازه‌ترین	t ɑː z e t a ɾ iː n
تصحیح	t a s h e h
صحرا	s a h ɾ ɑː
اجازه	e d͡ʒ ɑː z e
نظام	n e z ɑː m
شناختن	ʃ e n ɑː x t a n
الماس‌ها	a l m ɑː s h ɑː
بریدن	b o ɾ iː d a n
دقت	d e ɢ ɢ a t
ثابت	s ɑː b e tʰ
تار	t ɑː ɾ
تصویر	t a s v i ɾ
جان	d͡ʒ uː n
شپش	ʃ e p e ʃ
خدا	x o d ɑː
ابری	ʔ a b ɾ iː
برداشتن	b a ɾ d ɑː ʃ t a n
وسط	v a s a t
پیسه	p a j s a
زیرسیگاری	z iː ɾ s iː ɡ ɑː ɾ iː
رسمی	ɾ a s m iː
مهندسی	m o h a n d e s iː
زیر	z e ɾ
آفند	ɑː f a n d
سیر	s e ɾ
مرشدقلی	m o ɾ ʃ e d ɢ o l iː
فرج	f a ɾ d͡ʒ
مروارید	m o ɾ v ɑː ɾ iː d
قبرستان	q a b ɾ i s t ɑː n
غریب	ɢ a ɾ iː b
مقطع	m a q t a ʔ
نغز	n a ɣ z
ساده	s ɑː d a
خوراک	x o ɾ ɑː k
فرمان	f a ɾ m ɑː n
درآوردن	d a ɾ ɑː w a ɾ d a n
مؤمن	m o ʔ m e n
وج	v a d͡ʒ
شهادت	ʃ a h ɑː d̪ a t̪
مردانه	m a ɾ d ɑː n a
بچگی	b a t t͡ʃ a ɡ iː
نشاط	n e ʃ ɑː t
بخارا	b o x ɑː ɾ ɑː
ذاتی	z ɑː t iː
مرغ‌ها	m o ɾ ɣ h ɑː
جویدن	d͡ʒ a v i d a n
مرمر	m a ɾ m a ɾ
جدا	d͡ʒ e d d a n
ژامبون	ʒ ɑː m b o n
ارغوان	a ɾ ɣ a v ɑː n
جانورشناسی	d͡ʒ ɑː n w a ɾ ʃ i n ɑː s iː
تاجگذاری	t ɑː d͡ʒ ɡ u z ɑː ɾ iː
خودکشی	x o d k o ʃ iː
چاپگر	t͡ʃ ɑː p ɡ a ɾ
آژیر	ɑː ʔ ʒ iː ɾ
اداره	e d ɑː ɾ e
امید	o m iː d
برادر	b a ɾ ɑː d a ɾ
کلپ	k l a p
زمی	z m iː
ابرنواختر	a b a ɾ n a v a x t a ɾ
عسل	a s a l
ناژو	n ɑː ʒ uː
خستگی	x a s t i ɡ iː
پستان	p e s t ɑː n
تیمارستان	t i m ɑː ɾ i s t ɑː n
سلام	s a l ɑː m
علم	a l a m
شمسی	ʃ a m s iː
سوزن	s u z a n
مؤدب	m o ʔ a d d e b
مکتب	m a k t a b
ارتش	a ɾ t i ʃ
نیرومند	n iː ɾ uː m a n d̪
فعالیت	f a ʔ ɑː l i j j a t
پرنده	p a ɾ a n d a
فرانسه	f a ɾ ɑː n s a
حیران	h a i ɾ ɑː n
جیب	d͡ʒ e b
بدن	b a d a n
کردن	k a d a n
سوگ	s oː ɡ
نیم	n i m
سقرلات	s a q i ɾ l ɑː t
اختیار	e x t i j ɑː ɾ
نهفتن	n a h o f t a n
لو	l o w
شعب	ʃ o ʔ a b
صورتی	s uː ɾ a tʰ iː
آغاز	ɑː ɣ ɑː z
نو	n a v
سرحد	s a ɾ h a d
پردیس	p a ɾ d e s
کلفخشنگ	k a l a f a x ʃ a n ɡ
ناوخدا	n ɑː v x o d ɑː
زره	z e ɾ e h
ازبکستان	o z b a k e s t ɑː n
تنیدن	t a n iː d a n
نومد	n o w m a d
خوب	x u b
مسافر	m o s ɑː f e ɾ
مجرد	m o d͡ʒ a ɾ ɾ a d
دوران	d a w a ɾ ɑː n
ارزان	a ɾ z ɑː n
بعث	b a ʔ s
بیابان	b i j ɑː b ɑː n
پروگرام	p e ɾ o ɡ e ɾ ɑː m
دبیرستان	d a b i ɾ i s tʰ ɑː n
دراییدن	d a ɾ ɑː j iː d a n
شنبه	ʃ a n b a
ژوژ	ʒ oː ʒ
رسیدن	ɾ a s i d a n
خوشگل	x o ʃ ɡ e l
سیلاس	s iː l ɑː s
اخذ	ʔ a x z
فرزندخوانده	f a ɾ z a n d x ɑː n d a
خودکار	x o d k ɑː ɾ
کاخ	k ɑː x
سهم	s a h m
ولایت	v e l ɑː j a t
قانون	q ɑː n uː n
سال	s ɑː l
شجر	ʃ a d ʒ a r
خشم	x i ʃ m
روش	ɾ a v i ʃ
فارغ	f ɑː ɾ i ɣ
باعث	b ɑː ʔ i s
چاقو	t͡ʃ ɑː q uː
ـی	e
چنان	t ʃ o n ɑː n
شوربا	ʃ oː ɾ b ɑː
هی	h e j
لهذا	l e h ɑː z ɑː
معنی	m a ʔ n iː
چمیدن	t͡ʃ a m i d a n
درخت	d a ɾ a x t
هندوانه	h e n d e v ɑː n e
جدایی	d͡ʒ o d ɑː j iː
شاپور	ʃ ɑː p uː ɾ
کالیفرنیا	k ɑː l iː f o r n i j ɑː
شوکران	ʃ a v k a ɾ ɑː n
مادرانه	m ɑː d a ɾ ɑː n a
بالا	b ɑː l ɑː
نویسه‌گردانی	n e v iː s e ɡ a ɾ d ɑː n iː
زرین	z a ɾ ɾ i n
پیمودن	p a j m u d a n
ترشک	t o ɾ ʃ a k
پاپ	p ɑː p
خشمگین	x a ʃ m ɡ i n
هندوستان	h e n d uː s t ɑː n
زهره	z o h ɾ e
پاپوش	p ɑː p oː ʃ
بیچاره	b e t͡ʃ ɑː ɾ a
سیماب	s i m ɑː b
وکیل	v a k i l
نعناع	n a ʔ n ɑː ʔ
غنی	ɢ a n iː
گذاشتن	ɡ o z ɑː ʃ t a n
ناک	n ɑː k
زراوند	z a ɾ ɑː w a n d
خرگوش	x a ɾ ɡ oː ʃ
ثابت‌ها	s ɑː b e tʰ h ɑː
تفسیدن	t a f s i d a n
رسانیدن	ɾ a s ɑː n iː d a n
نالان	n ɑː l ɑː n
ستاره‌شناس	s e t ɑː ɾ e ʃ e n ɑː s
مکانیک	m e k ɑː n iː k
اولی	a v v a l iː
پوشاک	p oː ʃ ɑː k
خویش	x e ʃ
بدبخت	b a d b a x t
حکومت	h o k uː m a t
نیوشا	n i j oː ʃ ɑː
بهبود	b e h b uː d
آمیزش	ɑː m iː z e ʃ
بستن	b a s t a n
سایه	s ɑː j a
غسل	ɢ o s l
می‌خواهم	m iː x ɑː h a m
خالو	x ɑː l uː
تسخیر	t a s x i ɾ
ژاله	ʒ ɑː l a
نبض	n a b z
هرتز	h e ɾ t z
سمیعی	s a m iː ʔ iː
قیچی	q a j t͡ʃ iː
ایران‌ویج	e ɾ ɑː n v e d͡ʒ
من	m a n
نژادی	n e ʒ ɑː d iː
خشکاندن	x o ʃ k ɑː n d a n
چلنگر	t͡ʃ e l e n ɡ a ɾ
برنامه	b a ɾ n ɑː m a
بوران	b uː ɾ ɑ n
موفقیت	m o v a f f a ɢ iː j a t
توریستی	t u ɾ i s t
مثلا	m a s a l a n
پرتوقع	p o ɾ t a v a ɢ ɢ o ʔ
سنجاب	s a n d͡ʒ ɑː b
بوالعجب	b o l ʔ a d͡ʒ a b
لاعلاج	l ɑː ʔ i l ɑː d͡ʒ
سازمان	s ɑː z i m ɑː n
ـیسم	i s m
دیسال	d i s ɑː l
تا	t ɑː
حداکثر	h a d d i a k s a ɾ
آرامی	ɑː ɾ ɑː m iː
متضاد	m o t a z ɑː d
آچار	ɑː t͡ʃ ɑː ɾ
تمر	t a m u ɾ
پالایش	p ɑː l ɑː j i ʃ
بزرگ	b o z o ɾ ɡ
بالغ	b ɑː l e ɣ
سبد	s a b a d
پاک	p ɑː k
آب	ɑː b
اردیبهشت	o ɾ d iː b e h e ʃ t
غافت	ɢ ɑː f e t
جایگاه	d͡ʒ ɑː j ɡ ɑː h
کوفته	k oː f t a
کاهش	k ɑː h i ʃ
پتک	p o t k
ایالت	i j ɑː l a t
قهوه‌ای	q a h v a ʔ iː
تکیدن	t a k i d a n
ارزش	a ɾ z i ʃ
سری	s a ɾ iː
قهوه‌خانه	q a h v a x ɑː n a
دشوار	d o ʃ v ɑː ɾ
لایه	l ɑː j e
رستن	ɾ o s t a n
غم	ɢ a m
خنیا	x o n i j ɑː
آکندن	ʔ ɑː k a n d a n
حفاظت	h e f ɑː z a t
پایتخت	p ɑː j t a x t
عالم	ɑː l a m
شورش	ʃ u ɾ i ʃ
زیبیدن	z e b i d a n
موز	m a v z
سپر	s e p a ɾ
اذیت	a z i j a t
آستانه	ɑː s t ɑː n a
حتما	h a t m a n
سرپوش	s a ɾ p oː ʃ
دلاور	d e l ɑː v a ɾ
نجس‌تر	n a d ʒ a s t a ɾ
بیش	b e ʃ
الهام	e l h ɑː m
شغل	ʃ o ɢ l
آشوب	ɑː ʃ oː b
زیباترین	z iː b ɑː t a ɾ iː n
عدد	ʔ a d a d
داشتن	d ɑː ʃ t a n
فرهنگ	f a ɾ h a n ɡ
کلمه	k a l a m a
غمناک	ɢ a m n ɑː k
سلجوق	s a l d͡ʒ u q
صوت	s a v t
کبوتر	k a b oː t a ɾ
دعوت	d a ʔ v a t
بلد	b a l a d
اشترخار	o ʃ t o ɾ x ɑː ɾ
چطور	t͡ʃ e t o w ɾ
ستاره	s e t ɑː ɾ e
هامون	h ɑː m uː n
نفت	n a f t
تهرون	t e h ɾ uː n
خزاعی	x a z ɑː ʔ iː
بی‌شمار	b e ʃ u m ɑː ɾ
ادیان	a d j ɑː n
رنگین	ɾ a n ɡ i n
ختنه‌گاه	x a t n a ɡ ɑː h
نوشیدنی	n u ʃ i d a n iː
نژادپرست	n e ʒ ɑː d p a ɾ a s t
کشتن	k e ʃ t a n
خدنگ	x a d a n ɡ
وقت	v a q t
ظهور	z o h uː ɾ
انتقام	e n t e ɢ ɑː m
هنی	h a n iː
مقداد	m e ɣ d ɑː d
اصفهانی	e s f a h ɑː n iː
تاکنون	t ɑː k u n uː n
بهترین	b e h t a ɾ i n
مژده	m o ʒ d e
همنوع‌خواری	h a m n a v ʔ x ɑː ɾ iː
چینی	t͡ʃ i n iː
سنگین	s a n ɡ i n
کهف	k a h f
بوم	b u m
خاطره	x ɑː t i ɾ a
رودابه	ɾ uː d ɑː b e
ابهام	e b h ɑː m
عصر	ʔ a s ɾ
دستار	d a s t ɑː ɾ
همجنس‌گراهراس	h a m d͡ʒ i n s ɡ a ɾ ɑː h a ɾ ɑː s
الموت	ʔ a l a m uː t
استراتژی	ɛ s t ɾ ɑː t ɛ ʒ iː
بار	b ɑː ɾ
تولد	t a v a l l u d
جادو	d͡ʒ ɑː d uː
رازی	ɾ ɑː z iː
ول	v e l
بری	b e ɾ e j
قبر	q a b ɾ
تازه	t ɑː z a
استعداد	e s t e ʔ d ɑː d
مربا	m o r a b b ɑ
دنیا	d o n j ɑː
طوفان	t u f ɑː n
شیردال	ʃ e ɾ d ɑː l
پیکار	p a j k ɑː ɾ
خجالتی	x e d͡ʒ ɑː l a t iː
مغرور	m a ɣ ɾ uː ɾ
پی	p e j
زورمند	z oː ɾ m a n d
قند	q a n d
الله‌قلی	a l l ɑː h q u l iː
شکافتن	ʃ e k ɑː f t a n
نیمروز	n e m ɾ ɵː z
خلوت	x a l v a t
عضوها	o z v h ɑ
پا	p ɑː
کتاب	k e t ɑː b
مهمان	m e h m ɑː n
ژرفی	ʒ a ɾ f iː
سیب	s e b
سوسمار	s uː s m ɑː r
پرتگاه	p a ɾ t ɡ ɑː h
مردم‌شناس	m a ɾ d u m ʃ i n ɑː s
خوشگل‌ترین	x o ʃ ɡ e l t a ɾ iː n
کادو	k ɑː d u
فرشته	f a ɾ i ʃ t a
هند	h e n d
سیاست	s i j ɑː s a t
مرد	m a ɾ d
کلاس	k e l ɑː s
شجاعت	ʃ a d͡ʒ ɑ ʔ a t
چرک	t ʃ e ɾ k
قیمه	q a j m a
چهارده	t͡ʃ a h ɑː ɾ d a h
تشریح	t a ʃ ɾ e h
نواختن	n a v ɑː x t a n
اشک	a ʃ k
جنس	d͡ʒ e n s
شاهنامه	ʃ ɑː h n ɑː m a
اسکندر	e s k a n d a ɾ
دلسوز	d̪ i l s oː z
چو	t ʃ o w
همدم	h a m d a m
موقعیت	m a v q i ʔ i j a t
بنابراین	b e n ɑː b a ɾ iː n
مهر	m a h ɾ
پرندگان	p a ɾ a n d a ɡ ɑː n
پرکار	p o ɾ k ɑː ɾ
شراب	ʃ a ɾ ɑː b
کود	k oː d
اعضا	a ʔ z ɑː
تولید	t a v l i d
مقدس	m o ɢ a d d a s
زرشکی	z e ɾ e ʃ k iː
مس	m e s
فامیل	f ɑː m iː l
معبد	m a ʔ b a d
ذکر	z a k a ɾ
پرستار	p a ɾ a s t ɑː ɾ
فرستادن	f e ɾ e s t ɑː d a n
تودری	t u d a ɾ iː
بی‌وفا	b e v a f ɑː
پدر	p e d e ɾ
مملکت	m a m l a k a t
برزیستن	b a r z iː s t a n
اسفند	e s f a n d̪
زمین‌شناسی	z a m i n ʃ i n ɑː s iː
ثنویت	s a n a v i j j a t
اختصار	e x t e s ɑː ɾ
نمایندگان	n a m ɑː j a n d e ɡ ɑː n
اصلاً	a s l a n
حشیش	h a ʃ i ʃ
حضور	h o z uː ɾ
آزادی	ɑː z ɑː d iː
شاداب	ʃ ɑː d ɑː b
کارمند	k ɑː ɾ m a n d
ارس	a ɾ a s
جامعه	d͡ʒ ɑː m i ʔ a
رنده	ɾ a n d a
زیگ	z iː ɡ
مشرک	m o ʃ ɾ e k
قهوه	q a h v a
بازنشسته	b ɑː z n i ʃ a s t a
قاره	q ɑː ɾ a
دشنام	d o ʃ n ɑː m
سبز	s a b z
سنت‌ها	s o n a t h ɑː
نمونه	n a m u n a
نه	n o h
آذرخش	ɑː ð a ɾ a x ʃ
باغ‌ها	b ɑː ɣ h ɑː
پنگان	p e n ɡ ɑː n
بو	b oː
معتدل	m o ʔ t a d e l
شبیه	ʃ a b e h
جعبه	d͡ʒ a ʔ b a
کابلی	k ɑː b u l iː
خاستن	x ɑː s t a n
آبگینه	ʔ ɑː b ɡ iː n e
تهران	t a h ɾ ɑː n
دم	d a m
شگرد	ʃ e ɡ e ɾ d
بازوبند	b ɑː z uː b a n d
آلودن	ɑː l uː d a n
کجا	k o d͡ʒ ɑː
آجر	ɑː d͡ʒ u ɾ
کلیچه	k o l iː t͡ʃ e
پرسمان	p o r s e m ɑː n
خلیج	x a l i d͡ʒ
تفنگ	t o f a ŋ ɡ
کنده	k a n d a
زائر	z ɑː ʔ i ɾ
همیشه	h a m e ʃ a
پوزخند	p uː z x a n d
نیفه	n e f a
تکیه	t a k j a
تفاوت	t a f ɑː w u t
پراندن	p a ɾ ɑː n d a n
زیاد	z i j ɑː d
شکال	ʃ e k ɑː l
فرآیند	f a ɾ ɑː j a n d
باز	b ɑː z
ناف	n ɑː f
صحیح	s a h e h
آقا	ɑː q ɑː
خو	x o
رکورد	ɾ e k o w ɾ d
دیوشناسی	d e v ʃ i n ɑː s iː
بغداد	b a ɣ d ɑː d
آری	ɑː ɾ eː
ضعف	z a ʔ f
دنیدن	d a n iː d a n
ناراحت	n ɑː ɾ ɑː h a t
قلم	q a l a m
بابل	b ɑː b i l
ژاژ	ʒ ɑː ʒ
بیدادی	b eː d ɑː d iː
ابزار	a b z ɑː ɾ
کن	k e n
فعال	f a ʔ ɑː l
عنابی	a n ɑː b iː
جگر	d ʒ e ɡ a ɾ
لقب	l a q a b
شکسته‌نستعلیق	ʃ e k a s t e n a s t a ʔ l iː ɢ
باستانی	b ɑː s t ɑː n iː
ربع	ɾ o b ʔ
دور	d a v ɾ
هرکس	h a r k a s
دپارتمان	d e p ɑ r tʰ e m ɑ n
کمک	k o m a k
ذبح	z e b h
دارو	d ɑː ɾ uː
ائتلاف	e ʔ t e l ɑː f
تاجیک	t ɑː d͡ʒ i k
عربی	ʔ a ɾ a b iː
محبت	m a h a b b a t
چایدان	t͡ʃ ɑː j d ɑː n
سرعت	s o ɾ ʔ a t
مسئول	m a s ʔ u l
شب	ʃ a b
صنعت	s a n ʔ a t
اعنی	a ʔ n iː
آشفته	ɑː ʃ u f t a
روباه	ɾ oː b ɑː h
صاحب	s ɑː h i b
مژه	m e ʒ e
اسپندان	e s p a n d ɑː n
شهوتی	ʃ a h v a t iː
برجسته	b a ɾ d͡ʒ a s t a
مصنوعی	m a s n u ʔ iː
زیستن	z i s t a n
مرداد	m o ɾ d̪ ɑː d̪
ریگ	ɾ e ɡ
تکفور	t a k f uː ɾ
رومی	ɾ oː m iː
غاز	ɢ ɑː z
نمایه	n a m ɑː j e
شاخه	ʃ ɑː x e
هنگ	h a n ɡ
انطاکیه	a n t ɑː k i j a
مردم	m a ɾ d u m
نامیدن	n ɑː m iː d a n
رتیل	ɾ o t e j l
خاتم	x ɑː t a m
فرارود	f a ɾ ɑː ɾ uː d
ژکفری	ʒ a k f a ɾ iː
طمطراق	t o m t o ɾ ɑː ɢ
کتب	k o t o b
بوستان	b oː s t ɑː n
فراموشیدن	f a ɾ ɑː m uː ʃ iː d̪ a n
لاغر	l ɑː ɣ a ɾ
خواستار	x ɑː s t̪ ɑː ɾ
سیم	s e j o m
داغ	d ɑː ɣ
مجازات	m o d ʒ ɑː z ɑː t
شاه	ʃ ɑː h
کفاش	k a f f ɑ ʃ
اعدام	e ʔ d ɑː m
کوهستان	k oː h i s t ɑː n
حدس	h a d s
ثروت	s a ɾ v a t
چندین	t͡ʃ a n d i n
درشت	d o ɾ o ʃ t
ظرف	z a ɾ f
زدن	z a d a n
خرداد	x o ɾ d̪ ɑː d̪
خیز	x e z
اصول‌گرا	o s uː l ɡ a ɾ ɑː
احتمال	e h t e m ɑː l
پیچیدن	p e t͡ʃ i d a
مؤسسه	m o ʔ a s s a s e
مجروح	m a d͡ʒ ɾ uː h
باد	b ɑː d
پایگاه	p ɑː j i ɡ ɑː h
پژوهش	p a ʒ u h i ʃ
عقرب	ʔ a ɣ ɾ a b
به‌آفرید	b e h ɑː f a ɾ iː d
همه	h a m e
داخل	d ɑː x i l i
تابع	t ɑː b i ʔ
خوره	x o rː a h
واش	v ɑ ʃ
پیاله	p i j ɑː l a
بحث	b a h s
البرز	ʔ a l b o ɾ z
خط	x a t
تاج	t ɑː d͡ʒ
ریدک	r e j d a k
اسپرزه	e s p a ɾ z e
پدافند	p a d ɑː f a n d
جاری	d͡ʒ ɑː ɾ i
ارگ	o ɾ ɡ
ژوپیتر	ʒ u p i t e ɾ
آلفته	ɑː l u f t a
بیل	b e l
خاتمه	x ɑː t i m a
اعلام	e ʔ l ɑː m
دفعه	d a f ʔ a
مشکی	m e ʃ kʰ iː
نژادها	n e ʒ ɑː d h ɑː
باغات	b ɑː ɣ ɑː t̪
شکلاتی	ʃ o kʰ o l ɑ tʰ i
اتفاق	e t t e f ɑː ɢ
شب‌بو	ʃ a b b oː
پروسه	p e ɾ o s e
تنیسور	t e n iː s o ɾ
غمگین	ɢ a m ɡ iː n
سرخوش	s a ɾ x u ʃ
بنیاد	b o n j ɑː d
مناسب	m o n ɑː s e b
آهن	ɑː h a n
جلسه	d͡ʒ a l a s a
برپا	b a ɾ p ɑː
بیشه	b e ʃ a
دستکند	d a s t k a n d
تهدید	t a h d i d
مشاهده	m o ʃ ɑː h a d e
ابری‌سازی	ʔ a b ɾ iː s ɑː z iː
اقمار	a q m ɑː ɾ
غره	ɢ a ɾ ɾ e
بلافاصله	b e l ɑː f ɑː s e l e
رسم	ɾ a s m
صنف	s a n f
آش	ʔ ɑː ʃ
آزاد	ɑː z ɑː d
خراب	x a ɾ ɑː b
ضد	z e d
شرط	ʃ a ɾ t
تازه‌تر	t ɑː z e t a ɾ
بادام	b ɑː d ɑː m
دوجنس‌گرا	d o d͡ʒ e n s ɡ a ɾ ɑː
قاچاقچی	q ɑː t͡ʃ ɑː q t͡ʃ iː
مفتی	m o f t iː
جنسی	d͡ʒ e n s iː
وفات	v a f ɑː t
مروزی	m a ɾ v e z iː
سوی	s oː j
ثانیه	s ɑː n i j a
خوشه	x oː ʃ a
پسی	p o s eː
فردوس	f e ɾ d o w s
قدرت	q u d ɾ a t
کهنه	k o h n e
افزودن	a f z u d a n
اسم	e s m
شروع	ʃ o r uː ʔ
بسته	b a s t a
چکمه	t͡ʃ a k m a
تنیس‌باز	t e n iː s b ɑː z
ناچار	n ɑː t͡ʃ ɑː ɾ
آدینه	ɑː d iː n a
ستبر	s e tʰ a b ɾ
بایستی	b ɑː j a s t iː
درنگ	d e ɾ a n ɡ
آدم‌ها	ɑː d a m h ɑː
مرغان	m o ɾ ɣ ɑː n
کلید	k a l i d
جزیره	d͡ʒ a z i ɾ a
چکیدن	t͡ʃ a k i d a n
مراسم	m a ɾ ɑː s i m
گاراژ	ɡ ɑː ɾ ɑː ʒ
آغوش	ɑː ɣ oː ʃ
کلاغ	k a l ɑː ɣ
نامه	n ɑː m a
ترجمه	t a ɾ d͡ʒ u m a
جهان	d͡ʒ a h ɑː n
نحو	n a h v
منگنه	m a ŋ ɡ a n a
انبار	ʔ a m b ɑː ɾ
هرمز	h o ɾ m o z
اصلاح	e s l ɑː h
صاعقه	s ɑː ʔ i q a
ایران	e ɾ ɑː n
انگیزه	a n ɡ e z a
زنبق	z a m b a q
نارنجک	n ɑː ɾ a n d͡ʒ a k
داماد	d uː m ɑː d
دروغ	d o ɾ uː ɢ
ورز	v a ɾ z
بحر	b a h ɾ
آتش	ɑː tʰ a ʃ
بی‌نظیر	b e n a z i ɾ
مضحک	m o z h e k
ماست	m ɑː s t
تاریخچه	t ɑː ɾ iː x t͡ʃ a
آفریدن	ɑː f a ɾ iː d a n
بادرنگ	b ɑː d ɾ a n ɡ
صورت	s u ɾ a t
دین‌داری	d i n d ɑː ɾ iː
درنده	d a ɾ a n d a
تشکیلات	t a ʃ k i l ɑː t
هفده	h a b d a h
صفت	s e f a t
مذهبی	m a z h a b iː
خوراندن	x o ɾ ɑː n d a n
ماندن	m ɑː n d a n
مستقیم	m o s t a ɢ iː m
ژرف‌ترین	ʒ a ɾ f t a ɾ iː n
سوغات	s a v ɣ ɑː t
طاووس	t ɑː w uː s
نشدنی	n a ʃ o d a n i
انجامیدن	a n d͡ʒ ɑː m iː d a n
جشن	d͡ʒ a ʃ n
شیوا	ʃ eː w ɑː
منتظر	m o n t a z e ɾ
وروجک	v o ɾ uː d͡ʒ a kʲ
متخصص	m o t a x a sː e s
قبلا	q a b l a n
نگهداری	n e ɡ a h d ɑː ɾ iː
دیسک‌ها	d iː s k h ɑː
غلامی	ɢ o l ɑː m iː
ختو	x o t uː
سنبه	s o m b e
میخانه	m a j x ɑː n a
صحبت	s o h b a t
تلاش	t a l ɑː ʃ
گاز	ɡ ɑː z
ارده	a ɾ d a
گرختن	ɡ o ɾ eː x t a n
پوییدن	p u j i d a n
سهل	s a h l
غلط	ɢ a l a t
زیباتر	z iː b ɑː t a ɾ
بیور	b eː w a ɾ
شخص	ʃ a x s
اراده	e ɾ ɑː d e
پرداختن	p a ɾ d ɑː x t a n
هفته‌ها	h a f t e h ɑː
بین‌المللی	b a j n a l m i l a l iː
فرد	f a ɾ d
تنها	t a n h ɑː
ققنوس	q u q n u s
تلویحی	t a l v iː h iː
منع	m a n ʔ
چهارشنبه	t͡ʃ a h ɑː ɾ ʃ a n b a
شاذ	ʃ ɑː z
شدنی	ʃ o d a n iː
بارداری	b ɑː ɾ d ɑː ɾ iː
شرکت	ʃ e ɾ k a t
خدای	x o d ɑː j
بعل	b a ʔ l
حرکت	h a ɾ a k a t
لابد	l ɑː b u d
سیزده	s e n z d a h
شوروی	ʃ uː ɾ a v iː
القاعده	a l q ɑː ʔ i d a
تیهو	t i h ɵː
اوگاندا	u ɡ ɑː n d ɑː
فروغ	f o ɾ uː ɢ
بنگاه	b o n ɡ ɑː h
استاندار	o s tʰ uː n d ɑː ɾ
فضایی	f a z ɑː j iː
کشتار	k o ʃ t ɑː ɾ
حساب	h e s ɑː b
پاییز	p ɑː iː z
هیچ‌کدام	h e t͡ʃ k u d ɑː m
وجود	v o d͡ʒ uː d
نصیحت	n a s i h a t
پایه	p ɑː j a
وارد	v ɑː ɾ e d
انفجار	e n f e d͡ʒ ɑː ɾ
منوچهر	m a n u t͡ʃ e h ɾ
بیرون	b e ɾ u n
خواندن	x ɑː n d a n
آینده	ɑː j a n d a
تختخواب	t a x t i x ɑː b
شکستن	ʃ e kʲ a s t̪ʰ a n
مجید	m a d͡ʒ iː d
وضوح	v o z uː h
مصر	m e s ɾ
اقتصادی	e ɢ t e s ɑː d iː
خوشی	x o ʃ iː
کمزور	k a m z oː ɾ
قرن	q a ɾ n
روان‌شناس	ɾ a v ɑː n ʃ i n ɑː s
ستوان	s o t v ɑː n
پادشاه	p ɑː d i ʃ ɑː h
هول	h a v l
مسلحانه	m o s a l l a h ɑː n e
استراحت	e s t e ɾ ɑː h a t
گذشته	ɡ o z a ʃ t e
مغازه	m a ɣ ɑː z a
کارگاه	k ɑː ɾ ɡ ɑː h
سختن	s o x t a n
دریافت	d a ɾ j ɑː f t
مهبل	m a h b a l
چشم	t͡ʃ a ʃ m
مریض	m a ɾ i z
آبی	ɑː b iː
خاص‌تر	x ɑː s tʰ a ɾ
ایرانی	e ɾ ɑː n iː
بانو	b ɑː n uː
موجود	m a v d͡ʒ u d
پنهان	p e n h uː n
انه	ɑː n a
هیس	sː
ایستگاه	i s t ɡ ɑː h
ابرو	a b ɾ u
کوتاه‌ترین	k uː t ɑː h t a ɾ iː n
قسم	q a s a m
غمگینی	ɢ a m ɡ iː n iː
باریک	b ɑː ɾ iː k
سرطان	s a ɾ a t ɑː n
افزایش	a f z ɑː j i ʃ
خودرو	x o d ɾ o w
الان	ʔ a l ʔ ɑː n
خانقاه	x ɑː n q ɑː h
قطار	q a t ɑː ɾ
برازیدن	b a ɾ ɑː z iː d a n
ازاله	e z ɑː l e
پوشیدن	p oː ʃ iː d a n
فریفتن	f a ɾ e f t a n
می	m a j
لحظه	l a h z a
واژه‌نامه	v ɑː ʒ e n ɑː m e
کنعان	k a n ʔ ɑː n
اخراج	e x ɾ ɑː d͡ʒ
اسبغول	e s b a ɢ uː l
پرسیدن	p o ɾ s iː d a n
قربک	q o ɾ b a k
صحنه	s a h n e
احترام	e h t e ɾ ɑː m
کشیش	k a ʃ i ʃ
شریک	ʃ a ɾ i k
گردن	ɡ a ɾ d a n
افسر	a f s a ɾ
رفتار	ɾ a f t ɑː ɾ
شهود	ʃ o h uː d
بسد	b e s a d
چین	t͡ʃ i n
قاطر	q ɑː t i ɾ
زرناپا	z u r n ɑː p ɑː
درد	d a ɾ d
سوگند	s a v ɡ a n d
الهه	e l ɑː h e
پرانتز	p a ɾ ɑː n t i z
بهمن	b a h m a n
لنگر	l a n ɡ a ɾ
بخصوص	b a x u s u s
درس	d a ɾ s
مشرقی	m a ʃ ɾ i q iː
اندیشه	a n d e ʃ a
پنج	p a n d͡ʒ
قلمدان	q a l a m d ɑː n
اتفاقاً	e t t e f ɑː ɢ a n
زمان	z a m ɑː n
گام	ɡ ɑː m
آموزش	ɑː m oː z i ʃ
قرمز	q i ɾ m i z
مشکل‌تر	m o ʃ k e l t a ɾ
خلاف	x e l ɑː f
لهجه	l a h d͡ʒ a
فلاخن	f a l ɑː x a n
خیال	x a j ɑː l
بیجاده	b i d͡ʒ ɑː d i
شوخی	ʃ oː x iː
روشنی	ɾ a v ʃ a n iː
شوق	ʃ a v q
همساده	h o m s ɑː d e
فشار	f e ʃ ɑː ɾ
همسده	h a m s e d a
ققنس	q u q n u s
آلایش	ɑː l ɑː j i ʃ
شش	ʃ a ʃ
زوو	z v oː
آشتی	ɑː ʃ t iː
باردار	b ɑː ɾ d ɑː ɾ
سرکه	s e ɾ k e
ضربه	z a ɾ b a
مرگ	m a ɾ ɡ
بازنشستگی	b ɑː z n i ʃ a s t a ɡ iː
پسوند	p a s v a n d
بختر	b e x t a ɾ
پیرترین	p iː ɾ t a ɾ iː n
خباز	x a b b ɑː z
بی‌گناه	b e ɡ u n ɑː h
خز	x a z
شغال‌ها	ʃ o ɣ ɑː l ɑː
میلاد	m e l ɑː d
شامل	ʃ ɑː m i l
ماه	m ɑː h
عالی	ɑː l iː
دویدن	d a v i d a n
ویس	v i s
دهقان	d e h q ɑː n
آخوند	ɑː x uː n d
مادربزرگ	m ɑː d a ɾ b u z u ɾ ɡ
قفسه	ɢ a f a s e
سالگرد	s ɑː l ɡ a ɾ d
تمرین	t a m ɾ i n
تأکید	t a ʔ k i d
فروش	f o ɾ uː ʃ
سیاسی	s i j ɑː s iː
پوده	p uː d a
هرچه	h a ɾ t͡ʃ i
زشت	z e ʃ t
آمارگر	ɑː m ɑː ɾ ɡ a ɾ
فردا	f a ɾ d ɑː
مارمولک	m ɑː ɾ m uː l a k
آسان	ɑː s ɑː n
کافی	k ɑː f iː
جمعاً	d͡ʒ a m ʔ a n
سلیمان	s o l e j m ɑː n
توجه	t a v a d d͡ʒ ɵː h
عضو	o z v
زشتی	z e ʃ t iː
بازدید	b ɑː z d iː d
سپهسالار	s e p a h s ɑː l ɑː ɾ
شپش‌ها	ʃ e p e ʃ h ɑː
رهبر	ɾ a h b a ɾ
گرا	ɡ a ɾ ɑː
زر	z a ɾ
آدم	ɑː d a m
جبر	d͡ʒ a b ɾ
اعتقاد	e ʔ t e ɢ ɑː d
هیزم	h e z u m
معمول	m a ʔ m u l
آنجا	ɑː n d͡ʒ ɑː
تعلیم	t a ʔ l i m
ریشه‌شناسی	ɾ e ʃ a ʃ i n ɑː s iː
توزیع	tʰ o ʊ̯ z iː ʔ
هندو	h e n d uː
تلف	t a l a f
ساده‌تر	s ɑː d e t a ɾ
درود	d a ɾ oː d
روستا	ɾ oː s t ɑː
منظور	m a n z u ɾ
انقلابی	e n ɢ e l ɑː b iː
فعل	f e ʔ l
سورپرایز	s u r p e ɾ ɑ j z
آفرین	ɑː f a ɾ iː n
اخیرا	a x i ɾ a n
آمرزیدن	ɑː m u ɾ z iː d a n
قول	q a v l
پزشک	p e z e ʃ k
دما	d a m ɑː
برهنگی	b a ɾ a h n a ɡ iː
عوض	i w a z
مرو	m a ɾ v
سرداب	s a ɾ d ɑː b
کوکب	k a v k a b
آشنا	ɑː ʃ i n ɑː
كنج	k o n d͡ʒ
اسپغول	e s p a ɢ uː l
سرکار	s a ɾ k ɑː ɾ
انگور	a n ɡ u ɾ
تخم	t o x m
مرخ	m a ɾ x
سفید	s a f e d
منطقه	m i n t a q a
شلوار	ʃ a l v ɑː ɾ
میانجیگری	m i j ɑː n d͡ʒ i ɡ a ɾ iː
مالی	m ɑː l iː
خرامیدن	x e ɾ ɑː m iː d a n
پیاده	p i j ɑː d a
ابرش	a b ɾ a ʃ
خوشبخت	x o ʃ b a x t
قاقم	ɢ ɑː ɢ o m
بحران	b o h ɾ ɑː n
خسروانی	x o s ɾ a v ɑː n iː
قدر	q a d a ɾ
رعد	ɾ a ʔ d
چشمان	t ʃʰ e ʃ m ɑː
شستن	ʃ o s t a n
سالار	s ɑː l ɑː ɾ
روادید	r a v ɑː d̪ iː d̪
بردن	b o ɾ d a n
فائده	f ɑː ʔ e d e
مطلب	m a t l a b
حرف	h a ɾ f
چوکی	t ʃ a w k iː
زهر	z a h ɾ
دودل	d o d e l
دیشب	d i ʃ a b
بهشت	b e h e ʃ t
دانشجو	d ɑː n i ʃ d͡ʒ uː j
حقوق	h o q u q
امتحان	e m t e h ɑː n
رعنا	ɾ a ʔ n ɑː
پرتو	p a ɾ t a v
دنب	d o n b
شهلا	ʃ a h l ɑː
نوین	n a v i n
لیمو	l i m u
ژغار	ʒ a ɣ ɑː ɾ
حتی	h a t t ɑː
شکستنی	ʃ i k a s t̪ a n iː
در	d a ɾ
تاریخ	t ɑː ɾ iː x
سیلاب	s a j l ɑː b
صندوق	s a n d u q
باریک‌ترین	b ɑː ɾ iː k t a ɾ iː n
نکاح	n e k ɑː h
کودکان	k uː d a k ɑː n
کارواژگان	k ɑː r v ɑː ʒ e ɡ ɑː n
عروس	ʔ a ɾ u s
شوره	ʃ oː ɾ e
افرنگ	a f ɾ a n ɡ
گاب	ɡ ɑː b
تقدیر	t a q d i ɾ
ضعیف	z a ʔ i f
رقص	ɾ a q s
نکونام	n e k uː n ɑː m
غارت	ɢ ɑː ɾ a t
بلگ	b a l ɡ
درزی	d a ɾ z iː
خاده	x ɑː d a
والا	v a e l l ɑː
پیروزی	p e ɾ ɵː z iː
خاموش	x ɑː m oː ʃ
دگرجنس‌گرا	d e ɡ a ɾ d͡ʒ e n s ɡ a ɾ ɑː
شترمرغ	ʃ o t o ɾ m o ɾ ɢ
تکواژ	t a k v â ʒ
سمت	s a m t
نشور	n o ʃ uː ɾ
دادن	d ɑː d a n
سالم	s ɑː l i m
افغانی	a f ɣ ɑː n iː
پرگار	p a ɾ ɡ ɑː ɾ
افلاطون	a f l ɑː t uː n
آرامگاه	ɑː ɾ ɑː m ɡ ɑː h
مو	m o
شلغم	ʃ a l ɣ a m
خیم	x iː m
نمودار	n e m u d ɑː ɾ
وسیع	v a s e ʔ
مهربان	m e h ɾ a b ɑː n
نواختر	n a v a x t a ɾ
ادویه	a d v i j a
آگاه	ɑː ɡ ɑː h
کمند	k a m a n d
بیکار	b e k ɑː ɾ
خامه	x ɑː m a
دلبستگی	d e l b a s t e ɡ iː
ممنون	m a m n u n
نجس	n a d ʒ e s
رد	ɾ a d d
دلفین	d o l f iː n
اسلامی	e s l ɑː m iː
جرم	d͡ʒ e ɾ m
چل	t ʃʰ e l
تاریک‌ترین	t ɑː ɾ iː k t a ɾ iː n
ویه	uː j e
شطرنج‌باز	ʃ a t ɾ a n d͡ʒ b ɑː z
لوله	l uː l e
خطا	x a t ɑː
میان	m i j ɑː n
جهانگیر	d͡ʒ a h ɑː n ɡ iː ɾ
خاص‌ترین	x ɑː s tʰ a ɾ iː n
انزروت	a n z a ɾ u t
نانوشته	n ɑː n i w i ʃ t a
ابوبکر	a b u b a k ɾ
هرگز	h a ɾ ɡ i z
نیست	n e s t
نمک	n e m e k
نتیجه	n a t i d͡ʒ a
اتحاد	e t t e h ɑː d
شماره	ʃ o m ɑː ɾ e
اسپست	a s p i s t
محسن	m o h s e n
سنگ	s a ŋ ɡ
اژدها	a ʒ d a h ɑː
قدمت	q i d m a t
کین	k iː n
خیابان	x i j ɑː b ɑː n
ترش	t o ɾ ʃ
بیان	b a j ɑː n
نارنج	n ɑː ɾ a n d͡ʒ
چیش	t ʃ i ʃ
اندیشیدن	a n d e ʃ i d a n
زوال	z a v ɑː l
شورا	ʃ o ʊ̯ ɾ ɑː
آسانی	ɑː s ɑː n iː
زلیخا	z o l e j x ɑː
اصفهان	e s f a h ɑː n
نهج	n a h a d͡ʒ
محمدقلی	m o h a m m a d ɢ o l iː
نازک	n ɑː z u k
دوش	d oː ʃ
چیست	t͡ʃ i s t
مدرسه	m a d ɾ a s a
برگ	b a ɾ ɡ
تقویت	t a q v i j a t
خاتون	x ɑː t uː n
اقلا	a q a l l a n
مسعود	m a s ʔ uː d
اتراق	o t ɾ ɑː ɢ
خراسانی	x o ɾ ɑː s ɑː n iː
ماساژ	m ɑː s ɑː ʒ
فریب	f a ɾ e b
درباره	d a ɾ b ɑː ɾ a j i
آلمان	ɑː l m ɑː n
ابتدا	e b t e d ɑː
هخامنش	h a x ɑː m a n i ʃ
متوجه	m o t a v a d d͡ʒ e h
شفقت	ʃ a f a q a t
مثل	m a s a l
خیس	x iː s
کارزار	k ɑː ɾ z ɑː ɾ
دریا	d a ɾ j ɑː
فن	f a n
بلا	b e l ɑː
صفحه	s a f h a
اثر	a s a ɾ
غور	ɢ o w ɾ
فحش	f o h ʃ
گاومیش	ɡ ɑː w m eː ʃ
فاس	f ɑː s
ناقص	n ɑː q i s
طرفدار	t a ɾ a f d ɑː ɾ
دریدن	d a ɾ i d a n
چنین	t ʃ o n iː n
مدت	m o d d a t
نوروزی	n a v ɾ ɵː z iː
کمانچه	k a m ɑː n t͡ʃ a
آرزو	ɑː ɾ i z uː
سر	s a ɾ
تشکر	t a ʃ a k k u ɾ
کون	kʰ u n
راهب	ɾ ɑː h i b
چپ	t ʃ a p
کنشگر	k o n e ʃ ɡ a ɾ
پالایشگاه	p ɑː l ɑː j i ʃ ɡ ɑː h
نیروگاه	n i ɾ u ɡ ɑː h
ابلیس	e b l iː s
سمند	s a m a n d
مطبوعات	m a t b u ʔ ɑː t
مینو	m i n ɵː
اسفناج	e s f e n ɑː d͡ʒ
معدنی	m a ʔ d a n iː
سرباز	s a ɾ b ɑː z
شکایت	ʃ e k ɑː j a t
خوشاب	x u ʃ ɑː b
اسطوره	o s t uː ɾ e
حاد	h ɑː d
راحت	ɾ ɑː h a t
تسو	t a s u
غرق	ɣ a ɾ ɣ
عام‌المنفعه	ʔ ɑː m o l m a n f a ʔ e
ملیت	m e l l i j a t
طبق	t a b a q
فاصله	f ɑː s i l a
بلوط	b a l u t
معراج	m e ʔ ɾ ɑː d͡ʒ
سخن	s o x a n
وشم	v a ʃ m
عجب	ʔ a d͡ʒ a b
ویستا	v i s t ɑ
دارم	d ɑː ɾ a m
اکثر	a k s a ɾ
خندق	x a n d a q
کرامت	k a ɾ ɑː m a t
تیرداد	t i ɾ d ɑː d
آرایش	ɑː ɾ ɑː j i ʃ
شدید	ʃ a d i d
قدیمی	q a d i m iː
فارسی	f ɑː ɾ s iː
مانند	m ɑː n a n d i
ارغوانی	a ɾ ɣ a v ɑː n iː
کمتر	k a m t a ɾ
جور	d͡ʒ u ɾ
رحیم	r a h iː m
ناپسند	n ɑː p a s a n d
امین	a m iː n
مشهور	m a ʃ h u ɾ
سوختن	s oː x t a n
انتحار	e n t e h ɑː ɾ
ما	m ɑː
خواستن	x ɑː s t a n
عیب	a j b
کنشت	k e n e ʃ t
تکور	t a k v o ɾ
چقدر	t͡ʃ e ɢ a d a ɾ
کنکور	k o ŋ k uː r
اً	t a n v i n
خوانش	x ɑː n e ʃ
نر	n a ɾ
ندارد	n a d ɑː ɾ a d
قرار	q a ɾ ɑː ɾ
ژکفر	ʒ a k f a ɾ
ارزیدن	a ɾ z i d a n
روشن	ɾ a v ʃ a n
دل	d e l
چایخانه	t͡ʃ ɑː j x ɑː n a
قالب	q ɑː l i b
نزدیک‌تر	n a z d iː k t a ɾ
خرم	x o ɾː a m
نهادن	n i h ɑː d a n
آمد	ɑː m a d
پریستان	p a ɾ i j i s t ɑː n
کیهانی	k a j h ɑː n iː
نشان	n e ʃ ɑː n
نهور	n o h uː ɾ
حکم	h o k m
مشق	m a ʃ ɢ
خزان	x a z ɑː n
قوت	q u v v a t
نفر	n a f a ɾ
فصیح	f a s e h
دعا	d o ʔ ɑː
سیلابی	s a j l ɑː b eː
پیر	p i j a ɾ
چریک	t͡ʃ a ɾ i k
غذا	ɢ e z ɑː
معالجه	m o ʔ ɑː l e d͡ʒ e
خطر	x a t a ɾ
لله	l a l a
اسلیمی	e s l iː m iː
حاشیه	h ɑː ʃ i j a
شاهانه	ʃ ɑː h ɑː n a
چلوکباب	t͡ʃ e l o w k a b ɑː b
آزمودن	ɑː z m uː d a n
نقاشی	n a q q ɑː ʃ iː
عباسی	ʔ a b b ɑː s iː
آستانه‌ای	ɑː s t ɑː n a iː
زمستان	z e m e s t ɑː n
درخواست	d a ɾ x ɑː s t
خونین	x u n i n
کیهان	k a j h ɑː n
لی	l iː
ارمنستان	a ɾ m a n i s t ɑː n
سیاره‌ها	s a j ɑː ɾ e h ɑː
آباد	ɑː b ɑː d
وام	v ɑː m
شاهان	ʃ ɑː h ɑː n
جواب‌ها	d ʒ a v ɑː b h ɑː
توپ	t oː p
کفگیر	k a f ɡ i ɾ
جریان	d͡ʒ a ɾ a j ɑː n
المزده	a l a m z a d e
کابل	k ɑː b u l
بون	b uː n
رایگان	ɾ ɑː j i ɡ ɑː n
تعارف	t a ʔ ɑː ɾ u f
امضاء	e m z ɑː
عجان	ʔ e d ʒ ɑː n
باقلوا	b ɑː q l a w ɑː
خدمت	x e d m a t
امت	o m m a t
کهکشان	k a h k a ʃ ɑː n
شاهدخت	ʃ ɑː h d u x t
اصل	a s l
پیغامبر	p a j ɣ ɑː m b a ɾ
دستاویز	d a s t ɑː w eː z
غیر	ɢ e j ɾ
خواننده	x ɑː n a n d a
ژرفا	ʒ a ɾ f ɑː
تمیزتر	t a m iː z t a ɾ
انگیختن	a ŋ ɡ iː x t a n
اسپریس	ʔ e s p a ɾ eː s
دفاع	d e f ɑː ʔ
جمعیت	d͡ʒ a m ʔ i j j a t
دیو	d e v
سرنشین	s a ɾ n i ʃ i n
آسایش	ɑː s ɑː j i ʃ
کر	k a ɾ
زوجیت	z a v d͡ʒ i j a t
قلاووز	q u l ɑː w uː z
ناتمام	n ɑː t a m ɑː m
مخصوص	m a x s u s
ضمیر	z a m i ɾ
سکه	s e kː e
زمین	z a m i n
مجلس	m a d͡ʒ l i s
پیشوا	p e ʃ v ɑ
بوسه	b oː s a
دهیار	d e h j ɑː ɾ
دگر	d e ɡ a ɾ
زندانی	z e n d ɑː n iː
مجموعه	m a d͡ʒ m u ʔ a
ممکن	m o m k e n
آمیتیست	ɑː m iː t iː s t
نمایان	n e m ɑː j ɑː n
ژیرش	ʒ i ɾ i ʃ
تکوک	t a k oː k
حمایت	h e m ɑː j a t
سقف	s a q f
زنبور	z a m b u ɾ
معلوم	m a ʔ l u m
مله	m a l a
سلماس	s a l m ɑː s
ارسطو	a ɾ a s t u
خارج	x ɑː ɾ i d͡ʒ
لوترا	l u t a ɾ ɑː
تمبر	t a m b ɾ
روسیه	ɾ u s i j a
ناشنوا	n ɑː ʃ i n a w ɑː
کیر	k e ɾ
میزان	m i z ɑ n
اثبات	e s b ɑː t
خارجی	x ɑː ɾ i d͡ʒ iː
دانش	d ɑː n i ʃ
ذره	z a r r a
شمع	ʃ a m ʔ
فروختن	f o ɾ uː x t a n
کارخانه	k ɑː ɾ x ɑː n a
ستون	s ʊ t uː n
رندیدن	ɾ a n d i d a n
پش	p a ʃ
سوداگر	s a v d ɑː ɡ a ɾ
واقعا	v ɑː ɣ e ʔ a n
بخش	b a x ʃ
خوابیدن	x ɑː b iː d a n
بارش	b ɑː ɾ i ʃ
شنبلیله	ʃ a m b a l iː l e
اعتماد	e ʔ t e m ɑː d
توصیه	t a v s i j a
لازم	l ɑː z i m
اخبار	a x b ɑː ɾ
خایه	x â j a
حدادی	h a dː ɑː d iː
شکم	ʃ e k a m
نقطه	n o ɢ t e
آوازه	ɑː w ɑː z a
بلور	b ɪ l oː ɾ
جمهوری	d͡ʒ o m h uː ɾ iː
آرپا	ɑː ɾ p ɑː
ونوس	v e n uː s
نغمه	n a ɣ m a
زحمت	z a h m a t
بیخودی	b i x u d iː
هنوز	h a n oː z
ناز	n ɑː z
قونیه	q u n i j a
کارورزی	k ɑː ɾ v a ɾ z iː
فاعل	f ɑː ʔ i l
داوود	d ɑː v uː d
پشت	p o ʃ t e
جاهل	d͡ʒ ɑː h i l
عصبانی	a s a b ɑː n iː
مایه	m ɑː j a
مصدر	m a s d a ɾ
استادانه	ʔ o s tʰ ɑː d̪ ɑː n e
چکش	t͡ʃ a k u ʃ
حسن	h a s a n
بوییدن	b uː j iː d a n
تمیزترین	t a m iː z t a ɾ iː n
گاه	ɡ ɑː h
جزدان	d͡ʒ o z d ɑː n
دوزخ	d oː z a x
نیزه	n e i̯ z e
زئوس	z e uː s
سیاه‌گوش	s i j ɑː h ɡ oː ʃ
سقوط	s o ɢ uː t
کاکوتی	k ɑː k uː t iː
اغلب	a ɣ l a b
منظومه	m a n z u m a
وزن	v a z n
تور	t o w a ɾ
آزمایشگاه	ɑː z m ɑː j i ʃ ɡ ɑː h
مردان	m a ɾ d ɑː n
سیستم	s iː s tʰ e m
صابون	s ɑː b uː n
خوک	x uː k
مبهم	m o b h a m
قلعه	q a l ʔ a
اصیل	a s i l
سیلو	s i l u
دول	d oː l
دست‌نماز	d a s t n a m ɑː z
کندن	k a n d a n
چوب	t͡ʃ oː b
حادثه	h ɑː d i s a
دیم	d e m
روح	ɾ uː h
قیصر	q a j s a ɾ
بی‌میل	b e m a j l
عدس	ʔ a d a s
جنوب	d͡ʒ a n u b
باستان‌شناس	b ɑː s t ɑː n ʃ i n ɑː s
پیش	p e ʃ
شانزده	ʃ uː n z d a h
ضربان	z a ɾ a b ɑː n
عطر	ʔ e t ɾ
نام	n ɑː m
هفته	a f t a
فانی	f ɑː n iː
معروف	m a ʔ ɾ u f
نور	n u ɾ
فضاپیما	f a z ɑː p a j m ɑː
دماغ	d a m ɑː ɣ
طور	t a v ɾ
پشمین	p a ʃ m iː n
مثال	m e s ɑː l
همبازی	h a m b ɑː z iː
خزیدن	x a z i d a n
بوی	b oː j
سردار	s a ɾ d ɑː ɾ
کشیدن	k a ʃ i d a n
خبر	x a b a ɾ
آهنگ	ɑː h a n ɡ
فعلا	f e ʔ l a n
زبان	z a b ɑː n
مسخره	m a s x a ɾ a
هل	h e l
صیغه	s iː ɣ a
برهنه	b a ɾ a h n a
محل	m a h a l l
لوخن	l oː x a n
سید	s a j j i d
بدرود	b e d ɾ uː d
علاءالدین	a l ɑː ʔ u d d ī n
شیراز	ʃ e ɾ ɑː z
شگفت	ʃ e ɡ e f t
شک	ʃ ɑː k k
جفت	d͡ʒ o f t
تباه	t a b ɑː h
نوروز	n a v ɾ ɵː z
ماک	m ɑː k
کرفس	k a ɾ a f s
برگزیدن	b a ɾ ɡ u z i d a n
چاشت	t ʃʰ ɑː ʃ tʰ
اقرار	e ɢ ɾ ɑː ɾ
ترساندن	t a ɾ s ɑː n d a n
دیر	d a j ɾ
فصل	f a s l
کاریز	k ɑː ɾ eː z
ته	t a h
خوارزم	x ɑː ɾ a z m
اقلیت	a q a l l i j a t
ارغنون	a ɾ ɣ a n uː n
شترغار	ʃ o t o ɾ ɢ ɑː ɾ
خوشحال	x o ʃ h ɑː l
پاکستان	p ɑː k i s t ɑː n
آشوب‌ها	ɑː ʃ uː b h ɑː
چله	t ʃʰ e l e
بد	b a d
سگالیدن	s e ɡ ɑː l iː d a n
کره	k a ɾ a
مشاور	m o ʃ ɑː v e ɾ
بام	b ɑː m
جودر	d͡ʒ a v d a ɾ
آسمان	ɑː s i m ɑː n
جعفری	d͡ʒ a ʔ f a ɾ iː
کالب	k ɑː l e b
ترسیدن	t a ɾ s i d a n
نستعلیق	n a s t a ʔ l i q
سمفونی	s a m f oː n iː
جوان	d͡ʒ a v ɑː n
دردناک	d a ɾ d n ɑː k
خرید	h a ɾ i d
بابا	b ɑː b ɑː
هجران	h i d͡ʒ ɾ ɑː n
نزد	n a z d
بشقاب	b o ʃ ɢ ɑː b
اتحادیه	e t t e h ɑː d iː j e
مازریون	m ɑː z a ɾ j oː n
سهمگین	s a h m ɡ i n
تقریبا	t a ɣ ɾ iː b a n
ایوب	a j j u b
مراقب	m o ɾ ɑː ɢ e b
جنگ	d͡ʒ a ŋ ɡ
کونی	k u n iː
چمن	t͡ʃ a m a n
ره	r a h
هشت	h a ʃ t
زیست‌شناسی	z iː s t ʃ e n ɑː s iː
نذل	n a z l
ملاقات	m o l ɑː ɢ ɑː t
هزینه	h a z e n a
منشار	m e n ʃ ɑː ɾ
کنفرانس	k o n f e ɾ ɑː n s
شیدا	ʃ e j d ɑː
بلبل	b o l b o l
عربستان	a ɾ a b i s t ɑː n
افیون	ʔ a f j uː n
ادغام	e d ɢ ɑː m
شهرزاد	ʃ a h ɾ z ɑː d
غیرت	ɢ e j ɾ a t
ماوراءالنهر	m ɑː w a ɾ ɑː ʔ u n n a h ɾ
صرع	s a ɾ ʔ
راسته	ɾ ɑː s t a
ژاپن	ʒ ɑː p u n
نالون	n ɑː l uː n
بیمار	b e m ɑː ɾ
بی‌سیم	b e s i m
فضا	f a z ɑː
مرحله	m a ɾ h a l a
ذهن	z e h n
آبلیمو	ɑː b l iː m uː
شاگرد	ʃ ɑː ɡ i ɾ d̪
ابتکار	e b t e k ɑː ɾ
رژیمان	ɾ e ʒ i m ɑ n
خردل	x a ɾ d a l
فشنگ	f e ʃ a n ɡ
مصون	m a s uː n
چون	t͡ʃ oː n
شترخار	ʃ o t o ɾ x ɑː ɾ
ماهر	m ɑː h i ɾ
زوبین	z oː b iː n
عشق	e ʃ ɢ
پناهگاه	p a n ɑː h ɡ ɑː h
خبره	x e b ɾ e
خونریزی	x u n ɾ e z iː
قلبی	q a l b iː
مقاومت	m o ɢ ɑː v e m a t
شور	ʃ oː ɾ
آشپزخانه	ɑː ʃ p a z x ɑː n a
طبقه	t a b a q a
فرودگاه	f o ɾ uː d ɡ ɑː h
اهورامزدا	a h u ɾ ɑː m a z d ɑː
مرغاب	m o ɾ ɢ ɑː b
اذان	a z ɑː n
سلجوقی	s a l d͡ʒ u q iː
شنفتن	ʃ e n o f t a n
هرزگی	h a ɾ z a ɡ iː
اشتر	ʔ o ʃ t o ɾ
پری	p a ɾ iː
بوته	b oː t a
مازندرانی	m ɑː z a n d a ɾ ɑː n iː
ستان	e s t ɑː n
جبهه	d͡ʒ e b h e
حاجت	h ɑː d͡ʒ a t
افتادن	o f t ɑː d a n
پوپک	p oː p a k
کنونی	k o n uː n iː
مجازات‌ها	m o d ʒ ɑː z ɑː t h ɑː
ساعت	s ɑː ʔ a t
شکست	ʃ e k a s t
هفت	h a f t
صرف	s e ɾ f
لهستان	l a h i s t ɑː n
پرشور	p o ɾ ʃ uː ɾ
وکالت	v e k ɑː l a t
خشونت	x o ʃ uː n a t
مازو	m ɑː z uː
سازش	s ɑː z i ʃ
بیمناک	b i n m ɑː k
پارسه	p ɑː ɾ s e
زغال	z o ɢ ɑː l
سیاح	s a j j ɑː h
ننه	n a n e
قاضی	q ɑː z iː
گذراندن	ɡ o z a ɾ ɑː n d a n
چاق	t͡ʃ ɑː q
نشلیدن	n e ʃ e l iː d a n
کبریت	kʰ e b ɾ iː t
سلاح	s e l ɑː h
دراز	d a ɾ ɑː z
ظهر	z o h ɾ
انعکاس	e n ʔ e k ɑː s
خداحافظ	x o d ɑː h ɑː f e z
کشتگی	k o ʃ t a ɡ iː
اسلام‌گرا	e s l ɑː m ɡ a ɾ ɑː
گران	ɡ a ɾ ɑː n
قفس	q a f a s
حافظ	h ɑː f e z
گاو	ɡ o ʊ
حق	h a q q
مادیان	m ɑː d i i̯ ɑː n
لیو	l e v
انکار	e n k ɑː ɾ
ایرانشهر	e ɾ ɑː n ʃ a h ɾ
نار	n ɑː ɾ
فراصوت	f a ɾ ɑː s a w t
کلنگ	k o l o ŋ ɡ
رختن	r e x t a n
با	b ɑː
نگار	n e ɡ ɑː ɾ
پیشوند	p e ʃ v a n d
قرعه‌کشی	q u ɾ ʔ a k a ʃ iː
ابراهیم	e b ɾ ɑː h iː m
آخر	ɑː x a ɾ
تقویم	t a q v i m
سعید	s a ʔ i d
بی‌ستاره	b e s i t ɑː ɾ a
مهاجر	m o h ɑː d͡ʒ e ɾ
سینا	s iː n ɑː
رضا	ɾ e z ɑː
فصح	f e s h
ابد	a b a d
اشرج	a ʃ r a d ʒ
قهرمان	q a h ɾ a m ɑː n
منشی	m u n ʃ iː
خنجر	x a n d͡ʒ a ɾ
چی	t͡ʃ e
کبود	k a b oː d
سرهنگ	s a ɾ h a n ɡ
مسافرت	m o s ɑː f e ɾ a t
خوان	x ɑː n
سرندیپ	s a r a n d iː p
انگاشتن	a n ɡ ɑː ʃ t a n
خواهش	x ɑː h e ʃ
برهمن	b a ɾ a h m a n
جواری	d͡ʒ o v ɑː ɾ iː
شهوت	ʃ a h v a t
گاهی	ɡ ɑː h iː
نریمان	n a ɾ eː m ɑː n
قطع	q a t ʔ
بامزه‌تر	b ɑː m a z e t a ɾ
مومیا	m oː m i j ɑː
داد	d ɑː d
بز	b o z
کنار	k a n ɑː ɾ
اشترغار	o ʃ t o ɾ ɢ ɑː ɾ
ماهواره	m ɑː h w ɑː ɾ a
پیشنهاد	p e ʃ n i h ɑː d
حقیقت	h a q i q a t
پریدن	p a ɾ i d a n
اگرچه	a ɡ a ɾ t ʃ e
فروهر	f o ɾ uː h a ɾ
نیک	n e k
شوریدن	ʃ oː ɾ iː d a n
بایستن	b ɑː j i s t a n
اشتباه	e ʃ t e b ɑː h
دیروز	d i ɾ ɵː z
قاموس	q ɑː m uː s
تمام	t a m ɑː m
واج	v ɑː d͡ʒ
بازار	b ɑː z ɑː ɾ
پیوسیدن	p a j oː s iː d a n
روزها	ɾ oː z h ɑː
فرمایش	f a ɾ m ɑː j i ʃ
افغان	a f ɣ ɑː n
ریگستان	ɾ e ɡ i s t ɑː n
خالق	x ɑː l i q
احمق	a h m a q
بعد	b a ʔ d
خریدن	x a ɾ i d a n
قبول	q a b u l
ویر	v i ɾ
رباعی	ɾ o b ɑː ʔ iː
میرزا	m e ɾ z ɑː
ماموت	m ɑː m uː t
صهیونی	s a h j u n iː
خسیس	x a s i s
شعر	ʃ e ʔ ɾ
سپاهی	s e p ɑː h iː
شیرین‌ترین	ʃ iː ɾ iː n t a ɾ iː n
سفره	s o f ɾ e
مرتبه	m a ɾ t a b a
فهرست	f e h ɾ e s t
لک	l a k
شاهقلی	ʃ ɑː h q u l iː
چوپ	t͡ʃ oː p
ژاندرم	ʒ ɑː n d a r m
وارث	v ɑː ɾ e s
آفتاب	ɑː f t ɑː b
هنر	h o n a ɾ
سخت	s a x t
مهره	m o h ɾ e
خرس	x e ɾ s
کوزه	k u z a
دو	d o
فرانسوی	f a ɾ ɑː n s a w iː
قاشق	q ɑː ʃ u q
پدرام	p a d ɾ ɑː m
دانشکده	d ɑː n i ʃ k a d a
کاغد	k ɑː ɣ a d
بین	b a j n
شبح	ʃ a b a h
سرای	s a ɾ ɑː j
طرف	t a ɾ a f
پنجره	p a n d͡ʒ a ɾ a
آموزگار	ɑː m oː z ɡ ɑː ɾ
شمعدان	ʃ a m ʔ d ɑː n
شمردن	ʃ e m o ɾ d a n
طول	t u l
هجده	h a d͡ʒ d a h
سفیر	s a f i ɾ
آیا	ɑː j ɑː
آمیختن	ɑː m eː x t a n
قطر	q a t a ɾ
کم‌مایه	k a m m ɑː j a
ادامه	e d ɑː m e
شدن	ʃ o d a n
خواجه	x ɑː d͡ʒ a
شاهزاده	ʃ ɑː h z ɑː d a
مدیر	m o d iː ɾ
ندا	n e d ɑː
چاه‌کور	t͡ʃ ɑː h k a w ɾ
ثروتمند	s a ɾ v a t m a n d
میز	m e z
لاف	l ɑː f
بختیار	b a x t i j ɑː ɾ
لشکر	l a ʃ k a ɾ
رشت	r o ʃ t
دوغ	d oː ɣ
بی‌وقفه	b e v a q f a
سخنرانی	s o x a n ɾ ɑː n iː
انجام	a n d͡ʒ ɑː m
سوسن	s oː s a n
کفتر	k e f t a ɾ
مین	m iː n
نخیر	n a x a j ɾ
خوابگاه	x ɑː b ɡ ɑː h
فاک	f ɑː k
هوشیار	h oː ʃ j ɑː ɾ
دیدگاه	d i d ɡ ɑː h
قرغیزستان	q ɪ ɾ ɣ iː z ɪ s t ɑː n
آدرس	ɑː d ɾ e s
کاسه	k ɑː s e
دفتر	d a f t a r
ناخواسته	n ɑː xʷ ɑː s t a
هوتن	h uː t a n
منفور	m a n f u ɾ
راستگو	ɾ ɑː s t ɡ uː
ژاپنی	ʒ ɑː p u n iː
تغییرات	t a ɣ j iː ɾ ɑː t
کماشیر	k a m ɑː ʃ eː ɾ
آسمانخراش	ɑː s m ɑː n x a ɾ ɑː ʃ
شایعه	ʃ ɑː j i ʔ a
عصمت	e s m a t
پاره	p ɑː ɾ a
پرویز	p a ɾ v iː z
دندان	d a n d ɑː n
مزنه	m o z n e
دهان	d a h ɑː n
نامور	n ɑː m w a ɾ
شب‌بوی	ʃ a b b oː j
آزمایش	ɑː z m ɑː j i ʃ
خر	x a ɾ
زوج	z a v d͡ʒ
جدول	d͡ʒ a d v a l
رستوران	r e s t o ɾ ɑː n
برس	b o ɾ s
وای	v ɑː j
زورق	z o w ɾ a q
حمله	h a m l a
سرگیجه	s a ɾ ɡ i d͡ʒ a
رخام	ɾ o x ɑː m
مردن	m o ɾ d a n
پیشگیر	p e ʃ ɡ i ɾ
دزد	d o z d
زندان	z e n d ɑː n
ویدیو	v iː d iː j o
بزاق	b o z ɑː ɣ
خون‌شناسی	x u n ʃ i n ɑː s iː
بندر	b a n d a ɾ
شیطانی	ʃ a j t ɑː n iː
کهکشان‌ها	k a h k a ʃ ɑː n h ɑː
مظهر	m a z h a ɾ
سوزش	s oː z i ʃ
واژگان	v ɑː ʒ e ɡ ɑː n
شاهین	ʃ ɑː h iː n
درفش	d a ɾ a f ʃ
مرند	m a ɾ a n d
می‌گم	m iː ɡ a m
دادگاه	d ɑː d ɡ ɑː h
وزیدن	v a z iː d a n
روند	ɾ a v a n d
آمار	ɑː m ɑː ɾ
شنگار	ʃ a n ɡ ɑː ɾ
ورد	v a ɾ d
بی‌معنی	b e m a ʔ n iː
کو	k oː
مرکب	m o ɾ a k k a b
خیر	x a j ɾ
قو	q u
امین‌ها	a m iː n h ɑː
خاندان	x ɑː n d ɑː n
خربوزه	x a ɾ b u z a
کاغذ	k ɑː ɣ a ð
فریبا	f a ɾ e b ɑː
لسان	l e s ɑː n
اطمینان	e t m iː n ɑː n
پاداش	pʰ ɑː d̪ ɑː ʃ
جامعه‌شناس	d͡ʒ ɑː m i ʔ a ʃ i n ɑː s
مستعمره	m o s t a ʔ m a ɾ e
ایستادن	i s t ɑː d a n
خزنده	x a z a n d e
طرح	t a ɾ h
قرنفل	q a ɾ a n f u l
ماهور	m ɑː h uː ɾ
زال	z ɑː l
انقلاب	e n ɢ e l ɑː b
ژنو	ʒ e n e v
نمکدان	n a m a k d ɑː n
قلیان	q a l j ɑː n
بی‌عرضه	b e u ɾ z a
شیک	ʃ iː k
کیمیا	k iː m i j ɑː
آبان	ɑː b ɑː n
هلو	h o l uː
سرانجام	s a ɾ a n d͡ʒ ɑː m
تمثیل	t a m s i l
وضعیت	v a z ʔ i j j a t
گائیدن	ɡ ɑː j iː d a n
فکر	f e k
خصومت	x o s uː m a t
بازیچه	b ɑː z iː t ʃʰ e
اریحا	a ɾ i h ɑː
بحریه	b a h ɾ i j a
پولدار	p u l d ɑː ɾ
رود	ɾ oː d
الحاق	e l h ɑː ɢ
باریک‌تر	b ɑː ɾ iː k t a ɾ
آلاله	ɑː l ɑː l a
تصمیم	t a s m i m
عنایت	ʔ e n ɑː j a t
خندون	x a n d uː n
جوره	d͡ʒ oː ɾ a
دلیل	d a l i l
درها	d a ɾ h ɑː
آغیل	ɑː ɣ iː l
بیرق	b a j ɾ a q
طاقت	t ɑː q a t
فرمودن	f a ɾ m u d a n
دادار	d ɑː d ɑː r
نوک	n v a k
خواه	x ɑː h
آرایشگاه	ɑː ɾ ɑː j i ʃ ɡ ɑː h
امروز	e m ɾ uː z
بیدار	b e d ɑː ɾ
آرژانتین	ɑː ɾ ʒ ɑː n t iː n
الماس	a l m ɑː s
ارتعاش	e ɾ t e ʔ ɑː ʃ
چرا	t ʃ a ɾ ɑː
کاروان	k ɑː ɾ w ɑː n
ملت	m e l l a t
تمساح	t e m s ɑː h
محیط	m o h iː t
زندگی	z e n d e ɡ iː
کثیف	k a s i f
واژه	v ɑː ʒ e
کافر	k ɑː f e r
موضوع	m a v z ɵː ʔ
نان	n ɑː n
به	b a
دیوان	d e v ɑː n
باژ	b ɑː ʒ
تعظیم	t a ʔ z i m
جنگجو	d͡ʒ a n ɡ d͡ʒ u
طلا	t e l ɑː
امکان	e m kʰ ɑː n
جنگل	d ʒ a n ɡ a l
کنگره	k o n ɡ r e
عادی	ʔ ɑː d iː
ترگمان	t a ɾ ɡ u m ɑː n
چرخیدن	t ʃ e ɾ x i d̪ a n
آغا	ɑː ɣ ɑː
چرخه	t͡ʃ a ɾ x a
اساتید	a s ɑː t iː d
ترسایی	t a ɾ s ɑː j iː
کرایه	k i ɾ ɑː j a
اصطبل	e s t a b l
بیمارستان	b e m ɑː ɾ i s t ɑː n
ایمان	i m ɑː n
ماله	m ɑː l a
لجن	l a d͡ʒ a n
غافث	ɢ ɑː f e s
پراکندگی	p a ɾ ɑː k a n d a ɡ iː
می‌دوم	m i d a v a m
اسلام	ʔ e s l ɑː m
خاطر	x ɑː t i ɾ
تشکیل	t a ʃ k i l
رخ	r o x
چرمه	t͡ʃ a ɾ m a
خەر	x aː ɾ
حرب	h a ɾ b
فراموش	f a ɾ ɑː m oː ʃ
آهار	ɑː h ɑː ɾ
ایدون	e d u n
رب	ɾ a bː
عنصر	o n s o ɾ
فاحش	f ɑː h e ʃ
لیوان	l iː v ɑː n
تغییر	t a ɣ j i ɾ
تصادف	t a s ɑː d u f
معادل	m o ʔ ɑː d e l
نسرین	n a s ɾ iː n
بر	b a ɾ
قزوین	q a z v i n
خوفناک	x a v f n ɑː k
پور	p u ɾ
اسفرزه	e s f a ɾ z e
سامانه	s ɑː m ɑː n a
سمع	s a m ʔ
پریشان	p a ɾ e ʃ ɑː n
وحی	v a h j
باره	b ɑː ɾ a
شهریور	ʃ a h ɾ iː v a ɾ
چندان	t͡ʃ a n d ɑː n
چاشنی	t ʃʰ ɑː ʃ n iː
آهسته	ɑː h i s t a
آفرینش	ɑː f a ɾ iː n i ʃ
تک	t a k
دهلی	d e h l iː
حلوا	h a l v ɑː
استان	o s t ɑː n
ویرایش	v i ɾ ɑː j i ʃ
پدیدار	p a d i d ɑː ɾ
خسته	x a s t a
نارسنگ	n ɑː ɾ s a n ɡ
شلوغ‌تر	ʃ o l uː ɣ t a ɾ
نمایش	n a m ɑː j i ʃ
سرین	s o ɾ iː n
ساختار	s ɑː x t ɑː ɾ
اجاق	o d͡ʒ ɑː ɢ
شاعر	ʃ ɑː ʔ i ɾ
فاخره	f ɑː x i ɾ a
فر	f o ɾ
سه	s e
تفریح	t a f ɾ e h
آویختن	ɑː w eː x t a n
ببر	b a b ɾ
ویژه	v e ʒ a
نسک	n a s k
حجاب	h e d͡ʒ ɑː b
خجالت	x e d͡ʒ ɑː l a t
باران	b ɑː ɾ ɑː n
استخدام	e s t e x d ɑː m
مجسمه	m o d͡ʒ a s s a m e
آلرژی	ɑː l i ɾ ʒ iː
ترشه	t o ɾ ʃ e
بی‌هوش	b e h ɵː ʃ
قیمتی	q a j m a t iː
نورانی	n u ɾ ɑː n iː
خان	x ɑː n
مسیح	m a s e h
مخرج	m a x ɾ a d͡ʒ
کشکول	k a ʃ k uː l
شال	ʃ ɑː l
جستجو	d͡ʒ o s t o d͡ʒ uː j
خاله	x ɑː l a
بخار	b o x ɑː ɾ
اشتراک	e ʃ t e ɾ ɑː k
مختلف	m o x t a l e f
دردمند	d a ɾ d m a n d
سن	s e n
او	oː
بسنده	b a s a n d e
افغانستان	a f ɣ ɑː n i s t ɑː n
قاصدک	q ɑː s i d a k
خف	x o f
چهل	t͡ʃ e h e l
خیار	x i j ɑː ɾ
آجیل	ɑː d͡ʒ iː l
هم	h a m
روزنامه	ɾ oː z n ɑː m a
زنجبیل	z a n d͡ʒ a b iː l
هم‌جنس‌گرا	h a m d͡ʒ i n s ɡ a ɾ ɑː
تمیز	t a m i z
استقبال	e s t e ɢ b ɑː l
معمار	m e ʔ m ɑː ɾ
آفت	ɑː f a t
بنیادگرا	b o n j ɑː d ɡ a ɾ ɑː
تزیین	t a z j i n
خاور	x ɑː w a ɾ
امسال	e m s ɑː l
سهراب	s o h ɾ ɑː b
زاوش	z ɑː w u ʃ
کلان	k a l ɑː n
جامعه‌شناسی	d͡ʒ ɑː m i ʔ a ʃ i n ɑː s iː
سلیمانی	s o l e j m ɑː n iː
گاش	ɡ ɑː ʃ
مرمی	m a r m iː
تنبور	t a n b u ɾ
خودنویس	x o d n e v iː s
چامه‌سرایی	t͡ʃ ɑː m a s a ɾ ɑː j iː
تلخ	t a l x
امشب	e m ʃ a b
فقیر	f a q i ɾ
کوتاه‌تر	k uː t ɑː h t a ɾ
لنگرگاه	l a n ɡ a ɾ ɡ ɑː h
توپچى	t oː p t͡ʃ iː
سرمه	s a ɾ m a
بارود	b ɑː ɾ uː d
پشه	p a ʃ e
لاله	l ɑː l e
اورشلیم	ʔ o ɾ ʃ a l iː m
تبدیل	t a b d i l
مشتق	m o ʃ t a ɢ
طلاق	t a l ɑː q
عراقچی	a ɾ ɑː q t͡ʃ iː
مامانی	m ɑː m ɑː n iː
طب	t e bː
شاید	ʃ ɑː j a d
سفر	s a f a ɾ
تهیه	t a h i j j a
همچنین	h a m t͡ʃ a n i n
مسافت	m a s ɑː f a t
قانونی	q ɑː n uː n iː
خوانندگان	x ɑː n a n d e ɡ ɑː n
نزدیک	n a z d i k
زور	z a v ɾ
اتم	a t o m
بفرمایید	b e f a ɾ m ɑː j iː d
چامه	t͡ʃ ɑː m a
جوراب	d ʒ oː ɾ ɑː b
سپندان	s e p a n d ɑː n
دیس	d e s
اتمام	e t m ɑː m
پوست‌شناسی	p oː s t ʃ i n ɑː s iː
ظاهر	z ɑː h i ɾ
فریدون	f e ɾ e i̯ d uː n
خفگی	x a f i ɡ iː
خزینه	x a z i n a
سوز	s oː z
برخی	b a r x iː
انزال	e n z ɑː l
دلگیری	d e l ɡ iː ɾ iː
بەت	b aː t
جبار	d ʒ a b ɑː ɾ
مریضی	m a ɾ iː z iː
نظر	n a z a ɾ
کنجکاو	k o n d͡ʒ k ɑː v
طاس	t ɑː s
معلم	m o ʔ a l l e m
لثه	l a s e
شات	ʃ ɑː t
منابع	m a n ɑː b i ʔ
باحال‌تر	b ɑː h ɑː l t a ɾ
توسی	t uː s iː
تیز	t e z
مفرط	m o f ɾ e t
گربه	ɡ o ɾ b e
خود	x o d
اهمیت	a h a m i j a t
تقریباً	t a q ɾ i b a n
همراه	h a m ɾ ɑː h
کیچه	kʰ iː t͡ʃʰ e
زوش	z u ʃ
وطن‌پرست	v a t a n p a ɾ a s t
آذربایجان	ɑː z a ɾ b ɑː j d͡ʒ ɑː n
رعایت	ɾ e ʔ ɑː j a t
بیضه	b a j z a
منیژه	m a n iː ʒ a
موسیقی‌شناسی	m u s i q i ʃ i n ɑː s iː
کینه	k iː n e
فانوس	f ɑː n uː s
خیریه	x a j ɾ i j j a
سریدن	s o ɾ iː d a n
مولانا	m o w l ɑː n ɑː
مازوج	m ɑː z uː d͡ʒ
مشارکت	m o ʃ ɑː ɾ e k a t
دربار	d a ɾ b ɑː ɾ
دجله	d e d͡ʒ l e
افشاندن	a f ʃ ɑː n d a n
بیگانه	b e ɡ ɑː n a
ادبیات	a d a b i j ɑː t
ویژگی‌ها	v iː ʒ e ɡ iː h ɑː
امام	e m ɑː m
مقدار	m e ɢ d ɑː ɾ
دنیوی	d o n j a v e
بوسیدن	b oː s iː d a n
حرفه	h e ɾ f e
بایست	b ɑː j e s t
عاصی	ʔ ɑː s iː
مسکه	m a s k a
کوه	k oː h
احساس	e h s ɑː s
مختلط	m o x t a l e t
سه‌شنبه	s e ʃ a n b e
ضخیم	z a x iː m
شلوغ‌ترین	ʃ o l uː ɣ t a ɾ iː n
موتر	m oː t a ɾ
جدید	d͡ʒ a d i d
شهر	ʃ a h ɾ
خوبانی	x u b ɑː n iː
مخالف	m o x ɑː l e f
اهریمن	ʔ a h ɾ iː m a n
غژب	ɢ o ʒ b
خندیدن	x a n d i d a n
مرتب	m o ɾ a t t a b
قشنگ	ɢ e ʃ a ŋ ɡ
شرک	ʃ e ɾ e k
شهری	ʃ a h ɾ iː
نارگیله	n ɑː ɾ ɡ iː l a
دیگر	d i ɡ a ɾ
مرکزی	m a ɾ k a z iː
برگشتن	b a ɾ ɡ a ʃ t a n
روشنگری	ɾ a v ʃ a n ɡ a ɾ iː
هزار	h a z ɑː ɾ
همسایه	h a m s ɑː j a
تقسیم	t a q s i m
بعید	b a ʔ i d
فیض	f a j z
میغ	m eː ɣ
رنگارنگ	ɾ a ŋ ɡ ɑː ɾ a ŋ ɡ
طعم	t a ʔ m
بتکده	b o t k a d e
ملکه	m a l i k a
شماریدن	ʃ o m ɑː ɾ iː d a n
بزرگ‌امید	b o z o ɾ ɡ ʔ o m iː d
سرد	s a ɾ d
مالیات	m ɑː l iː j ɑː t
هیچ	h e t͡ʃ
شبنم	ʃ a b n a m
انسان	e n s ɑː n
موافق	m o v ɑː f e ɣ
نوکر	n a w k a r
کفن	k a f a n
بخور	b o x uː ɾ
خارگیل	x ɑː ɾ ɡ iː l
استاد	o s t ɑː d
شانه	ʃ ɑː n a
جانور	d͡ʒ ɑː n w a ɾ
داروشناس	d ɑː ɾ uː ʃ i n ɑː s
زین	z i n
آموختن	ɑː m oː x t a n
کمو	k a m uː
جواب	d͡ʒ a v ɑː b
امامقلی	e m ɑː m ɢ o l iː
بال	b ɑː l
حاکم	h ɑː k i m
زیرک	z i ɾ a k
هشتن	h e ʃ t a n
بشکه	b o ʃ k e
مراکش	m a ɾ ɑː k i ʃ
فقرا	f o ɢ a ɾ ɑː
اندی	a n d eː
چه	t͡ʃ a
خروس	x o ɾ uː s
خوشنویسی	x o ʃ n e v iː s iː
ابر	a b a ɾ
بیمارتر	b iː m ɑː ɾ t a ɾ
وضع	v a z ʔ
اسپهسالار	ʔ e s p a h s ɑː l ɑː ɾ
پختن	p o x t a n
مربوط	m a ɾ b u t
مواظب	m o v ɑː z e b
محبوب	m a h b u b
قید	ɢ e j d
خصم	x a s m
اضافه	e z ɑː f e
مختار	m o x t ɑː ɾ
علاقه	a l ɑː q a
دستور	d a s t u ɾ
پذیرفتن	p a z i ɾ u f t a n
عادت	ʔ ɑː d a t
گراز	ɡ o ɾ ɑː z
مد	m o d
دست	d a s t
پاکستانی	p ɑː k i s t ɑː n iː
اهواز	a h w ɑː z
کالبد	k ɑː l b u d
مدهوش	m a d h u ʃ
صادق	s ɑː d i q
بخشش	b a x ʃ i ʃ
قمر	q a m a ɾ
حماس	h a m ɑː s
بی‌پروا	b e p a ɾ v ɑː
تحفه	t o h f e
جمشید	d͡ʒ a m ʃ e d
استقلال	e s t e ɢ l ɑː l
ابریشم	a b ɾ i ʃ a m
پاستا	p ɑː s t ɑː
کنسرت	k o n s e ɾ t
دربان	d a ɾ b ɑː n
تاریک‌تر	t ɑː ɾ iː k t a ɾ
خال	x ɑː l
خروشیدن	x o ɾ uː ʃ iː d a n
برای	b a ɾ ɑː j i
ذرت	z o rː a t
ماهی	m ɑː h iː
پررونق	p o ɾ ɾ o w n a ɢ
جسور	d͡ʒ a s u ɾ
درودن	d o ɾ uː d a n
مترجم	m o t a ɾ d͡ʒ e m
مغز	m a ɣ z
رم	ɾ a m
سمور	s a m oː ɾ
فهم	f a h m
خراسان	x o ɾ ɑː s ɑː n
جایزه	d͡ʒ ɑː j i z a
لیک	l iː k
برهنه‌گرا	b a ɾ a h n a ɡ a ɾ ɑː
مار	m ɑː ɾ
تصویب	t a s v i b
کفش	k a f ʃ
پرسش	p o ɾ s e ʃ
کرشن	k ɾ i ʃ n
تاجیکستان	t ɑː d͡ʒ iː k i s t ɑː n
بکارت	b a k ɑː ɾ a t
جام	d͡ʒ ɑː m
بهتر	b e h t a ɾ
فروردین	f a ɾ v a ɾ d̪ iː n
شاهکار	ʃ ɑː h k ɑː ɾ
شما	ʃ o m ɑː
مهربانی	m e h ɾ a b ɑː n iː
کسشعر	k o s e ʃ e ɾ
پیشمرگه	p e ʃ m a ɾ ɡ e
متخلف	m o t a x a l l e f
مورچه	m oː ɾ t͡ʃ a
طلایی	t a l ɑː j iː
خواهر	x ɑː h a ɾ
اشکال	a ʃ k ɑː l
مهرداد	m e h ɾ d ɑː d
بان	b ɑː n
ارض	a ɾ z
پنجشیر	p a n d͡ʒ ʃ e ɾ
انجمن	ʔ a n d͡ʒ o m a n
بامداد	b ɑː m d ɑː n
بهتان	b o h t u n
هیئت	h a j ʔ a t
کم	k a m
اصلی	a s l iː
دانستن	d uː n e s t a n
آتنا	ɑː t i n ɑː
تفلیس	t e f l iː s
ژم	ʒ a m
صنوبر	s a n a v b a ɾ
بعضی	b a ʔ z e
سوخ	s oː x
دیگ	d e ɡ
خوار	x ɑː ɾ
مک	m a k
مقصد	m a q s a d
افسانه	a f s ɑː n a
وصل	v a s l
زقاق	z o ɢ ɑː ɢ
پله	pʰ e l l e
اشتباهی	e ʃ t e b ɑː h iː
سینه	s i n a
تقوا	t a q v ɑː
معنوی	m a ʔ n a v iː
سبزی	s a b z iː
درویش	d a ɾ v e ʃ
آمدن	ɑː m a d a n
مشکل‌ترین	m o ʃ k e l t a ɾ iː n
سنان	s e n ɑː n
نشستن	n e ʃ a s t a n
از	a z
دارفلفل	d ɑː ɾ f i l f i l
لوز	l a v z
شوید	ʃ e v iː d
ترک	t a ɾ k
ران	ɾ ɑː n
هوش	h oː ʃ
غصه	ɢ o s s e
بانک	b ɑː n k
اتاق	o t ɑː ɢ
عباء	a b ɑː
سنگواره	s a n ɡ v ɑː ɾ a
متعلق	m o t a ʔ a l l e ɢ
مالک	m ɑː l i k
خریطه	x a ɾ i t a
باجی	b ɑː d ʒ iː
آن	ɑː n
سرنوشت	s a ɾ n a v i ʃ t
بگران	b a ɡ ɾ ɑː n
رأی	ɾ a ʔ j
آلت	ɑː l a t
چند	t͡ʃ a n d
آخ	ɑː χ
متحد	m o t t a h e d
احتیاج	e h t i j ɑː d͡ʒ
تازگی	t ɑː z a ɡ iː
پلخته	p a l a x t a
سالن	s ɑː l o n
پاریس	pʰ ɑː ɾ iː s
نفرین	n e f ɾ iː n
نقشه	n a q ʃ a
آشپز	ɑː ʃ p a z
سده	s a d a
بامزه‌ترین	b ɑː m a z e t a ɾ iː n
کرس	k e ɾ s
فوق‌العاده	f a w q o l ʔ ɑ d a
رخت	ɾ a x t
استیون	e s t iː v e n
رابطه	ɾ ɑː b i t a
بیشتر	b e ʃ t a ɾ
لندن	l a n d a n
خانه	x ɑː n a
قوم	q a v m
ملی	m e l l iː
نفرت	n a f ɾ a t
ابریق	e b ɾ iː ɢ
بابک	b ɑː b a k
خور	x o ɾ
بهار	b a h ɑː ɾ
شخصیت	ʃ a x s i j a t
سرخ	s o ɾ x
باید	b ɑː j a d
پیچ	p e t͡ʃ
روحانی	r o ʊ h ɑː n iː
عکس	a k s
چنگال	t͡ʃ a n ɡ ɑː l
قلاوز	q u l ɑː w u z
رابط	ɾ ɑː b i t
ارادت	e ɾ ɑː d a t
بودن	b u d a n
شباهت	ʃ a b ɑː h a t
چیدن	t͡ʃ i d a n
بهاری	b a h ɑː ɾ iː
دانشمند	d ɑː n i ʃ m a n d
عمر	o m a ɾ
تنبسه	t a n b a s a
صفحه‌کلید	s a f h a k a l i d
ریشه	ɾ e ʃ a
شیرین	ʃ i ɾ i n
مسیحی	m a s i h iː
تابستان	t ɑː b i s t ɑː n
برخوردار	b a ɾ x o ɾ d ɑː ɾ
تبریک	t a b ɾ i k
میوه	m e v a
بچه	b a t t͡ʃ a
زیست‌شناس	z iː s t ʃ e n ɑː s
سرپرستی	s a ɾ p a ɾ a s t iː
سیل	s a j l
ژولیدن	ʒ uː l iː d a n
قدرتمند	q u d ɾ a t m a n d
شیرین‌تر	ʃ iː ɾ iː n t a ɾ
مناسبت	m o n ɑː s e b a t
چهار	t͡ʃ a h ɑː ɾ
فیروزه	f i ɾ u z a
پشیمان	p a ʃ iː m ɑː n
نماینده	n a m ɑː j a n d e
ناتوان	n ɑː t a w ɑː n
بلعیدن	b a l ʔ iː d a n
قسطنطنیه	q u s t a n t a n i j a
مند	m a n d
خزندگان	x a z a n d e ɡ ɑː n
ارشد	a ɾ ʃ a d
قایق	ɢ ɑː j e ɣ
لزوماً	l o z uː m a n
کس	k a s
جذاب	d͡ʒ a z z ɑː b
تجربه	t a d͡ʒ ɾ i b a
کوچک‌ترین	k uː t ʃ e k t a ɾ iː n
سرو	s a ɾ v
میرزاخانی	m i ɾ z ɑː x ɑː n iː
مشابه	m o ʃ ɑː b e
خار	x ɑː ɾ
زیبا	z e b ɑː
صلح	s u l h
پرندوش	p a ɾ a n d oː ʃ
سنگسار	s a n ɡ s ɑː ɾ
نیرو	n e ɾ ɵː
عثمان	o s m ɑː n
اله	e l ɑː h
نارون	n ɑː ɾ w a n
عنوان	o n v ɑː n
نشاندن	n e ʃ ɑː n d a n
شهنشاه	ʃ a h a n ʃ ɑː h
سیبویه	s i b u j a
اتصال	e t t e s ɑː l
منفی	m a n f iː
رغبت	r a ɣ b a t
بی‌مغز	b e m a ɣ z
خدشه	x a d ʃ a
زورخانه	z oː ɾ x ɑː n a
کله	k a l l a
درست	d o ɾ o s
خیلی	x a j l e
قندوز	q o n d uː z
شاهزادگان	ʃ ɑː h z ɑː d e ɡ ɑː n
تکرار	t a k ɾ ɑː ɾ
تجربی	t a d ʒ ɾ o b iː
نسخه	n o s x e
ماجرا	m ɑː d͡ʒ a ɾ ɑː
ام	e m
کی	k a j
حلال	h a l ɑː l
موزه	m oː z a
چغندر	t͡ʃ o ɢ o n d a ɾ
سوریه	s uː ɾ i j e
خندان	x a n d ɑ n
مسلمون	m o s a l m uː n
معشوق	m a ʔ ʃ u q
بی‌طرف	b e t a ɾ a f
قلب	q a l b
عمو	a m u
انتقاد	e n t e ɢ ɑː d
کباب	k a b ɑː b
بیمه	b i m a
خدیو	x a d e v
داروساز	d ɑː ɾ uː s ɑː z
ایام	ʔ a j j ɑː m
خربزه	x a ɾ b u z a
ممنوع	m a m n uː ʔ
مهم	m o h e m m
نوع	n a v ʔ
کسی	k a s e
باژدار	b ɑː ʒ d ɑː ɾ
سرچشمه	s a ɾ t͡ʃ a ʃ m a
دیوانه	d e v ɑː n a
انگبین	a n ɡ a b i n
تخریب	t a x ɾ i b
بیمارترین	b iː m ɑː ɾ t a ɾ iː n
دروغ‌ها	d o ɾ uː ɣ h ɑː
بم	b ə m
انگشت	a n ɡ i ʃ t
معمولا	m a ʔ m u l a n
آراستن	ɑː ɾ ɑː s t a n
علت	e l l a t
جنون	d ʒ o n uː n
شوهر	ʃ a v h a ɾ
خبری	x a b a ɾ j a
دوره	d a v ɾ a
واژه‌ها	v ɑː ʒ e h ɑː
ملا	m o lː ɑː
فغفور	f a ɣ f uː ɾ
اقیانوس	o ɢ j ɑː n uː s
خاموشی	x ɑː m oː ʃ iː
خالی	x ɑː l iː
سند	s e n d
مشکل‌ها	m o ʃ k e l h ɑː
صنم	s a n a m
شاهنشاه	ʃ ɑː h a n ʃ ɑː h
غالب	ɢ ɑː l e b
دلگیر	d e l ɡ iː ɾ
منبع	m a n b a ʔ
عمیق	a m iː q
آوا	ɑː w ɑː
چم	t͡ʃ a m
حیات	h a j ɑː t
جامه‌دان	d͡ʒ ɑː m i d ɑː n
فوت	f a v t
اثاث	a s ɑː s
برابر	b a ɾ ɑː b a ɾ
زیره	z iː ɾ e
بلی	b a l e
هیچ‌وقت	eː t͡ʃ w a q t
گاه‌شماری	ɡ ɑː h ʃ u m ɑː ɾ iː
کوچک‌تر	k uː t ʃ e k t a ɾ
هواپیما	h a v ɑː p a j m ɑː
شکسته	ʃ e k a s t e
ترنج	t o ɾ o n d͡ʒ
جستن	d͡ʒ a s t a n
میدان	m a j d ɑː n
ویژگی	v i ʒ a ɡ iː
غایب	ɢ ɑː j e b
قشنگی	q a ʃ a n ɡ iː
ناو	n ɑː w
بی	b e
بردار	b a ɾ d ɑː ɾ
شجاع	ʃ o d͡ʒ ɑː ʔ
محکمه	m a h k a m a
سرمایه	s a ɾ m ɑː j a
ساحل	s ɑː h i l
مقعد	m a q ʔ a d
فراموشی	f a ɾ ɑː m oː ʃ iː
کوتاهی	k u t ɑː h iː
نوشیدن	n oː ʃ iː d a n
والله	v a l l ɑː h
ساختن	s ɑː x t a n
ان‌شاءالله	e n ʃ ɑː ʔ a l l ɑː h
بوزه	b oː z a
منازل	m a n ɑː z i l
بیرونی	b eː ɾ uː n iː
خوردن	x o ɾ d a n
بعدا	b a ʔ d a n
تب	t a b
حیوان	h a j v ɑː n
بلال	b a l ɑː l
نیاز	n i j ɑː z
پناهندگان	p a n ɑː h a n d e ɡ ɑː n
خنداندن	x a n d ɑː n d a n
قطره	q a t ɾ a
