necessitous	n ə s ɛ s ə t ə s
litterateur	l ɪ t ə ɹ ə t ʊ ɚ
orenda	o ʊ ɹ ɛ n d ə
bighead	b ɪ ɡ h ɛ d
sprite	s p ɹ a ɪ t
ferroconcrete	f ɛ ɹ o ʊ k ɑ n k ɹ i t
jacuzzi	d͡ʒ ə k u z i
a'n't	æ n t
ampere	æ m p ɪ ə r
risorius	ɹ ɪ s ɔ ɹ i ə s
pest	p ɛ s t
gaymer	ɡ e ɪ m ɚ
picador	p ɪ k ə d ɔː ɹ
straitjacketing	s t ɹ e ɪ t d͡ʒ æ k ɪ t ɪ ŋ
splooge	s p l uː d͡ʒ
theories	θ iː ə ɹ i z
diamagnetic	d a ɪ ə m æ ɡ n ɛ t ɪ k
dispenser	d ɪ s p ɛ n s ə
quetiapine	k w ɪ t a ɪ ə p i n
matitudinal	m æ t ə t j u d ə n l̩
transcribe	t r æ n s k ɹ a ɪ b
bull	b ʊ l
emir	ɛ m ɪ ə ɹ
graded	ɡ ɹ e ɪ d ɪ d
competence	k ɒ m p ə t ə n s
bloomed	b l uː m d
globus	ɡ l ə ʊ b ə s
sika	s iː k ə
groundbreaking	ɡ ɹ a ʊ n d b ɹ e ɪ k ɪ ŋ
alucard	æ l ə k ɑː ɹ d
lexicon	l ɛ k s ɪ k ɑ n
austin	ɔ s t ɪ n
tsunauchi	t s uː n ɑː uː t͡ʃ i
piezoelectricity	p i e ɪ z ə ʊ ɪ l ɛ k t r ɪ s ɪ t i
redden	ɹ ɛ d n̩
ethane	ɛ θ e ɪ n
undertook	ʌ n d ə ɹ t ʊ k
stilton	s t ɪ l t ə n
foulsome	f a ʊ l s ə m
strophe	s t r o ʊ f i
treyf	t ɹ e ɪ f
volvelle	v ɑ l v ɛ l
unionization	j uː n j ə n a ɪ z e ɪ ʃ ə n
jeepney	d͡ʒ iː p n i
solum	s o ʊ l ə m
ludomusicologist	l u d o ʊ m j u z ɪ k ɑ l ə d͡ʒ ɪ s t
tsushima	s uː ʃ iː m ə
question	k w ɛ s t j ə n
cheeped	t͡ʃ iː p t
blood	b l ʌ d
gimlet	ɡ ɪ m l ə t
mses	m ɪ z ə z
lavandin	l æ v ə n d ɪ n
stare	s t ɛ ɚ
utonian	j uː t o ʊ n i ə n
inventor	ɪ n v ɛ n t ɚ
lessen	l ɛ s ə n
crust	k ɹ ʌ s t
grossly	ɡ ɹ o ʊ s l i
prima	p ɹ iː m ə
debit	d ɛ b ɪ t
embale	ɪ m b e ɪ l
zoledronate	z o ʊ l ɛ d ɹ ə n e ɪ t
pleiades	p l a ɪ ə d i z
barometz	b æ ɹ ə m ɛ t s
this's	ð ɪ s ɪ z
hermitty	h ɜː ɹ m ɪ t i
miniature	m ɪ n i ə t͡ʃ ə ɹ
liraglutide	l ɪ ɹ æ ɡ l ʊ t a ɪ d
frontlet	f ɹ ʌ n t l ə t
squeteague	s k w iː t iː ɡ
copay	k o ʊ p e ɪ
hayward	h e ɪ w ə ɹ d
promises	p ɹ ɑ m ɪ s ɪ z
chute	ʃ j uː t
croggle	k ɹ ɒ ɡ ə l
semantics	s ɪ m æ n t ɪ k s
tac	t æ k
baccarat	b æ k ə ɹ ɑː
considerative	k ɑ n s ɪ d ə ɹ e ɪ t ɪ v
cabg	k æ b ɪ d͡ʒ
ion	a ɪ o ʊ n
docks	d ɒ k s
leady	l ɛ d i
advertiser	æ d v ɚ t a ɪ z ɚ
nasus	n e ɪ s ə s
pultaceous	p ʌ l t e ɪ ʃ ə s
deserve	d ɪ z ɝ v
routine	ɹ uː t iː n
bereft	b ə ɹ ɛ f t
canadiens	k ə n e ɪ d i ə n z
bins	b ɪ n z
blackguard	b l æ ɡ ɚ d
cannon	k æ n ə n
malm	m ɑː l m
pulls	p ʊ l z
formalist	f ɔ ɹ m l̩ ɪ s t
pentateuch	p ɛ n t ə t j uː k
upward	ʌ p w ɜː ɹ d
richness	ɹ ɪ t͡ʃ n ə s
squoze	s k w o ʊ z
dissemination	d ɪ s ɛ m ɪ n e ɪ ʃ ə n
prosiopetic	p ɹ ɑ s i o ʊ p ɛ t ɪ k
opal	o ʊ p ə l
loll	l ɑ l
throat	θ ɹ o ʊ t
dreaded	d ɹ ɛ d ə d
garden	ɡ ɑ ɹ d ə n
carnivorously	k ɑː ɹ n ɪ v ə ɹ ə s l i
lakh	l æ k
condescending	k ɑ n d ə s ɛ n d ɪ ŋ
catamaran	k æ t ə m ə ɹ æ n
booger	b ʊ ɡ ɚ
patrols	p ə t ɹ o ʊ l z
halfness	h æ f n ə s
breitschwanz	b ɹ a ɪ t͡ʃ v ɑː n t s
vility	v a ɪ l ɪ t i
amerind	æ m ə ɹ ɪ n d
bunyip	b ʌ n j ɪ p
flooding	f l ʌ d ɪ ŋ
ecumenopoleis	ɛ k j u m ɛ n ɒ p ɒ l ɛ ɪ z
cicatrise	s ɪ k ə t ɹ a ɪ z
ypsiliform	ɪ p s ɪ l ɪ f ɔː ɹ m
qataban	k ɑ t ə b ə n
whistle	w ɪ s l̩
matronymic	m æ t ɹ ə n ɪ m ɪ k
katharometer	k æ θ ə ɹ ɒ m i t ə ɹ
contraband	k ɑ n t ɹ ə b æ n d
temazepam	t ə m æ z ə p æ m
pubes	p j uː b i z
octane	ɒ k t e ɪ n
whimsy	w ɪ m z i
biscotto	b ɪ s k ɑ t o ʊ
roomth	ɹ uː m θ
sages	s e ɪ d͡ʒ ɪ z
hugely	h j uː d͡ʒ l i
haunt	h æ n t
soteriology	s ə ʊ t ɪ ə ɹ ɪ ɒ l ə d͡ʒ i
jink	d͡ʒ ɪ ŋ k
fran	f ɹ æ n
disgust	d ɪ s k ʌ s t
horrible	h ɒ ɹ ɪ b ə l
permeable	p ɜː ɹ m i ə b ə l
sexy	s ɛ k s i
omnivorous	ɑ m n ɪ v ɝ ə s
ragù	ɹ æ ɡ u
leman	l iː m ə n
daimyo	d a ɪ m j o ʊ
baconic	b ə k ə ʊ n ɪ k
claps	k l æ p s
argillaceous	ɑː d͡ʒ ɪ l e ɪ ʃ ə s
inman	ɪ n m ə n
mull	m ʌ l
trudeau	t ɹ uː d o ʊ
fob	f ɒ b
yep	j ɛ p
neolithic	n i o ʊ l ɪ θ ɪ k
metaphysics	m ɛ t ə f ɪ z ɪ k s
teller	t ɛ l ə ɹ
fink	f ɪ ŋ k
dickies	d ɪ k i z
despotat	d ɛ s p ə t æ t
ratio	ɹ e ɪ ʃ i o ʊ
sunbathe	s ʌ n b e ɪ ð
psora	s ɔː ɹ ə
flaneur	f l ɑ n ʊ ɚ
gerontic	d͡ʒ ɛ ɹ ɑː n t ɪ k
nunation	n ʌ n e ɪ ʃ n̩
prince	p ɹ ɪ n s
euro	j ɝ o ʊ
centred	s ɛ n t ə ɹ d
equalize	i k w ə l a ɪ z
gazelle	ɡ ə z ɛ l
thaxted	θ æ k s t ɪ d
nucleus	n uː k l i ə s
dilf	d ɪ l f
phub	f ʌ b
baidu	b a ɪ d uː
sclerotal	s k l ə ɹ ə ʊ t ə l
bookstave	b ʊ k s t ɪ v
overstudious	o ʊ v ɚ s t j uː d i ə s
youthenize	j uː θ ə n a ɪ z
pressed	p ɹ ɛ s t
redebug	ɹ iː d iː b ʌ ɡ
uric	j ʊ ɹ ɪ k
dace	d e ɪ s
superseminate	s uː p ə ɹ s ɛ m ɪ n e ɪ t
custard	k ʌ s t ɚ d
feiseanna	f ɛ ʃ ə n ə
teletsunami	t ɛ l ə t s u n ɑː m i
cognoscence	k ɒ ɡ n ə s ə n s
pushpin	p ʊ ʃ p ɪ n
chore	t͡ʃ ɔ ɹ
achieved	ə t͡ʃ iː v d
forbid	f ɚ b ɪ d
rerefief	ɹ ɪ ə ɹ f iː f
maguire	m ə ɡ w a ɪ ɹ
ebbed	ɛ b d
cuts	k ʌ t s
withhold	w ɪ ð h o ʊ l d
perfusionist	p ə ɹ f j uː ʒ ə n ɪ s t
goon	ɡ uː n
wench	w ɛ n t͡ʃ
chickie	t͡ʃ ɪ k i
massey	m æ s i
civitas	k i w ɪ t ɑ s
newport	n u p ɔ ɹ t
zygomatic	z a ɪ ɡ ə m æ t ɪ k
shleps	ʃ l ɛ p s
belongs	b ɪ l ɔ ŋ z
macaulay	m ə k ɔː l i
terrenceville	t ɛ ɹ ə n s v ɪ l
euth	j u θ
workforce	w ɝ k f o ɹ s
tyranny	t ɪ ɹ ə n i
celtomania	k ɛ l t o ʊ m e ɪ n i ə
woggle	w ɒ ɡ ə l
application	æ p l ɪ k e ɪ ʃ ə n
glitches	ɡ l ɪ t͡ʃ ɪ z
whally	w ɔː l ɪ
putid	p j uː t ɪ d
ephedra	ɛ f ɪ d ɹ ə
tones	t o ʊ n z
luminescence	l uː m ə n ɛ s ə n s
relapse	ɹ iː l æ p s
slovenian	s l ə v iː n i ə n
eldritch	ɛ l d ɹ ɪ t͡ʃ
oreo	ɔ ɹ i o ʊ
berg	b ɝ ɡ
preprepare	p ɹ i p ɹ ɪ p ɛ ɹ
piphilologist	p a ɪ f ɪ l ɑ l ə d͡ʒ ɪ s t
tornedalen	t ɔː ɹ n ə d ɑː l ə n
wuss	w ʊ s
cacoethics	k a k ə ʊ ɛ θ ɪ k s
overweather	ə ʊ v ə ɹ w ɛ ð ə ɹ
breathy	b ɹ ɛ θ i
phocian	f ə ʊ s i ə n
towering	t a ʊ ə ɹ ɪ ŋ
buchi	b ʊ t͡ʃ i
cantillation	k æ n t ɪ l e ɪ ʃ ə n
bathylimnetic	b æ θ i l ɪ m n ɛ t ɪ k
crowings	k ɹ o ʊ ɪ ŋ z
kerberos	k ɜ ɹ b ə ɹ ə s
lusatia	l u s e ɪ ʃ ə
nagual	n ə ɡ w ɑː l
imprudence	ɪ m p ɹ uː d n̩ s
evaporite	ɪ v æ p ə ɹ a ɪ t
clippers	k l ɪ p ɚ z
bentwood	b ɛ n t w ʊ d
beprose	b ɪ p ɹ ə ʊ z
gosewehr	ɡ o ʊ z w ɛ ə ɹ
acanthocephalid	ə k æ n t θ ə s ɛ f ə l ɪ d
gooch	ɡ uː t͡ʃ
bate	b e ɪ t
cerebel	s ɛ ɹ ə b ə l
web	w ɛ b
valuable	v æ l j u ə b l̩
gerrit	ɡ ɛ ɹ ɪ t
thole	θ o ʊ l
roach	ɹ o ʊ t͡ʃ
danger	d e ɪ n d͡ʒ ɚ
clues	k l uː z
ethionamide	ɛ θ a ɪ ɑ n ə m a ɪ d
frontales	f ɹ ʌ n t e ɪ l i z
copperfield	k ɑ p ɚ f iː l d
somewhile	s ʌ m w a ɪ l
superbeing	s u p ɚ b i ŋ
halal	h ə l ɑː l
lyric	l ɪ ɹ ɪ k
roué	ɹ uː e ɪ
sirius	s ɪ ɹ i ə s
sapient	s e ɪ p i ə n t
weakling	w iː k l ɪ ŋ ɡ
gamaliel	ɡ æ m ə l iː ə l
roadstead	ɹ o ʊ d s t ɛ d
cheaping	t͡ʃ iː p ɪ ŋ
hieratic	h a ɪ ə ɹ æ t ɪ k
floyd	f l ɔ ɪ d
desnuda	d ɛ s n u d ɑ
launch	l ɔ n t͡ʃ
meaburn	m iː b ɜː r n
cymbalist	s ɪ m b ə l ɪ s t
finical	f ɪ n ɪ k ə l
provident	p ɹ ɒ v ɪ d ə n t
khedive	k ə d iː v
prototype	p ɹ o ʊ t ə t a ɪ p
cuh	k ʌ
leigh	l iː
schatz	ʃ æ t s
supercollider	s u p ɚ k ə l a ɪ d ɚ
governed	ɡ ə v ɚ n d
spicate	s p a ɪ k e ɪ t
herbary	h ɜː ɹ b ə ɹ i
cosmopolite	k ɑ z m ɑ p ə l a ɪ t
acephalan	e ɪ s ɛ f ə l ə n
luckily	l ʌ k ə l i
plosive	p l o ʊ s ɪ v
preparative	p ɹ ə p æ ɹ ə t ɪ v
venue	v ɛ n j uː
wealy	w iː l i
unwittingly	ʌ n w ɪ t ɪ ŋ l i
connote	k ə n o ʊ t
ciss	s ɪ s
apostate	ə p ɔ s t e ɪ t
cockaigne	k ɒ k e ɪ n
acuity	ə k j uː ɪ t i
stealing	s t iː l ɪ ŋ
equation	ɪ k w e ɪ ʃ ə n
tracks	t ɹ æ k s
adoxographer	e ɪ d ɑ k s ɑ ɡ ɹ ə f ɚ
casey	k e ɪ s i
centrosymmetricity	s ɛ n t ɹ ə ʊ s ɪ m ə t ɹ ɪ s ɪ t i
blackfoot	b l æ k f ʊ t
operand	ɑ p ə ɹ æ n d
nomenclature	n o ʊ m ə n k l e ɪ t͡ʃ ɚ
haboku	h ɑ b o ʊ k u
nielle	n j ɛ l
brotastic	b ɹ ə ʊ t æ s t ɪ k
collectible	k ə l ɛ k t ɪ b ə l
hydraulics	h a ɪ d ɹ ɔː l ɪ k s
paprika	p æ p ɹ iː k ə
conjurer	k ʌ n d͡ʒ ə ɹ ə ɹ
crosswind	k ɹ ɑː s w ɪ n d
kelleher	k ɛ l ə h ɚ
canvass	k æ n v ə s
pyroxene	p a ɪ ɹ ɑ k s i n
missend	m ɪ s s ɛ n d
haskell	h æ s k ə l
abkar	ɑ b k ɑ ɹ
bacup	b e ɪ k ʌ p
knoll	n o ʊ l
pahari	p ə h ɑː ɹ i
poon	p uː n
abouts	ə b a ʊ t s
immerse	ɪ m ɝ s
stygian	s t ɪ d͡ʒ i ə n
pacifism	p æ s ɪ f ɪ z ə m
hey	h e ɪ
diloxanide	d a ɪ l ɑ k s ə n a ɪ d
dunam	d ʊ n ə m
single	s ɪ ŋ ɡ ə l
manor	m æ n ə ɹ
petrarch	p i t ɹ ɑ ɹ k
seattle	s i æ t l̩
edifying	ɛ d ɪ f a ɪ ɪ ŋ
illation	ə l e ɪ ʃ ə n
which've	w ɪ t͡ʃ ə v
geoglyph	d͡ʒ iː ə ɡ l ɪ f
pallium	p æ l i ə m
profusely	p ɹ ə f j u s l i
canakin	k æ n ə k ɪ n
associations	ə s o ʊ s i e ɪ ʃ ə n z
bending	b ɛ n d ɪ ŋ
hornotine	h ɔː ɹ n ə t a ɪ n
cenesthopathy	s iː n ə s θ ɒ p ə θ i
accordionist	ə k ɔ ɹ d i ə n ə s t
exteriorized	ɛ k s t ɪ ɹ i ə ɹ a ɪ z d
hertz	h ɝ t s
childbed	t͡ʃ a ɪ l d b ɛ d
lop	l o ʊ p
gymnastics	d͡ʒ ɪ m n æ s t ɪ k s
science	s a ɪ ə n s
entente	ɑ n t ɑ n t
multifold	m ʌ l t ə f o ʊ l d
rating	ɹ e ɪ t ɪ ŋ
demagogue	d ɛ m ə ɡ ɑ ɡ
wan	w æ n
gsoc	d͡ʒ iː s ɑ k
paracosm	p æ ɹ ə k ɒ z ə m
overnumerousness	o ʊ v ɚ n u m ə ɹ ə s n ə s
dearly	d ɪ ɹ l i
supplying	s ə p l a ɪ ɪ ŋ
disney	d ɪ z n i
palaces	p æ l ɪ s ɪ z
budgerigar	b ʌ d͡ʒ ə ɹ i ɡ ɑ ɹ
anniversary	æ n ə v ɝ s ə ɹ i
kittitas	k ɪ d ɪ t æ s
keriorrhea	k ɛ ɹ ɪ ə ɹ iː ə
gangnam	ɡ ɑ ŋ n ɑ m
recite	ɹ ɪ s a ɪ t
affluence	æ f l u ə n s
theater	θ i ə t ɚ
kilos	k i l o ʊ z
misoneism	m a ɪ s ə n iː ɪ z ə m
llandudno	l æ n d ɪ d n o ʊ
demonstrate	d ɛ m ə n s t ɹ e ɪ t
machinist	m ə ʃ iː n ɪ s t
towkay	t a ʊ k e ɪ
nicaragua	n ɪ k ə ɹ ɑ ɡ w ə
mincer	m ɪ n s ɚ
foolscap	f uː l s k æ p
empire	ɛ m p a ɪ ɚ
spirochetolytic	s p a ɪ r o ʊ k i t ə l ɪ t ɪ k
oats	o ʊ t s
brainy	b ɹ e ɪ n i
script	s k ɹ ɪ p t
problem	p ɹ ɑ b l ə m
curate	k j ʊ ɹ e ɪ t
cockle	k ɒ k l̩
minxishly	m ɪ ŋ k s ɪ ʃ l i
teak	t iː k
botryoid	b ɑ t ɹ i ɔ ɪ d
gülenist	ɡ u l ə n ɪ s t
wouldn't	w ʊ d n̩ t
trews	t ɹ uː z
flimsy	f l ɪ m z i
invent	ɪ n v ɛ n t
banes	b e ɪ n z
argent	ɑ ɹ d͡ʒ ə n t
engross	ɛ n ɡ ɹ o ʊ s
pastis	p æ s t iː s
bears	b ɛ ɹ z
impatiently	ɪ m p e ɪ ʃ ə n t l i
nulled	n ʌ l d
antarctic	æ n t ɑ ɹ k t ɪ k
jarp	d͡ʒ ɑ ɹ p
irenic	a ɪ ɹ i n ɪ k
umich	j u m ɪ ʃ
macaroni	m æ k ə ɹ o ʊ n i
trifles	t ɹ a ɪ̯ f l̩ z
hadleigh	h æ d l i
mascle	m æ s k ə l
metabolite	m ɪ t æ b ə l a ɪ t
retrospective	ɹ ɛ t ɹ ə ʊ s p ɛ k t ɪ v
sanguinolent	s æ ŋ ɡ w ɪ n ə l ə n t
shanxi	ʃ ɑ n ʃ i
squeenix	s k w iː n ɪ k s
inconsistent	ɪ n k ə n s ɪ s t ə n t
tunnel	t ʌ n ə l
meadery	m i d ə ɹ i
reak	ɹ iː k
nirvana	n ɚ v æ n ə
cloning	k l o ʊ n ɪ ŋ
diamond	d a ɪ ə m ə n d
mesophyll	m iː s ə ʊ f ɪ l
changchun	t͡ʃ æ ŋ t͡ʃ ʊ n
animus	æ n ɪ m ə s
mésalliance	m e ɪ z ə l a ɪ ə n s
polaris	p ɔ ʊ l ɑ ɹ ɪ s
scorpio	s k ɔː ɹ p ɪ o ʊ
grouching	ɡ ɹ a ʊ t͡ʃ ɪ ŋ
redaction	ɹ ə d æ k ʃ ə n
wholly	h o ʊ l i
polytheistic	p ɒ l ɪ θ iː ɪ s t ɪ k
flintwork	f l ɪ n t w ɜː ɹ k
deistically	d e ɪ ɪ s t ɪ k l i
nipple	n ɪ p ə l
terrier	t ɛ ɹ i ə ɹ
pudor	p j uː d ɔː
belarusian	b ɛ l ə ɹ uː s i ə n
danwei	d ɑː n w e ɪ
solar	s o ʊ l ɚ
hold	h o ʊ l d
vocally	v o ʊ k ə l i
pistole	p ɪ s t o ʊ l
yogh	j o ʊ ɡ
paycheck	p e ɪ t͡ʃ ɛ k
subterfuge	s ʌ b t ə ɹ f j uː d͡ʒ
upfront	ʌ p f ɹ ʌ n t
quartet	k w ɔː ɹ t ɛ t
cowbit	k a ʊ b ɪ t
seesaw	s i s ɔ
emanate	ɛ m ə n e ɪ t
hydrolysate	h a ɪ d ɹ ɒ l ɪ s ə t
confronted	k ə n f ɹ ʌ n t ɪ d
sheffield	ʃ ɛ f iː l d
kelvin	k ɛ l v ə n
forgot	f ɚ ɡ ɑ t
airport	ɛ ɹ p ɔ ɹ t
perform	p ɚ f ɔ ɹ m
stradivarius	s t ɹ æ d ə v ɛ ɹ i ə s
fucus	f j uː k ə s
mags	m æ ɡ z
infiltrate	ɪ n f ə l t ɹ e ɪ t
quartan	k w ɔ ɹ t ə n
statistic	s t ə t ɪ s t ɪ k
adolph	e ɪ d ɑ l f
almah	æ l m ə
madeline	m æ d ə l ɪ n
leicester	l ɛ s t ɚ
entertained	ɛ n t ɚ t e ɪ n d
jet	d͡ʒ ɛ t
nullibiety	n ʌ l ɪ b a ɪ ɪ t i
askeses	ə s k i s i z
populace	p ɑ p j ə l ə s
redowa	ɹ ɛ d ə v ə
abiturient	ɑ b ɪ t u ɹ i ɛ n t
ablush	ə b l ʌ ʃ
tiggerish	t ɪ ɡ ə ɹ ɪ ʃ
flexure	f l ɛ k s j ʊ ə ɹ
husks	h ʌ s k s
whacks	w æ k s
dinkum	d ɪ ŋ k ə m
literature	l ɪ t ɚ t͡ʃ ɚ
binds	b a ɪ n d z
compatriot	k ə m p e ɪ t ɹ i ə t
shawty	ʃ ɔː t i
dinnet	d ɪ n ə t
peeving	p iː v ɪ ŋ
branch	b ɹ æ n t͡ʃ
skills	s k ɪ l z
sizable	s a ɪ z ə b ə l
banzai	b æ n z a ɪ
spiced	s p a ɪ s t
swamp	s w ɑ m p
casually	k æ ʒ u ə l i
bangalore	b æ ŋ ɡ ə l o ɹ
cardinal	k ɑ ɹ d n ə l
benzopyrazine	b ɛ n z ə ʊ p a ɪ ɹ ə z iː n
hogmanay	h ɑ ɡ m ə n e ɪ
arraigning	ə ɹ e ɪ n ɪ ŋ
impresario	ɪ m p r ɪ s ɑː r ɪ ə ʊ
commotion	k ə m o ʊ ʃ ə n
forefinger	f ɔ ɹ f ɪ ŋ ɡ ɚ
confess	k ə n f ɛ s
precise	p ɹ ɪ s a ɪ s
recalcitrate	ɹ ɪ k æ l s ɪ t ɹ e ɪ t
slapdash	s l æ p d æ ʃ
adorbs	ə d ɔ ɹ b z
marmoset	m ɑ ɹ m ə s ə t
heathenesse	h iː ð ə n ə s
shipworm	ʃ ɪ p w ɜː ɹ m
nanase	n a n a s e
chickies	t͡ʃ ɪ k i z
teleophyte	t ɛ l iː ə ʊ f a ɪ t
spender	s p ɛ n d ɚ
sneeze	s n iː z
reanimate	ɹ i æ n ə m e ɪ t
deliberately	d ə l ɪ b ə ɹ ə t l i
emerod	ɛ m ə ɹ ə d
willpower	w ɪ l p a ʊ ɚ
bulky	b ʌ l k i
jaw	d͡ʒ ɑ
irritated	ɪ ɹ ɪ t e ɪ t ɪ d
gingerism	d͡ʒ ɪ n d͡ʒ ɚ ɪ z m̩
pederast	p i d ə ɹ æ s t
paperback	p e ɪ p ɚ b æ k
thieves	θ iː v z
pseudopatient	s u d o ʊ p e ɪ ʃ ə n t
haking	h e ɪ k ɪ ŋ
ghana	ɡ æ n ə
octavation	ɒ k t e ɪ v e ɪ ʃ ə n
resource	ɹ i s ɔ ɹ s
titles	t a ɪ t l̩ z
bumptious	b ʌ m p ʃ ə s
abacate	æ b ə k ɑ t i
artificial	ɑː ɹ t ə f ɪ ʃ ə l
fluorate	f l o ɹ e ɪ t
accelerometer	æ k s ɛ l ə ɹ ɑ m ə t ɚ
adulate	æ d͡ʒ ə l e ɪ t
drover	d ɹ o ʊ v ə ɹ
spoke	s p ə ʊ k
taxes	t æ k s iː z
zouave	z u ɑ v
information	ɪ n f ɚ m e ɪ ʃ ə n
fluvoxamine	f l uː v ɑ k s ə m iː n
trillion	t ɹ ɪ l j ə n
temeritous	t ɪ m ɛ ɹ ə t ə s
abaptiston	æ b æ p t ɪ s t ɑ n
dysprosium	d ɪ s p ɹ o ʊ z i ə m
brits	b ɹ ɪ t s
liberate	l ɪ b ə ɹ e ɪ t
baubon	b ɔː b ə n
welwood	w ɛ l w ʊ d
phenoxypropazine	f ə n ɒ s k i p ɹ ə ʊ p ə z iː n
ily	ɪ l i
andromache	æ n d ɹ ɒ m ə k i
kenora	k ə n ɔː r ə
soup	s u p
norepinephrine	n ɔː ɹ ɛ p ɪ n ɛ f ɹ ɪ n
casting	k æ s t ɪ ŋ
awry	ə ɹ a ɪ
computerette	k ə m p j u t ɚ ɹ ɛ t
unenabled	ʌ n ə n e ɪ b ə l d
kirkheaton	k ə r k h iː t ə n
indinavir	ɪ n d ɪ n ə v ɪ ɹ
blends	b l ɛ n d z
trenches	t ɹ ɛ n t͡ʃ ɪ z
slight	s l a ɪ t
culantro	k uː l æ n t ɹ o ʊ
flux	f l ʌ k s
kittlish	k ɪ t ə l ɪ ʃ
chance	t͡ʃ æ n s
hyoidal	h a ɪ ɔ ɪ d ə l
aleglitazar	æ l ə ɡ l ɪ t ə z ɑ ɹ
downloading	d a ʊ n l o ʊ d ɪ ŋ
connascence	k ə n æ s ə n s
supraclavicular	s u p ɹ ə k l æ v ɪ k j ə l ɚ
colport	k ɒ l p ɔː ɹ t
emma	ɛ m ə
penglai	p ɛ ŋ l a ɪ
saule	s ɔː l
numinous	n j u m ə n ə s
yakky	j æ k i
navaratna	n ɑ v ɑ ɹ ɑ t n ɑ
scuppernong	s k ʌ p ə ɹ n ɑ ŋ
implements	ɪ m p l ə m ə n t s
dejecta	d i d͡ʒ ɛ k t ə
internally	ɪ n t ɝ n ə l i
beckett	b ɛ k ɪ t
humming	h ʌ m ɪ ŋ
spetchel	s p e t͡ʃ l
atrichic	e ɪ t ɹ ɪ k ɪ k
thorough	θ ɜ ɹ o ʊ
suppawn	s ə p ɔː n
hivemind	h a ɪ v m a ɪ n d
mampy	m æ m p i
kitbag	k ɪ t b æ ɡ
diver	d a ɪ̯ v ə ɹ
vierkleur	f ɪ ɹ k l ɜ ɹ
apoxyomenos	ə p ɑ k s i ɑ m ə n ɑ s
plaice	p l e ɪ s
menhaden	m ɛ n h e ɪ d ə n
maftir	m ɑː f t iː ɹ
maraca	m ə ɹ æ k ə
apraxia	ə p ɹ æ k s ɪ ə
gamed	ɡ e ɪ m d
theanthropist	θ iː æ n θ ɹ ə p ɪ s t
casanova	k æ s ə n o ʊ v ə
batdom	b æ t d ə m
planetary	p l æ n ə t ɛ r i
choc	t͡ʃ ɒ k
tigger	t ɪ ɡ ɚ
hydrocele	h a ɪ d ɹ ə s iː l
stylohyoid	s t a ɪ l o ʊ h a ɪ ɔ ɪ d
oneironaut	o ʊ n a ɪ ɹ o ʊ n ɔ t
fantasy	f æ n t ə s i
specialist	s p ɛ ʃ ə l ɪ s t
nerf	n ɝ f
flowrate	f l o ʊ ɹ e ɪ t
undeserving	ʌ n d ɪ z ɝ v ɪ ŋ
optofluidics	ɑ p t o ʊ f l u ɪ d ɪ k s
fishhook	f ɪ ʃ h ʊ k
floss	f l ɔ s
oleose	ə ʊ l i ə ʊ z
han	h e ɪ n
azygous	e ɪ z a ɪ ɡ ə s
diagenesis	d a ɪ ə d͡ʒ ɛ n ə s ɪ s
polyzoan	p ɒ l i z ə ʊ ə n
irrawaddy	ɪ ɹ ə w ɑ d i
release	ɹ iː l iː s
maracanaço	m æ ɹ ə k ə n ɑː s ə ʊ
effected	ɪ f ɛ k t ɪ d
hubby	h ʌ b i
yaldabaoth	j ɑː l d ə b e ɪ ɒ θ
egoboo	iː ɡ ə ʊ b uː
cohesive	k o ʊ h iː s ɪ v
whichsoever	w ɪ t͡ʃ s o ʊ ɛ v ɚ
molar	m o ʊ l ɚ
cheating	t͡ʃ iː t ɪ ŋ
antiphon	æ n t ɪ f ɑ n
cissy	s ɪ s i
dorp	d ɔː ɹ p
rusyn	r uː s ɪ n
manifestation	m æ n ɪ f ə s t e ɪ ʃ ə n
amain	ə m e ɪ n
tetrylammonium	t ɛ t ɹ ə l ə m o ʊ n i ə m
echard	ɛ k ɑː ɹ d
auxometer	ɔː k s ɒ m ɪ t ə
oneiromancy	o ʊ n a ɪ ɹ o ʊ m æ n t s i
seedtime	s iː d t a ɪ m
waywode	w e ɪ w ə ʊ d
unchaste	ʌ n t͡ʃ e ɪ s t
fire	f a ɪ ə ɹ
natasha	n ə t æ ʃ ə
varronian	v æ ɹ o ʊ n i ə n
loppet	l o ʊ p ɛ t
garboil	ɡ ɑː ɹ b ɔ ɪ l
virgula	v ə ɹ ɡ j ʊ l ə
cogniscient	k ɒ ɡ n ɪ ʃ ə n t
bearable	b ɛ ə ɹ ə b ə ɫ
fazzolet	f æ z ə l ɛ t
clacks	k l æ k s
elam	iː l ə m
clicking	k l ɪ k ɪ ŋ
boiler	b ɔ ɪ l ɚ
anyways	ɛ n i w e ɪ z
zichyújfalu	z i t͡ʃ i uː j f ɒ l u
tushker	t ʌ ʃ k ə ɹ
yiff	j ɪ f
greatness	ɡ ɹ e ɪ t n ə s
kontor	k ɑ n t ɔ ɹ
achillean	æ k ɪ l iː ə n
acrylate	æ k ɹ ɪ l e ɪ t
shopworn	ʃ ɒ p w ɔː ɹ n
osage	o ʊ s e ɪ d͡ʒ
advantageous	æ d v ə n t e ɪ d͡ʒ ə s
panga	p a ŋ ɡ ə
alps	æ l p s
thrilled	θ ɹ ɪ l d
abandoning	ə b æ n d ə n ɪ ŋ
maybe	m e ɪ b i
ischemiae	ɪ s k i m i a ɪ
skunk	s k ʌ ŋ k
postoperative	p o ʊ s t ɑ p ə ɹ ə t ɪ v
legwork	l ɛ ɡ w ɚ k
wodgil	w ɑ d͡ʒ ɪ l
permanence	p ɜ ɹ m ə n ə n s
trip	t ɹ ɪ p
canaigre	k ə n a ɪ ɡ r i
latency	l e ɪ t ə n s i
groyper	ɡ r ɔ ɪ p ɝ
remediless	ɹ ɛ m ə d i l ɪ s
firth	f ɝ θ
nill	n ɪ l
nodule	n ɑː d͡ʒ uː l
adusk	ə d ʌ s k
fails	f e ɪ l z
pentad	p ɛ n t æ d
mealer	m iː l ə ɹ
absurdly	æ b s ɝ d l i
composure	k ə m p o ʊ ʒ ɚ
veriest	v ɛ ɹ i ə s t
moschatel	m ɒ s k ə t ɛ l
slack	s l æ k
converted	k ə n v ɝ t ɪ d
sensory	s ɛ n s ə ɹ i
derich	d i ɹ ɪ t͡ʃ
noosed	n uː s t
bday	b iː d e ɪ
antrum	æ n t ɹ ə m
beggings	b ɛ ɡ ɪ ŋ z
farsi	f ɑː ɹ s i
woodstock	w ʊ d s t ɒ k
scamp	s k a m p
aguise	ə ɡ a ɪ z
clusters	k l ʌ s t ɚ z
glandular	ɡ l æ n d͡ʒ ə l ɚ
cotyledon	k ɑ t ə l iː d ə n
sounding	s a ʊ n d ɪ ŋ
spivvery	s p ɪ v ə ɹ i
unergatives	ʌ n ɜː ɹ ɡ ə t ɪ v z
herring	h ɛ ɹ ɪ ŋ
orinoco	o ʊ ɹ ɪ n o ʊ k o ʊ
lachesis	l æ k ɪ s ɪ s
ultravast	ʌ l t ɹ ə v æ s t
bona	b ə ʊ n ə
xoanon	z o ʊ ə n ɑ n
crimp	k ɹ ɪ m p
ruckus	ɹ ʌ k ə s
fuzed	f j uː z d
supershot	s u p ɚ ʃ ɑ t
searce	s ɑ ɹ s
banneret	b æ n ə ɹ e t
scold	s k o ʊ l d
honest	ɑ n ɪ s t
louth	l a ʊ ð
podiatry	p ə d a ɪ ə t ɹ i
hydroxymethylsulfonate	h a ɪ d r ɑ k s i m ɛ θ ə l s ʌ l f ə n e ɪ t
luxury	l ʌ k ʃ ə ɹ i
telegraphy	t ə l ɛ ɡ ɹ ə f i
overspecialize	o ʊ v ɚ s p ɛ ʃ ə l a ɪ z
septicaemic	s ɛ p t ɪ s iː m ɪ k
freshes	f ɹ ɛ ʃ ɪ z
untakeable	ʌ n t e ɪ k ə b l̩
fragility	f ɹ ə d͡ʒ ɪ l ɪ t i
aeration	ɛː r e ɪ ʃ ə n
oniomaniac	ə ʊ n i ə ʊ m e ɪ n i æ k
nauseated	n ɔː z i e ɪ t ɪ d
nietzscheanism	n i t͡ʃ i ə n ɪ z ə m
geosmin	d͡ʒ i ɑ z m ɪ n
correspondence	k ɒ ɹ ɪ s p ɒ n d ə n s
wiles	w a ɪ l z
whales	w e ɪ l z
godzilla	ɡ ɑ d z ɪ l ə
ivanovna	ɪ v æ n ə v n ə
macropsy	m æ k ɹ ɒ p s i
kitty	k ɪ t i
besought	b ɪ s ɔː t
tag	t æ ɡ
incus	ɪ ŋ k ə s
chewy	t͡ʃ uː i
feastware	f iː s t w ɛ ə ɹ
storie	s t ɔː ɹ i
swadeshi	s w ə d ɛ ʃ i
tentacular	t ɛ n t æ k j uː l ə ɹ
spinsterishness	s p ɪ n s t ə ɹ ɪ ʃ n ə s
attract	ə t ɹ æ k t
chernobyl	t͡ʃ ɚ n o ʊ b ə l
maniacally	m ə n a ɪ ə k l i
jinhua	d͡ʒ ɪ n h w ɑː
halfpenny	h e ɪ p ə n i
balearic	b æ l i æ ɹ ɪ k
copter	k ɑ p t ɚ
anathema	ə n æ θ ə m ə
jammy	d͡ʒ æ m i
pistol	p ɪ s t ə l
climb	k l a ɪ m
heirdom	ɛ ə ɹ d ə m
spiracle	s p ɪ ɹ ə k ə l
handiwork	h æ n d i w ɝ k
sanctimonious	s æ ŋ k t ə m o ʊ n i ə s
femalia	f iː m e ɪ l i ə
farcical	f ɑː ɹ s ɪ k ə l
dessert	d ɪ z ɝ t
sherbrooke	ʃ ɝ b ɹ ʊ k
arhat	ɑː h æ t
handstand	h æ n d s t æ n d
rectum	ɹ ɛ k t ə m
sowl	s a ʊ l
deneisha	d ɪ n iː ʃ ə
ocarina	o ʊ k ə ɹ i n ə
functional	f ʌ ŋ k t͡ʃ n ə l
ingenuous	ɪ n d͡ʒ ɛ n j u ə s
bioinformatics	b a ɪ o ʊ ɪ n f ɚ m æ t ɪ k s
ra	ɹ ɑː
beliven	b ə l ɪ v ə n
burgeo	b ɜː ɹ d͡ʒ o ʊ
civilise	s ɪ v ɪ l a ɪ z
stress	s t ɹ ɛ s
comprehension	k ɑ m p ɹ ɪ h ɛ n ʃ n̩
sussultatory	s ʌ s ə l t e ɪ t ə ɹ i
vali	v ɑː l ɪː
scye	s a ɪ
stun	s t ʌ n
germen	d͡ʒ ɝ m ə n
cumming	k ʌ m ɪ ŋ
pavis	p ɑ v ɪ s
politique	p ɑ l ə t ɪ k
scarifier	s k æ ɹ ɪ f a ɪ ə ɹ
stood	s t ʊ d
duality	d j uː æ l ɪ t i
butterfly	b ʌ t ə ɹ f l a ɪ
perplexity	p ə ɹ p l ɛ k s ə d i
lubra	l uː b ɹ ə
rizzuto	ɹ ɪ t s uː t ə ʊ
luzon	l u z ɔ n
grouchy	ɡ ɹ a ʊ t͡ʃ i
encierro	ɛ n s i ɛ ɹ o ʊ
perjury	p ɜː ɹ d͡ʒ ə ɹ i
debunk	d iː b ʌ ŋ k
reciprocal	ɹ ɪ s ɪ p ɹ ə k ə l
sifter	s ɪ f t ɚ
snipelike	s n a ɪ p l a ɪ k
oryx	o ʊ ɹ ɪ k s
oma	o ʊ m ɑ
kasundi	k ə s ʊ n d i
permission	p ɚ m ɪ ʃ ə n
finalize	f a ɪ n ə l a ɪ z
higgs	h ɪ ɡ z
dre	d ɹ e ɪ
camomile	k æ m ə m a ɪ l
blissfully	b l ɪ s f l i
prosecco	p ɹ o ʊ s ɛ k o ʊ
secure	s ə k j ɔ ɹ
accident	æ k s ə d ə n t
reversionary	ɹ ə v ɝ ʒ ə n ɛ ɹ i
newel	n j u ə l
beantown	b i n t a ʊ n
adhocratic	æ d h ə k ɹ æ d ɪ k
stereoscopic	s t ɛ r i ə s k ɑː p ɪ k
cnemides	n ɛ m ɪ d iː z
verstehen	v ə ɹ ʃ t e ɪ ə n
hounded	h a ʊ n d ɪ d
douchebag	d uː ʃ b æ ɡ
rhyparography	ɹ ɪ p ə ɹ ɑ ɡ ɹ ə f i
cringing	k ɹ ɪ n d͡ʒ ɪ ŋ
hella	h ɛ l ə
galápagos	ɡ ə l æ p ə ɡ o ʊ s
deets	d iː t s
outburst	a ʊ t b ɝ s t
jubile	d͡ʒ u b ə l
bengali	b ɛ ŋ ɡ ɔː l i
ecstatica	ɛ k s t æ t ɪ k ə
sparerib	s p ɛ ɚ ɹ ɪ b
rigs	ɹ ɪ ɡ z
whatnot	w ʌ t n ɑ t
matador	m æ t ə d ɔ ɹ
fryatt	f ɹ a ɪ ə t
gujari	ɡ u d͡ʒ ɑː ɹ i
call't	k ɔː l t
thrack	θ ɹ æ k
mexicali	m ɛ k s ɪ k æ l i
europe	j ɝ ə p
synoecious	s ɪ n iː ʃ ə s
mattie	m æ t i
tortfeasor	t ɔ ɹ t f iː z ɚ
reports	ɹ ɪ p ɔ ɹ t s
brooke	b ɹ ʊ k
leicestrian	l ɛ s t ɹ ɪ ə n
abasement	ə b e ɪ s m ə n t
dominions	d ə m ɪ n j ə n z
advancer	ə d v æ n s ɚ
rules	ɹ u l z
antiquity	æ n t ɪ k w ə t i
kilroy	k ɪ l ɹ ɔ ɪ
culverin	k ʌ l v ə ɹ ɪ n
milliner	m ɪ l ɪ n ɚ
wool	w ʊ l
wainwright	w e ɪ n ɹ a ɪ t
lamely	l e ɪ m l i
outsourcing	a ʊ t s ɔː ɹ s ɪ ŋ
pasadena	p æ s ə d iː n ə
developmentals	d ɪ v ɛ l ə p m ɛ n t ə l z
foolings	f uː l ɪ ŋ z
gaunt	ɡ ɔː n t
cyanose	s a ɪ ə n ə ʊ s
monoecious	m ə n iː ʃ ə s
misère	m iː z ɛ ə ɹ
slowpoke	s l o ʊ p o ʊ k
pitch	p ɪ t͡ʃ
ado	ə d uː
odessa	ə ʊ d ɛ s ə
xoloitzcuintli	ʃ o ʊ l o ʊ ɪ t s k w ɪ n t l i
bolder	b o ʊ l d ə ɹ
hank	h æ ŋ k
excandescence	ɛ k s k æ n d ɛ s ə n s
cacoethes	k a k ə ʊ iː θ iː z
shitty	ʃ ɪ t i
dern	d ɜː ɹ n
miscarry	m ɪ s k æ ɹ i
convinces	k ə n v ɪ n s ɪ z
combatant	k ɑ m b ə t ə n t
infrahyoid	ɪ n f ɹ ə h a ɪ ɔ ɪ d
attrit	ə t ɹ ɪ t
fbi	ɛ f b iː a ɪ
holds	h o ʊ l d z
maniac	m e ɪ n i æ k
ortiz	ɔ ɹ t i s
aquiline	æ k w ɪ l a ɪ n
obadiah	o ʊ b ə d a ɪ ə
hiragana	h ɪ ɹ ə ɡ æ n ə
pope	p o ʊ p
conceptional	k ə n s ɛ p ʃ ə n ə l
blacktop	b l æ k t ɒ p
skoosh	s k u ʃ
panicky	p æ n ɪ k i
atrocity	ə t ɹ ɒ s ɪ t i
auspice	ɔ s p ɪ s
grows	ɡ ɹ o ʊ z
bundestag	b ʊ n d ə s t ɑː ɡ
turin	t ə ɹ ɪ n
heathrow	h iː θ ɹ o ʊ
sansha	s ɑ n ʃ ɑː
boymoder	b ɔ ɪ m o ʊ d ɚ
amun	ɑː m uː n
eclectic	ɛ k l ɛ k t ɪ k
crosier	k ɹ o ʊ ʒ ɚ
ma	m ɑː
diffident	d ɪ f ɪ d ə n t
beechmast	b i t͡ʃ m æ s t
function	f ʌ ŋ k ʃ ə n
packs	p æ k s
badassery	b æ d æ s ə ɹ i
adieu	ə d j u
tickets	t ɪ k ɪ t s
sourceable	s ɔ ɹ s ə b ə l
vaguened	v e ɪ ɡ ə n d
brad	b ɹ æ d
sprightly	s p ɹ a ɪ t l i
pizzle	p ɪ z l̩
galwegian	ɡ ɔ l w i d͡ʒ ə n
bellburns	b ɛ l b ɝ n z
legislature	l ɛ d͡ʒ ɪ s l e ɪ t͡ʃ ɚ
dormouse	d ɔ ɹ m a ʊ s
abdominocardiac	æ b d ɑ m ɪ n o ʊ k ɑ ɹ d i æ k
fusee	f j uː z i
arriving	ə ɹ a ɪ v ɪ ŋ
attainments	ə t e ɪ n m ə n t s
caib	k e ɪ b
seliciclib	s ɛ l ɪ s ɪ k l ɪ b
shinola	ʃ ɪ n o ʊ l ə
alif	a l ɪ f
priceless	p ɹ a ɪ s l ə s
romanesque	ɹ o ʊ m ə n ɛ s k
vaguebook	v e ɪ ɡ b ʊ k
parka	p ɑ ɹ k ə
sievert	s iː v ɚ t
sting	s t ɪ ŋ
paddocking	p æ d ə k ɪ ŋ
abrase	ə b ɹ e ɪ z
cooch	k uː t͡ʃ
marginalness	m ɑ ɹ d͡ʒ ə n ə ɫ n ə s
lhasa	l ɑː s ə
bassoon	b ə s u n
recreancy	ɹ ɛ k ɹ i ə n s i
obtain	ə b t e ɪ n
captopril	k æ p t ə p ɹ ɪ l
dematerialize	d i m ə t ɪ ɹ i ə l a ɪ z
zolpidem	z o ʊ l p ɪ d ɛ m
satire	s æ t a ɪ ɹ
eiffel	a ɪ f l̩
fallopian	f ə l o ʊ p i ə n
stephanie	s t ɛ f ə n i
militiate	m ɪ l ɪ ʃ i e ɪ t
hexapod	h ɛ k s ə p ɑ d
bowtie	b o ʊ t a ɪ
elf	ɛ l f
clotho	k l o ʊ θ o ʊ
microbial	m a ɪ k ɹ o ʊ b i ə l
croon	k ɹ uː n
secs	s ɛ k s
fatal	f e ɪ t ə l
californium	k æ l ɪ f ɔ ɹ n i ə m
encyclopediae	ɪ n s a ɪ k l ə p iː d i a ɪ
lactulose	l æ k t j ʊ l o ʊ s
coldham	k ə ʊ l d ə m
notoriety	n o ʊ t ɚ a ɪ ə t i
squabash	s k w ə b æ ʃ
pigtail	p ɪ ɡ t e ɪ l
blumenthal	b l uː m ə n t ɑː l
clade	k l e ɪ d
abditory	æ b d ɪ t ə ɹ i
waily	w e ɪ l i
apoptosis	æ p ə p t o ʊ s ə s
fungi	f u n d͡ʒ i
jinn	d͡ʒ ɪ n
resonate	ɹ ɛ z ə n e ɪ t
fauld	f ɔ l d
shunga	ʃ ʊ ŋ ə
nuxálk	n uː h ɒ l k
diphone	d a ɪ f ə ʊ n
insects	ɪ n s ɛ k t s
valeria	v ə l ɪ ə ɹ i ə
maecenatism	m iː s iː n ə t ɪ z ə m
acetochlor	ə s iː t ə ʊ k l ɔː ɹ
macroeconomic	m æ k ɹ o ʊ ɛ k ə n ɑː m ɪ k
admirers	æ d m a ɪ ɚ ɚ z
recurve	ɹ ɪ k ɜː ɹ v
pierced	p ɪ ə ɹ s t
ballerina	b æ l ə ɹ iː n ə
najis	n ɑ d͡ʒ ɪ s
quixotry	k w ɪ k s ə t ɹ i
glossitis	ɡ l ɒ s a ɪ t ɪ s
batavia	b ə t e ɪ v i ə
reclamation	ɹ ɛ k l ə m e ɪ ʃ n̩
bulgur	b ʊ l ɡ ə ɹ
what	w ɑ t
agnostic	æ ɡ n ɑ s t ɪ k
busted	b ʌ s t ə d
desmond	d ɛ z m ə n d
efforce	ɪ f ɔː ɹ s
cancún	k ɑː n k uː n
nutty	n ʌ t i
churchical	t͡ʃ ɝ t͡ʃ ɪ k ə l
dissuade	d ɪ s w e ɪ d
circles	s ɝ k l̩ z
resurrection	ɹ ɛ z ə ɹ ɛ k ʃ n̩
rotherham	ɹ ɒ ð ə ɹ ə m
acrolect	æ k ɹ ə l ɛ k t
linearity	l ɪ n i æ ɹ ə t i
cosmopolis	k ɒ z m ɒ p ɒ l ɪ s
abovementioned	ə b ʌ v m ɛ n ʃ ə n d
kinney	k ɪ n i
wheedle	w iː d ə l
fyrom	f ɪ ɹ ə m
areole	æ ɹ i o ʊ l
aldehyde	æ l d ɪ h a ɪ d
drumslade	d r ʌ m s l e ɪ d
common	k ɑ m ə n
monetize	m ɒ n ə t a ɪ z
mullah	m ʊ l ə
interrupted	ɪ n t ə ɹ ʌ p t ɪ d
primitive	p ɹ ɪ m ɪ t ɪ v
anacrogynous	æ n ə k ɹ ɑ d͡ʒ ɪ n ə s
tach	t æ k
farrier	f ɛ ɹ i ɚ
trichrome	t ɹ a ɪ k ɹ ə ʊ m
background	b æ k ɡ ɹ a ʊ n d
shadowy	ʃ æ d o ʊ i
accusatory	ə k j u z ə t ɔ ɹ i
yreka	w a ɪ r iː k ə
concordant	k ə ŋ k ɔː ɹ d ə n t
inclusionary	ɪ n k l uː ʒ ə n ɛ ɹ i
altman	ɔː l t m ə n
welk	w ɛ l k
lawn	l ɔ n
kendell	k ɛ n d ə l
bulked	b ʌ l k t
prereq	p ɹ i ɹ ɛ k
ctab	s iː t æ b
henpeck	h ɛ n p ɛ k
silken	s ɪ l k ə n
veny	v ɛ n i
dressy	d ɹ ɛ s i
puzzled	p ʌ z l̩ d
theophilus	θ iː ɒ f ɪ l ə s
pethidine	p ɛ θ ɪ d iː n
these've	ð i z ə v
escrow	ɛ s k ɹ o ʊ̯
dalry	d æ l ɹ a ɪ
sandy	s æ n d i
asked	æ s k t
union	j uː n i ə n
pharmacovigilance	f ɑ ɹ m ə k o ʊ v ɪ d͡ʒ ɪ l ə n s
clumb	k l ʌ m
looter	l u t ɚ
hearthstone	h ɑ ɹ θ s t o ʊ n
redie	ɹ iː d a ɪ
workflow	w ɝ k f l o ʊ
favors	f e ɪ v ɚ z
banjouke	b æ n d͡ʒ ə ʊ j uː k
kumara	k uː m ə ɹ ə
ganguro	ɡ ɑː n ɡ u ɹ ə ʊ
aznavour	ɑː z n ə v ʊ ɚ
chaste	t͡ʃ e ɪ s t
bristly	b ɹ ɪ s l i
wain	w e ɪ n
diiodohydroxyquinoline	d a ɪ a ɪ ə d o ʊ h a ɪ d ɹ ɑ k s ɪ k w ɪ n ə l i n
beads	b iː d z
croupier	k ɹ u p i e ɪ
fopdoodle	f ɑ p d u d ə l
punks	p ʌ ŋ k s
imbongis	ɪ m b ɔ ŋ ɡ i s
pasithea	p ə s ɪ θ ɪ ə
subliterate	s ʌ b l ɪ t ə ɹ ə t
snark	s n ɑː ɹ k
spread	s p ɹ ɛ d
lardiner	l ɑ ɹ d ə n ɚ
synopsis	s ɪ n ɑ p s ɪ s
tweed	t w iː d
encounter	ɪ n k a ʊ n t ɚ
illabiality	ɪ l e ɪ b i æ l ɪ t i
crepuscular	k ɹ ɪ p ʌ s k j ə l ɚ
carb	k ɑ ɹ b
bohunk	b o ʊ h ʌ ŋ k
phrasebooks	f ɹ e ɪ z b ʊ k s
abducens	æ b d j u s ɛ n z
custodian	k ə s t o ʊ d i ə n
conlanger	k ɑ n l æ ŋ ɚ
crawshay	k ɹ ɔː ʃ e ɪ
aberdeen	æ b ɚ d i n
ciliolate	s ɪ l i ə l ə t
dudess	d j uː d ɛ s
dotard	d o ʊ t ɑ ɹ d
arnaut	ɑ ɹ n a ʊ t
emery	ɛ m ə ɹ i
paradoxical	p ɛ ɹ ə d ɑː k s ɪ k ə l
dehull	d i h ʌ l
sunita	s uː n iː t ə
ankh	ɑ ŋ k
presses	p ɹ ɛ s ɪ z
billy	b ɪ l i
slowth	s l o ʊ θ
recognition	ɹ ɛ k ə ɡ n ɪ ʃ ə n
belladonna	b ɛ l ə d ɑ n ə
denotation	d iː n o ʊ t e ɪ ʃ ə n
tarnish	t ɑ ɹ n ɪ ʃ
shoulda	ʃ ʊ d ə
tearaway	t ɛ ə ɹ ə w e ɪ
ocher	o ʊ k ɚ
interception	ɪ n t ɚ s ɛ p ʃ ə n
pasch	p æ s k
pearl	p ɝ l
thunderstruck	θ ʌ n d ɚ s t ɹ ʌ k
culty	k ʌ l t i
tuff	t ʌ f
megapenny	m ɛ ɡ ə p ɛ n i
mezereon	m ə z ɪ ə r i ə n
propice	p ɹ ə p a ɪ s
mamash	m ɑː m ə ʃ
intimately	ɪ n t ɪ m ə t l i
horrendous	h ə ɹ ɛ n d ə s
cruising	k ɹ uː z ɪ ŋ
embody	ɪ m b ɒ d i
responsiveness	ɹ ɪ s p ɒ n s ɪ v n ɪ s
foofaraw	f u f ə ɹ ɔ
cisgender	s ɪ s d͡ʒ ɛ n d ɚ
accustomedness	ə k ʌ s t ə m d n ɪ s
pericardium	p ɛ ɹ ɪ k ɑː ɹ d i ə m
suifenhe	s w e ɪ f ʌ n h ʌ
dictate	d ɪ k t e ɪ t
tyne	t a ɪ n
sagittae	s ə d͡ʒ ɪ t i
waiver	w e ɪ v ɚ
dipstick	d ɪ p s t ɪ k
pupal	p j uː p ə l
stubbington	s t ʌ b ɪ ŋ t ə n
peeking	p iː k ɪ ŋ
celtic	k ɛ l t ɪ k
gladden	ɡ l æ d ə n
care	k ɛ ə ɹ
salicional	s ə l ɪ ʃ n ə l
masterly	m æ s t ɚ l i
windowsill	w ɪ n d o ʊ s ɪ l
ablepharous	æ b l ɜ f ə ɹ ʌ s
scious	s a ɪ ə s
duplicitous	d j uː p l ɪ s ə t ə s
couple	k ʌ p ə l
dally	d æ l i
trailer	t ɹ e ɪ l ɚ
lambda	l æ m d ə
fieldwork	f i l d w ɝ k
fuckings	f ʌ k ɪ ŋ z
arrogate	æ ɹ ə ɡ e ɪ t
mound	m a ʊ n d
julian	d͡ʒ uː l i ə n
component	k ʌ m p o ʊ n ə n t
renegade	ɹ ɛ n ɪ ɡ e ɪ d
cumin	k j u m ɪ n
hatter	h æ t ə ɹ
odorless	ə ʊ d ə l ə s
clutched	k l ʌ t͡ʃ t
bastes	b e ɪ s t s
confit	k ɒ n f iː
guernsey	ɡ ɝ n z i
amphora	æ m f ə ɹ ə
theo	θ i o ʊ
taro	t ɑ ɹ o ʊ
executrix	ɪ ɡ z ɛ k j ə t ɹ ɪ k s
harmful	h ɑ ɹ m f l̩
gift	ɡ ɪ f t
vertiginous	v ɜː ɹ t ɪ d͡ʒ ɪ n ə s
conative	k o ʊ n ə t ɪ v
monoousian	m ɑ n o ʊ u z i ə n
hyoidean	h a ɪ ɔ ɪ d i ə n
skeezy	s k iː z i
ribaudequin	ɹ ɪ b ə ʊ d ɪ k ɪ n
bass	b e ɪ s
ways	w e ɪ z
bashlyk	b æ ʃ l ɪ k
crewed	k ɹ uː d
reservoir	ɹ ɛ z ə ɹ v w ɑ ɹ
invoke	ɪ n v o ʊ k
lasts	l æ s t s
worldly	w ɜː ɹ l d l i
expletive	ɛ k s p l ə t ɪ v
interpellate	ɪ n t ə ɹ p ɛ l e ɪ t
haggle	h æ ɡ ə l
vilazodone	v ɪ l æ z ə d ə ʊ n
mordant	m ɔː ɹ d ə n t
cuzco	k uː s k o ʊ
trannies	t ɹ æ n i z
wacko	w æ k ə ʊ
fiche	f iː ʃ
bulletproof	b ʊ l ɪ t p ɹ uː f
geyser	ɡ a ɪ s ɚ
also	ɑ l s o ʊ
gil	ɡ ɪ l
praziquantel	p ɹ æ z ɪ k w æ n t ɛ l
tampa	t æ m p ə
uniformal	j uː n ɪ f ɔː ɹ m ə l
commitment	k ə m ɪ t m ə n t
longsword	l ɔ ŋ s ɔ ɹ d
slushee	s l ʌ ʃ i
chloral	k l ɔː ɹ æ l
gnostic	n ɑ s t ɪ k
alces	æ l s iː z
haze	h e ɪ z
murray	m ɜ ɹ i
trees	t ɹ iː z
candidate	k æ n d ɪ d e ɪ t
kellion	k ɛ l iː ɑ n
fizgigged	f ɪ z ɡ ɪ ɡ d
polypantheism	p ɒ l i p æ n θ i ɪ z ə m
taxi	t æ k s i
esmolol	ɛ z m ə l ɔ l
arun	ɑː ɹ ʊ n
senioritis	s i n j ɚ ɑ i t ɪ s
hemmel	h ɛ m ə l
brand	b r æ n d
fictional	f ɪ k ʃ ə n ə l
kiang	k i æ ŋ
gifting	ɡ ɪ f t ɪ ŋ
affluent	æ f l u ə n t
filatory	f ɪ l ə t ɔ ɹ i
ventôse	v ɑ n t o ʊ z
subjacency	s ə b d͡ʒ e ɪ s ə n s i
munificence	m j uː n ɪ f ɪ s ə n s
rearview	ɹ i ɹ v j uː
conclude	k ə n k l uː d
yerkish	j ɜː r k ɪ ʃ
ink	i ŋ k
avoided	ə v ɔ ɪ d ɪ d
adirondack	æ d ɪ ɹ ɑ n d æ k
peeping	p iː p ɪ ŋ
linsheng	l ɪ n ʃ ɛ ŋ
unprofitable	ʌ n p ɹ ɑ f ɪ t ə b l̩
departed	d ɪ p ɑ ɹ t ɪ d
tentative	t ɛ n t ə t ɪ v
greenspan	ɡ ɹ iː n s p æ n
commissions	k ə m ɪ ʃ ə n z
mccrea	m ɪ k k r e ɪ
abandoner	ə b æ n d ə n ɚ
horizontal	h ɔː ɹ ə z ɑː n t ə l
kenspeckle	k ɛ n s p ɛ k ə l
hullock	h ʌ l ə k
donnean	d ʌ n i ə n
cyberocracy	s a ɪ b ə ɹ ɒ k ɹ ə s i
abaculus	ə b æ k j ə l ə s
zoomies	z uː m i z
dieretic	d a ɪ ə ɹ ɛ t ɪ k
completist	k ə m p l iː t ɪ s t
papyrus	p ə p a ɪ ɹ ə s
smiling	s m a ɪ l ɪ ŋ
medicaster	m ɛ d ə k æ s t ɚ
folger	f o ʊ l d͡ʒ ə r
alabama	æ l ə b æ m ə
bampot	b æ m p ɒ t
besmirch	b ɪ s m ɝː t͡ʃ
tog	t ɑ ɡ
pouldron	p o ʊ l d ɹ ə n
relentlessness	ɹ ɪ l ɛ n t l ə s n ə s
gaslight	ɡ æ s l a ɪ t
wug	w ʌ ɡ
meek	m i k
freeminer	f ɹ iː m a ɪ n ə
instance	ɪ n s t ə n s
nest	n ɛ s t
jerrie	d͡ʒ ɛ ɹ i
australian	ɔ s t ɹ ɛ l i ə n
biotite	b a ɪ ə t a ɪ t
exactly	ɪ ɡ z æ k t l i
pettywhin	p ɛ t i w ɪ n
gosplan	ɡ ɒ s p l æ n
dorty	d ɔ ɹ t i
vint	v ɪ n t
kilton	k ɪ l t ə n
tignish	t ɪ ɡ n ɪ ʃ
shalt	ʃ æ l t
attractant	ə t ɹ æ k t ə n t
saccharide	s æ k ə ɹ a ɪ d
juniperites	d͡ʒ u n ɪ p ə ɹ a ɪ t i s
radioactive	ɹ e ɪ d i o ʊ æ k t ɪ v
pathics	p æ θ ɪ k s
interpose	ɪ n t ɚ p o ʊ z
drossel	d ɹ ɒ s ə l
silhouette	s ɪ l uː w ɛ t
unsex	ʌ n s ɛ k s
head	h ɛ d
absentment	ə b s ɛ n t m ə n t
ge'ez	ɡ iː ɛ z
raspberry	ɹ æ z b ɛ ɹ i
comparably	k ɒ m p æ ɹ ə b l̩ i
janken	d͡ʒ ɒ ŋ k ɛ n
injections	ɪ n d͡ʒ ɛ k ʃ ə n s
ancient	e ɪ n ʃ ə n t
penang	p ə n ɑ ŋ
wenis	j uː n ə s
tobiano	t ə ʊ b i ɑː n ə ʊ
whicker	h w ɪ k ɚ
acculturate	ə k ʌ l t͡ʃ ə ɹ e ɪ t
nack	n æ k
adaptable	ə d æ p t ə b ə l
leapt	l ɛ p t
polynomial	p ɑ l i n o ʊ m i ə l
karakalpakstan	k ɑ ɹ ə k ɑ l p ɑ k s t æ n
leia	l e ɪ ə
maim	m e ɪ m
misotheist	m a ɪ s ə ʊ θ iː ɪ s t
acidic	ə s ɪ d ɪ k
grog	ɡ ɹ ɑ ɡ
slow	s l o ʊ
bassooned	b ə s uː n d
lupercus	l uː p ɜː ɹ k ə s
montezuma	m ɒ n t ɪ z uː m ə
influencer	ɪ n f l u ə n s ə ɹ
viscacha	v ɪ s k ɑ t͡ʃ ə
reminisce	ɹ ɛ m ə n ɪ s
capacify	k ə p æ s ɪ f a ɪ
hypospadias	h a ɪ p ə s p e ɪ d i ə s
hark	h ɑː ɹ k
impregnable	ɪ m p ɹ ɛ ɡ n ə b ə l
gustable	ɡ ʌ s t ə b ə l
lice	l a ɪ s
larve	l ɑː ɹ v
accretion	ə k ɹ i ʃ ə n
perturbate	p ɜː ɹ t ə ɹ b e ɪ t
annie	æ n i
interlanguage	ɪ n t ɜ ɹ l æ ŋ ɡ w ɪ d͡ʒ
paganism	p e ɪ ɡ ə n ɪ z m̩
caffs	k æ f s
dyslectic	d ɪ s l ɛ k t ɪ k
polylactide	p ɒ l i l æ k t a ɪ d
peril	p ɛ ɹ ɪ l
acampsia	ə k æ m p s i ə
salutatory	s ə l uː t ə t ɔː ɹ iː
govvy	ɡ ʌ v i
finely	f a ɪ n l i
doogh	d uː ɡ
sartorius	s ɑː ɹ t ɔː ɹ i ə s
weary	w ɪ ə ɹ i
vag	v æ d͡ʒ
stigmatize	s t ɪ ɡ m ə t a ɪ z
faciliatory	f ə s ɪ l i ə t o ɹ i
reneg	ɹ ɪ n e ɪ ɡ
chic	ʃ i k
shivering	ʃ ɪ v ə ɹ ɪ ŋ
soupçon	s uː p s ɒ n
biggs	b ɪ ɡ z
figgy	f ɪ ɡ i
academics	æ k ə d ɛ m ɪ k s
kate	k e ɪ t
pasilla	p ə s iː j ə
nief	n iː f
allied	æ l a ɪ d
kielbasa	k i l b ɑ s ə
chard	t͡ʃ ɑ ɹ d
glazes	ɡ l e ɪ z ɪ z
algedonic	æ l d͡ʒ ɪ d ɒ n ɪ k
meats	m iː t s
oolith	o ʊ ə l ɪ θ
olive	ɑ l ɪ v
peachy	p iː t͡ʃ i
tegmen	t ɛ ɡ m ə n
vegeburger	v ɛ d͡ʒ iː b ɜː ɹ ɡ ə ɹ
herpes	h ɚ p i z
galangal	ɡ ə l æ ŋ ɡ ə l
naught	n ɔ t
quadriplegia	k w ɑ d ɹ ɪ p l i d͡ʒ ə
tract	t ɹ æ k t
decima	d ɛ s ɪ m ə
afghan	æ f ɡ æ n
mysoped	m a ɪ s ə ʊ p ɛ d
epics	ɛ p ɪ k s
discus	d ɪ s k ə s
accusatorial	ə k j u z ə t ɔ ɹ i ə l
strikesthrough	s t ɹ æ ɪ k s θ ɹ u
tatar	t æ t ɑː ɹ
needs	n i d z
rorty	ɹ ɔː t i
fasces	f æ s iː z
amazingly	ə m e ɪ z ɪ ŋ l i
preferred	p ɹ ɪ f ɝ d
overvast	ə ʊ v ə b ɝ s t
nasal	n e ɪ z ə l
umbrage	ʌ m b ɹ ɪ d͡ʒ
haryana	h ɑː ɹ ɪ j ɑː n ə
gurge	ɡ ɜ ɹ d ʒ
ingredient	ɪ n ɡ ɹ iː d i ə n t
niding	n a ɪ d ɪ ŋ
kacapi	k ə t͡ʃ ɑ p i
knobbler	n ɑ b l ɚ
noon	n uː n
quefrency	k w i f ɹ ə n s i
blunderbuss	b l ʌ n d ɚ b ʌ s
aphorism	æ f ə ɹ ɪ z ə m
vexillology	v ɛ k s ə l ɑ l ə d͡ʒ i
derma	d ɜː ɹ m ə
hashish	h æ ʃ iː ʃ
armiger	ɑː ɹ m ɪ d͡ʒ ɚ
hohenzollern	h o ʊ ə n z ɑ l ə ɹ n
miltefosine	m ɪ l t ɛ f ə s i n
irritate	ɪ ɹ ɪ t e ɪ t
esture	ɛ s t j ʊ ə ɹ
slaver	s l e ɪ v ɚ
pitchfork	p ɪ t͡ʃ f ɔ ɹ k
gleeman	ɡ l iː m ə n
semeion	s ɪ m a ɪ ɒ n
winked	w ɪ ŋ k t
nunavut	n j uː n ə v uː t
puisne	p j u n i
stirred	s t ɝ d
basutoland	b ə s u t ə ʊ l æ n d
ectasis	ɛ k t ə s ɪ s
hypostatize	h a ɪ p ɒ s t ə t a ɪ z
vecuronium	v ɛ k j ə ɹ o ʊ n i ə m
hamartia	h æ m ɑ ɹ t iː ə
foreholding	f ɔ ɹ h o ʊ l d ɪ ŋ
daw	d ɔː
amalek	æ m ə l ɛ k
frowned	f ɹ a ʊ n d
forestal	f ɔ ɚ ɹ ə s t ə l
made	m e ɪ d
banker	b æ ŋ k ɚ
belts	b ɛ l t s
cunning	k ʌ n ɪ ŋ
gridlock	ɡ ɹ ɪ d l ɑ k
ended	ɛ n d ɪ d
existed	ɪ ɡ z ɪ s t ɪ d
skein	s k e ɪ n
sconce	s k ɑ n s
debug	d iː b ʌ ɡ
paum	p ɑː m
acclaims	ə k l e ɪ m z
proleptical	p ɹ ə ʊ l ɛ p t ɪ k ə l
sadist	s e ɪ d ɪ s t
shrining	ʃ ɹ a ɪ n ɪ ŋ
swire	s w a ɪ ə
occipitalis	ɑ k s ɪ p ə t e ɪ l ɪ s
skens	s k ɛ n z
petrine	p i t ɹ a ɪ n
festivus	f ɛ s t ɪ v ə s
comphet	k ɑ m p h ɛ t
nosel	n ə ʊ z ə l
ascorbate	ə s k ɔː ɹ b e ɪ t
arrival	ə ɹ a ɪ v ə l
some	s ʌ m
closh	k l ɒ ʃ
pledging	p l ɛ d͡ʒ ɪ ŋ
antics	æ n t ɪ k s
sesquipedalian	s ɛ s k w ɪ p ɪ d e ɪ l ɪ ə n
helve	h ɛ l v
mountainous	m a ʊ n t ə n ə s
knew	n j u ʊ̯
sleepiphany	s l ɛ p ɪ f ə n i
driscoll	d ɹ ɪ s k ə l
eyeglass	a ɪ ɡ l æ s
disgruntlement	d ɪ s ɡ ɹ ʌ n t ə l m ɪ n t
confidant	k ɑ n f ɪ d ɑ n t
moguled	m o ʊ ɡ ə l d
ablaze	ə b l e ɪ z
hypocretin	h a ɪ p o ʊ k ɹ iː t ə n
evapotranspirational	ɪ v æ p o ʊ t ɹ æ n s p ɪ ɹ e ɪ ʃ ə n ə l
that	ð æ t
brine	b ɹ a ɪ n
sokushinbutsu	s ɒ k u ʃ ɪ n b ʊ t s uː
streetlet	s t ɹ iː t l ə t
miscreate	m ɪ s k ɹ ɪ e ɪ t
kinshasa	k ɪ n ʃ ɑː s ə
ketogenesis	k iː t ə ʊ d͡ʒ ɛ n ɪ s ɪ s
smuthound	s m ʌ t h a ʊ n d
accentor	ə k s ɛ n t ɚ
byssine	b ɪ s iː n
monotreme	m ɒ n ə t ɹ iː m
caressings	k ə ɹ ɛ s ɪ ŋ z
careworn	k ɛ ə ɹ w ɔ ɹ n
agoraphobia	æ ɡ ɚ ə f o ʊ b i ə
dorothy	d ɔ ɹ ə θ i
frontonasal	f ɹ ʌ n t o ʊ n e ɪ z ə l
sambuq	s æ m b u k
alsatian	æ l s e ɪ ʃ ə n
oaten	ə ʊ t ə n
aknee	ə n iː
sain	s e ɪ n
chomophyte	k ə ʊ m ə ʊ f a ɪ t
preposterous	p ɹ ə p ɑ s t ə ɹ ə s
pipradol	p ɪ p ɹ ə d ɒ l
pastel	p æ s t ɛ l
tait	t e ɪ t
rbar	ɹ iː b ɑ ɹ
immitigable	ɪ m ɪ t ɪ ɡ ə b ə l
draw	d ɹ ɔ
granary	ɡ ɹ e ɪ n ə ɹ i
thereabout	ð ɛ ɹ ə b a ʊ t
object	ɑ b d͡ʒ ɛ k t
niobe	n a ɪ o ʊ b i
awesometastic	ɔ s m̩ t æ s t ɪ k
chromate	k ɹ ə ʊ m e ɪ t
monish	m ɒ n ɪ ʃ
equinoctial	iː k w ə n ɑ k ʃ ə l
omega	o ʊ m e ɪ ɡ ə
containment	k ə n t e ɪ n m ə n t
thorax	θ ɔ ɹ æ k s
sho	ʃ o ʊ
decision	d ɪ s ɪ ʒ ə n
erythremia	ɛ ɹ ɪ θ ɹ iː m i ə
kesteven	k ɛ s t ə v ə n
damned	d æ m d
quinquagenary	k w ɪ ŋ k w æ d͡ʒ ə n ɛ ɹ i
coaxes	k ə ʊ k s ɪ z
furl	f ɝ l
appear	ə p ɪ ɹ
thimbling	θ ɪ m b l ɪ ŋ
wandy	w ɒ n d i
gloomiest	ɡ l u m i ə s t
spic	s p ɪ k
skirl	s k ɜː l
envoi	ɑ n v ɔ ɪ
dudley	d ʌ d l i
corporate	k ɔ ɹ p ə ɹ e ɪ t
keene	k iː n
abstinence	æ b s t ɪ n ə n s
uncovered	ʌ n k ʌ v ɚ d
piazza	p i æ t s ə
honoree	ɑ n ɚ i
deluded	d ɪ l uː d ɪ d
eunice	j uː n ɪ s
pound	p a ʊ n d
crewkerne	k ɹ uː k ə ɹ n
apartheid	ə p ɑ ɹ t a ɪ d
manhood	m æ n h ʊ d
fart	f ɑ ɹ t
hexacosichoron	h ɛ k s ə ɪ k o ʊ s ɪ k o ʊ ɹ ɔ n
sirenomelia	s a ɪ ɹ ə n o ʊ m i l i ə
connects	k ə n ɛ k t s
boulevard	b ʊ l ə v ɑ ɹ d
too	t u
hummel	h ʌ m ə l
greeks	ɡ ɹ iː k s
suave	s w e ɪ v
culminate	k ʌ l m ə n e ɪ t
livor	l a ɪ v ɔ ə ɹ
polack	p o ʊ l ɑ k
perilla	p ə ɹ ɪ l ə
halts	h ɑ l t s
shooter	ʃ uː t ə ɹ
galoshes	ɡ ə l ɒ ʃ ɪ z
incumbent	ɪ n k ʌ m b ə n t
aramaic	æ ɹ ə m e i ɪ k
abductor	æ b d ʌ k t ɚ
incisiveness	ɪ n s a ɪ s ə v n ə s
alistair	æ l i s t ɚ
afresh	ʌ f ɹ ɛ ʃ
particularity	p ə ɹ t ɪ k j ə l ɛ ɹ ə t i
patten	p æ t ə n
multifurcate	m ʌ l t i f ɝ k e ɪ t
workmanship	w ɜː k m ə n ʃ ɪ p
admin	æ d m ɪ n
detrital	d i t ɹ a ɪ t ə l
understander	ə n d ɚ s t æ n d ɚ
rejoicing	ɹ ɪ d͡ʒ o ɪ s ɪ ŋ
carts	k ɑ ɹ t s
owler	a ʊ l ɚ
calmy	k ɑː m i
markovian	m ɑ ɹ k o ʊ v i ə n
dilate	d a ɪ l e ɪ t
deliberate	d ɪ l ɪ b ə ɹ e ɪ t
diock	d a ɪ ɑ k
denmark	d ɛ n m ɑ ɹ k
romansch	ɹ o ʊ m æ n ʃ
mawn	m ɔː n
drought	d ɹ a ʊ t
i'm	a ɪ m
albanian	æ l b e ɪ n i ə n
infringement	ɪ n f ɹ ɪ n d͡ʒ m ə n t
scrotum	s k ɹ o ʊ t ə m
dubbings	d ʌ b ɪ ŋ z
hicking	h ɪ k ɪ ŋ
stabilization	s t e ɪ b ə l a ɪ z e ɪ ʃ ə n
bergsonian	b ɜː ɹ ɡ s ə ʊ n ɪ ə n
parterre	p ɑː ɹ t ɛ ɚ
gimble	ɡ ɪ m b ə l
jamoke	d͡ʒ ə m ə ʊ k
calmer	k ɑː m ə
swelt	s w ɛ l t
anomic	ə n o ʊ m ɪ k
ethea	iː θ ɪ ə
westrip	w ɛ s t ɹ ɪ p
asonant	e ɪ̯ s o ʊ̯ n ə n t
loot	l uː t
throwendish	θ r ə ʊ ə n d ɪ ʃ
clinical	k l ɪ n ɪ k ə l
cuissard	k w i s ɑ ɹ d
cuajo	k w a h o
plethora	p l ɛ θ ə ɹ ə
aisle	a ɪ̯ l
reese	ɹ i s
divinization	d ɪ v ɪ n a ɪ z e ɪ ʃ ə n
perissology	p ɛ ɹ ɪ s ɒ l ə d͡ʒ i
abstinently	æ b s t ə n n̩ t l i
inhabitiveness	ɪ n h æ b ɪ t ɪ v n ə s
disbud	d ɪ s b ʌ d
pastime	p æ s t a ɪ m
betted	b ɛ t ə d
incapacitation	ɪ n k ə p æ s ɪ t e ɪ ʃ ə n
succame	s ə k e ɪ m
plausive	p l ɔː z ɪ v
unnerving	ʌ n n ɜː v ɪ ŋ
cloverleaf	k l o ʊ v ɚ l iː f
cannoli	k ə n o ʊ l i
theme	θ iː m
ichnusaite	ɪ k n u s ə a ɪ t
decking	d ɛ k ɪ ŋ
faiths	f e ɪ θ s
foist	f ɔ ɪ s t
flapping	f l æ p ɪ ŋ
readily	ɹ ɛ d ɪ l i
stiver	s t a ɪ v ə
serpentine	s ɝ p ə n t a ɪ n
einstein	a ɪ n s t a ɪ n
bubonic	b j uː b ɒ n ɪ k
bedmas	b ɛ d m æ s
tatting	t æ t ɪ ŋ
glastonbury	ɡ l æ s t ə n b ɹ i
disquisition	d ɪ s k w ə z ɪ ʃ ə n
gazump	ɡ ə z ʌ m p
ululate	j uː l j u l e ɪ t
continue	k ə n t ɪ n j uː
jiggle	d͡ʒ ɪ ɡ ə l
stringer	s t ɹ ɪ ŋ ɚ
rhythmlessly	ɹ ɪ ð m̩ l ə s l i
prof	p ɹ ɑ f
lapsarian	l æ p s ɛ ə ɹ ɪ ə n
polygynandry	p ɑ l i d͡ʒ ɪ n æ n d ɹ i
acalculia	e ɪ k æ l k j uː l i ə
abocclusion	æ b o ʊ k l u ʒ n̩
gauge	ɡ e ɪ d͡ʒ
cradle	k ɹ e ɪ d ə l
otolaryngologist	o ʊ t o ʊ l ɛ ɚ ɪ ŋ ɡ ɑ l ə d͡ʒ ɪ s t
buddhist	b u d ɪ s t
arty	ɑː ɹ t i
belly	b ɛ l i
phantasm	f æ n t æ z ə m
tumbril	t ʌ m b ɹ ɪ l
dastardly	d æ s t ɚ d l i
pail	p e ɪ l
absently	æ b s n̩ t l i
braked	b ɹ e ɪ k t
misfortune	m ɪ s f ɔ ɹ t͡ʃ ə n
prosodies	p ɹ ɑ s ə d i z
ivanhoe	a ɪ v ə n h o ʊ
aber	æ b ɚ
jacksonian	d͡ʒ æ k s o ʊ n i ə n
fengqiu	f ʌ ŋ t͡ʃ j o ʊ
pensive	p ɛ n s ɪ v
nimble	n ɪ m b l̩
privilege	p ɹ ɪ v ɪ l ɪ d͡ʒ
copier	k ɑ p i ɚ
legion	l iː d͡ʒ ə n
hygraulic	h a ɪ ɡ ɹ ɒ l ɪ k
supratrochlear	s u p ɹ ə t ɹ ɑ k l i ɚ
avian	e ɪ v i ə n
ankylosaur	æ ŋ k ə l o ʊ s ɔː r
earwitness	ɪ ɹ w ɪ t n ə s
neutrophile	n uː t ɹ o ʊ̯ f a ɪ̯ ɫ
verset	v ɚ s ə t
morris	m ɒ ɹ ɪ s
problemo	p ɹ ɑ b l e ɪ̯ m o ʊ̯
acanthopodous	æ k æ n θ ɑ p ə d ə s
cezve	d͡ʒ ɛ z v e ɪ
lust	l ʌ s t
jointed	d͡ʒ ɔ ɪ n t ɪ d
missouran	m ə z ɝ ə n
sapodilla	s æ p ə d ɪ l ə
steady	s t ɛ d i
shitkicker	ʃ ɪ t k ɪ k ə ɹ
niobium	n a ɪ o ʊ b i ə m
keys	k iː z
ain'tcha	e ɪ n t͡ʃ ə
stallon	s t æ l ə n
outlook	a ʊ t l ʊ k
mashup	m æ ʃ ʌ p
comfort	k ʌ m f ɚ t
prominence	p ɹ ɑ m ɪ n ə n s
blacon	b l e ɪ k ə n
innage	ɪ n ə d͡ʒ
accommodation	ə k ɑ m ə d e ɪ ʃ ə n
poussette	p uː s ɛ t
tsaric	z ɑ ɹ ɪ k
ultrapure	ʌ l t ɹ ə p j ɔ ɹ
self	s ɛ l f
avaunce	ə v ɑː n s
afterward	æ f t ɚ w ɚ d
spelk	s p ɛ l k
cleverness	k l ɛ v ɚ n ə s
faugh	f ɔː
cast	k æ s t
cletus	k l iː t ə s
endure	ɪ n d j ʊ ɹ
bacn	b e ɪ k ə n
decock	d i k ɔ k
leaching	l iː t͡ʃ ɪ ŋ
pungy	p ʌ ŋ i
rovibrational	ɹ ə ʊ v a ɪ b ɹ e ɪ ʃ ə n ə l
cameron	k æ m ə ɹ ə n
occultation	ɑ k ə l t e ɪ ʃ ə n
tomato	t ə m e ɪ t o ʊ
flexed	f l ɛ k s t
shitting	ʃ ɪ t ɪ ŋ
clowns	k l a ʊ n z
micronova	m a ɪ k ɹ o n o ʊ v ə
debye	d ə b a ɪ
vaward	v ɑː w ə d
delate	d ə l e ɪ t
congeniality	k ə n d͡ʒ iː n i æ l ɪ t i
abelam	ə b ə l ə m
clock	k l ɑ k
dietetician	d a ɪ ə t ɪ t ɪ ʃ ə n
snares	s n e ɚ z
prestigious	p ɹ ɛ s t i d͡ʒ ə s
fenoldopam	f ɪ n o ʊ l d ə p æ m
basheer	b ə ʃ i ɹ
pewing	p j uː ɪ ŋ
zed	z ɛ d
stoor	s t ɔ ɚ
intake	ɪ n t e ɪ k
ancestral	æ n s ɛ s t ə ɹ ə l
exchanged	ɛ k s t͡ʃ e ɪ n d͡ʒ d
pig	p ɪ ɡ
nuqta	n ʊ k t ə
lingual	l ɪ ŋ ɡ j u ə l
upsoar	ʌ p s ɔː ɹ
serum	s ɪ ɹ ə m
muggins	m ʌ ɡ ɪ n z
counsel	k a ʊ n s ə l
inalienable	ɪ n e ɪ l i ə n ə b ə l
sloane	s l o ʊ n
lino	l a ɪ n ə ʊ
baulk	b ɔ k
swatchel	s w ɒ t͡ʃ ə l
pactless	p æ k t l ə s
trientine	t ɹ a ɪ ɛ n t iː n
remeid	ɹ i m i d
jocularity	d͡ʒ ɑ k j ə l ɛ ɹ ɪ t i
disopyramide	d a ɪ s ə p ɪ ɹ ə m a ɪ d
rustacean	ɹ ʌ s t e ɪ ʃ ə n
ruritanian	ɹ ʊ ɹ ɪ t e ɪ n i ə n
apoaequorin	æ p ə ʊ iː k w ɔː ɹ ɪ n
stumble	s t ʌ m b ə l
yourself	j ɔ ɹ s ɛ l f
pleas	p l iː z
incitement	ɪ n s a ɪ t m ə n t
cousin	k ʌ z ə n
chloride	k l ɔ ɹ a ɪ d
stutter	s t ʌ t ɚ
tetracycline	t ɛ t ɹ ə s a ɪ k l iː n
eco	iː k ə ʊ
uncial	ʌ n s i ə l
obese	o ʊ b i s
dalmatian	d æ l m e ɪ ʃ ə n
ara	e ɪ ɹ ə
resinify	ɹ ɛ z ɪ n ə f a ɪ
fus'ha	f ʊ s h ə
cricoarytenoidei	k ɹ a ɪ k o ʊ æ ɹ ə t i n ɔ ɪ d i a ɪ
abelmosk	e ɪ b l m ɑ s k
norgestrel	n ɔ ɹ d͡ʒ ɛ s t ɹ ə l
lunatic	l uː n ə t ɪ k
homsi	h ɒ m s i
blin	b l ɪ n
treasure	t ɹ ɛ ʒ ɚ
wat	w æː t
caramel	k æ ɹ ə m ə l
enclave	ɑ n k l e ɪ v
coquette	k o ʊ k ɛ t
cruised	k ɹ uː z d
sicel	s ɪ k ə l
crumbs	k ɹ ʌ m z
revertent	ɹ ɪ v ɜː ɹ t ə n t
peta	p iː t ə
tyebble	t j ɛ b ə l
khata	k ɑ t ɑ
cacciatore	k ɑ t͡ʃ ə t ɔ ɹ i
lain	l e ɪ n
refoulement	ɹ ə f u l m ɑ n
flagstaff	f l æ ɡ s t æ f
reactionary	ɹ i æ k t͡ʃ ə n ɛ ɚ i
telepathy	t ə l ɛ p ə θ i
touchy	t ʌ t͡ʃ i
trekkie	t ɹ ɛ k i
blasphemy	b l æ s f ə m i
ordinary	ɔ ɹ d ɪ n ɛ ə ɹ i
pondicherry	p ɒ n d ɪ t ʃ ɛ ɹ i
lethe	l iː θ i
foolhardy	f u l h ɑ ɹ d i
amylin	æ m ə l ɪ n
oversevere	ə ʊ v ə s ɪ v ɪ ɹ
sink	s ɪ ŋ k
orthopedics	ɔ ɹ θ ə p i d ɪ k s
winkers	w ɪ ŋ k ɚ z
gravamen	ɡ ɹ æ v ə m ɛ n
netty	n ɛ t i
howdah	h a ʊ d ə
latecomer	l e ɪ t k ʌ m ɚ
glorify	ɡ l ɔ ɹ ɪ f a ɪ
languid	l æ ŋ ɡ w ə d
misguilt	m ɪ s ɡ ɪ l t
hanky	h æ ŋ k i
watchlist	w ɔ t͡ʃ l ɪ s t
ratisbon	ɹ æ t ɪ z b ɑ n
johannes	d ʒ ə ʊ h æ n ɪ s
signification	s ɪ ɡ n ɪ f ɪ k e ɪ ʃ ə n
roaming	ɹ o ʊ m ɪ ŋ
illusory	ɪ l uː s ə ɹ i
delage	d ə l a ʒ
sandwich	s æ n d w ɪ d͡ʒ
such	s ʌ t͡ʃ
greatsword	ɡ ɹ e ɪ t s ɔ ɹ d
bushy	b ʊ ʃ i
boast	b o ʊ s t
savagery	s æ v ɪ d͡ʒ ɹ ɪ
heaumes	h ə ʊ m z
morpheus	m ɔ ɹ f j u s
preëmptory	p ɹ iː ɛ m p t ə ɹ i
shocking	ʃ ɑ k ɪ ŋ
evans	ɛ v ə n z
rasorial	ɹ ə s ɔː ɹ ɪ ə l
militarily	m ɪ l ɪ t ɛ ɹ ə l i
evaluative	ɪ v æ l j u ə t ɪ v
hettotype	h ɛ t ə t a ɪ p
babm	b ɔ ɑː b ɔ m u
seguin	s ə ɡ iː n
karin	k æ r ɪ n
gymnasium	d͡ʒ ɪ m n e ɪ z i ə m
concave	k ɑ n k e ɪ v
revise	ɹ ɪ v a ɪ̯ z
ockendon	o k ɪ n d ə n
stardom	s t ɑ ɹ d ə m
cribbings	k ɹ ɪ b ɪ ŋ z
fact	f æ k t
hope	h o ʊ p
picul	p ɪ k ə l
soldanrie	s o ʊ l d ə n ɹ i
clotrimazole	k l o ʊ t ɹ a ɪ m ə z o ʊ l
stasi	s t ɑː z i
authorized	ɔ θ ə ɹ a ɪ z d
promiscuous	p ɹ ə m ɪ s k j u ə s
sanskrit	s æ n s k ɹ ɪ t
richard	ɹ ɪ t͡ʃ ɚ d
calumny	k æ l ə m n i
laisse	l e ɪ s
voluntary	v ɑ l ə n t ɛ ɹ i
delirate	d ɛ l ɪ ɹ e ɪ t
regionally	ɹ iː d͡ʒ n ə l i
ackee	æ k iː
piecemeal	p iː s m iː l
cueing	k j uː ɪ ŋ
runway	ɹ ʌ n w e ɪ
bucha	b uː t͡ʃ ə
acoelomic	e ɪ s iː l ɒ m ɪ k
deign	d e ɪ n
astral	æ s t ɹ ə l
namur	n ə m ʊ ə ɹ
amma	ʌ m ə
zizania	z ɪ z e ɪ n i ə
gouges	ɡ a ʊ d͡ʒ ə z
panipuri	p ɑ n i p ʊ ɹ i
vada	v ɑː d ə
baritsu	b ɑː ɹ ɪ t s uː
epidermis	ɛ p ə d ɝ m ə s
nationwide	n e ɪ ʃ ə n w a ɪ d
glyceride	ɡ l ɪ s ə ɹ a ɪ d
adage	æ d ɪ d͡ʒ
weekend	w i k ɛ n d
acaricide	ə k ɛ ɹ ə s i d
quadraturist	k w ɒ d ɹ ə t͡ʃ ə ɹ ɪ s t
weazen	w iː z ə n
tsuyuharai	t s uː j uː h ɑː ɹ a ɪ
tyrant	t a ɪ ɹ ə n t
erythrocyte	ə ɹ ɪ θ ɹ ə s a ɪ t
bowery	b a ʊ ə ɹ i
outermost	a ʊ t ɚ m o ʊ s t
reify	ɹ e ɪ ə f a ɪ
aniseed	æ n ɪ s i d
sports	s p ɔ ɹ t s
depressant	d ɪ p ɹ ɛ s ə n t
entertainer	ɛ n t ə t e ɪ n ə
lpwan	ɛ l p iː w æ n
fascinum	f æ s ɪ n ə m
stupid	s t j u p ɪ d
filenames	f a ɪ l n e ɪ m s
boneseeker	b o ʊ n s i k ɚ
arrives	ə ɹ a ɪ v z
roaring	ɹ ɔː ɹ ɪ ŋ
peabody	p i b ɑ d i
cairns	k ɛ ɹ n z
truculent	t ɹ ʌ k j ʊ l ə n t
anaptyxis	æ n ə p t ɪ k s ɪ s
uotsuri	uː o ʊ t s ʊ ə ɹ i
flang	f l æ ŋ
feud	f j uː d
holofernes	h ɑː l ə f ɝː n iː z
digitigrade	d ɪ d͡ʒ ə t ə ɡ ɹ e ɪ d
sully	s ʌ l i
immoved	ɪ m uː v d
mariah	m ə ɹ a ɪ ə
tetraeteris	t ɛ t r ə ɛ d ə r ə s
factice	f æ k t ɪ s
adenines	æ d ɪ n ɪ n z
premarin	p ɹ ɛ m ə ɹ ɪ n
serpette	s ɜː ɹ p ɛ t
announcement	ə n a ʊ n s m ɛ n t
destruction	d ɪ s t ɹ ʌ k ʃ ə n
western	w ɛ s t ɚ n
tender	t ɛ n d ə
legally	l iː ɡ ə l i
categories	k æ t ə ɡ ɔ ɹ i z
furnished	f ɝ n ɪ ʃ t
eep	i p
schwa	ʃ w ɑ
towards	t o ʊ ɚ d z
urged	ɝ d͡ʒ d
xenopsychiatry	z ɛ n ə ɛ θ s a ɪ k a ɪ ə t ɹ i
diamide	d a ɪ e ɪ m a ɪ d
greater	ɡ ɹ e ɪ t ə ɹ
fibulares	f ɪ b j ə l ɛ ɹ i z
mishmash	m ɪ ʃ m æ ʃ
biokinesis	b a ɪ o ʊ k ɪ n i s ɪ s
xeriscape	z ɛ ɹ ə s k e ɪ p
pastings	p e ɪ s t ɪ ŋ z
trioecious	t r a ɪ iː ʃ ɪ ə s
quibble	k w ɪ b ə l
baddams	b æ d ə m z
clit	k l ɪ t
therapeutic	θ ɛ ɹ ə p j uː t ɪ k
lazarus	l æ z ə ɹ ə s
regulator	ɹ ɛ ɡ j u l e ɪ t ɚ
whaler	w e ɪ l ɚ
daemon	d e ɪ m ə n
cumbric	k ʌ m b ɹ ɪ k
donepezil	d o ʊ n ɛ p ə z ɪ l
dalteparin	d ɔ l t ɛ p ə ɹ ɪ n
bolster	b o ʊ l s t ɚ
bagger	b æ ɡ ɚ
landover	l æ n d o ʊ v ə ɹ
descent	d i s ɛ n t
cautiouser	k ɔː ʃ ə s ə ɹ
vow	v a ʊ
parson	p ɑ ɹ s ə n
cooties	k uː t i z
beatlesque	b iː t ə l ɛ s k
superhabitable	s u p ɚ h æ b ɪ t ə b l̩
chark	t͡ʃ ɑː ɹ k
filet	f ɪ l e ɪ
aevum	i v ə m
amaranth	æ m ə ɹ æ n θ
blacker	b l æ k ɚ
debugger	d i b ʌ ɡ ə ɹ
infliction	ɪ n f l ɪ k ʃ ə n
hexings	h ɛ k s ɪ ŋ z
skive	s k a ɪ v
misluck	m ɪ s l ʌ k
tufty	t ʌ f t i
israelite	ɪ z ɹ e ɪ ə l a ɪ t
military	m ɪ l ɪ t ɛ ɹ i
todd	t ɑ d
ryelage	ɹ a ɪ l ɪ d͡ʒ
lingala	l ɪ ŋ ɡ ɑː l ə
trucks	t ɹ ʌ k s
production	p ɹ ə d ʌ k ʃ ə n
choral	k ɔ ɹ ə l
goosefoot	ɡ uː s f ʊ t
quim	k w ɪ m
hunching	h ʌ n t͡ʃ ɪ ŋ
gibnut	ɡ ɪ b n ʌ t
trike	t ɹ a ɪ k
emigre	ɛ m ɪ ɡ ɹ e ɪ
synonym	s ɪ n ə n ɪ m
sympiezometer	s ɪ m p i ɪ z ɒ m ɪ t ə
couch	k a ʊ t͡ʃ
aedeagus	i d i e ɪ ɡ ə s
remission	ɹ ə m ɪ ʃ ə n
unakas	j u n e ɪ k ə z
peaceful	p iː s f ə l
asweve	ə s w iː v
soda	s o ʊ d ə
masturbatory	m æ s t ɚ b ə t ɔː r i
linwood	l ɪ n w ʊ d
prepotent	p ɹ ɪ p o ʊ t ə n t
euphrates	j uː f ɹ e ɪ t iː z
abietene	æ b i ə t i n
dover	d o ʊ v ɚ
acetylcholine	ə s i t ə l k o ʊ l i n
whether	w ɛ ð ə ɹ
humvee	h ʌ m v iː
petrology	p ə t ɹ ɑ l ə d͡ʒ i
xenia	z iː n i ə
autumnal	ɔ t ʌ m n ə ɫ
complying	k ə m p l a ɪ ɪ ŋ
chillax	t͡ʃ ɪ l æ k s
petit	p ə t i
estonia	ɛ s t o ʊ n i ə
outlet	a ʊ t l ɛ t
homeless	h o ʊ m l ə s
attire	ə t a ɪ ɚ
climbed	k l a ɪ m d
necessity	n ɪ s ɛ s ə t i
hagiographer	h æ ɡ i ɑ ɡ ɹ ə f ɚ
anagoge	æ n ə ɡ o ʊ d͡ʒ i
accuses	ə k j uː z ɪ z
ammo	æ m o ʊ
tombal	t uː m b ə l
comprises	k ə m p ɹ a ɪ z ɪ z
fafia	f æ f i ə
eutrapely	j uː t ɹ æ p ə l ɪ
phac	p iː h æ k
adorb	ə d ɔ ɹ b
clitoral	k l ɪ t ɔ ɹ ə l
indexes	ɪ n d ɛ k s ɪ z
eschatology	ɛ s k ə t ɔ l ə d͡ʒ i
pizza	p iː t s ə
pitjantjatjara	p ɪ t͡ʃ ə n t͡ʃ ə t͡ʃ aː r ə
caliber	k æ l ə b ɚ
pizzazz	p ɪ z æ z
deidentify	d iː a ɪ d ɛ n t ɪ f a ɪ
fandub	f æ n d ʌ b
toughie	t ʌ f i
hasta	h æ s t ə
mineralogize	m ɪ n ə ɹ æ l ə d͡ʒ a ɪ z
askance	ə s k æ n s
interfrastically	ɪ n t ɚ f ɹ æ s t ɪ k ʌ l i
elytron	ɛ l ɪ t ɹ ɒ n
exultation	ɛ ɡ z ʌ l t e ɪ ʃ ə n
orchard	ɔ ɹ t͡ʃ ɚ d
teas	t iː z
penelope	p ɪ n ɛ l ə p i
finishings	f ɪ n ɪ ʃ ɪ ŋ z
redder	ɹ ɛ d ɚ
roseate	ɹ o ʊ z i ə t
buttercup	b ʌ t ɚ k ʌ p
carny	k ɑː ɹ n i
humdinger	h ʌ m d ɪ ŋ ɚ
rowlock	ɹ ɑ l ə k
chieftain	t͡ʃ iː f t ə n
vocales	v o ʊ k e ɪ l i z
danish	d e ɪ n ɪ ʃ
britannia	b ɹ ɪ t æ n ɪ ə
injuria	ɪ n d ʒ ʊ ə ɹ i ə
fleck	f l ɛ k
repent	ɹ iː p ə n t
woken	w o ʊ k ə n
fling	f l ɪ ŋ
whorlton	w ɔː ɹ l t ə n
oligophrenia	ɒ l ɪ ɡ o ʊ f ɹ iː n ɪ ə
menobranch	m ɛ n ə b ɹ æ ŋ k
hydrogenous	h a ɪ d ɹ ɑ d͡ʒ ə n ə s
totality	t o ʊ t æ l ɪ t i
wickiup	w ɪ k i ʌ p
adherence	ə d h ɪ ɹ ə n s
termini	t ɝ m ə n a ɪ
spatter	s p æ t ɚ
bill	b ɪ l
mylar	m a ɪ l ɑ ɹ
quietly	k w a ɪ ɪ t l i
extremities	ɪ k s t ɹ ɛ m ə t i z
personality	p ɝ s ə n æ l ɪ t i
hobart	h ə ʊ b ɑː t
handless	h æ n d l ə s
seriousness	s ɪ ɹ i ə s n ə s
kingdom	k ɪ ŋ d ə m
gambol	ɡ æ m b ə l
orbital	ɔ ɹ b ə t l̩
fledge	f l ɛ d͡ʒ
dilucidation	d ɪ l j uː s ɪ d e ɪ ʃ ə n
okie	o ʊ k i
ableism	e ɪ b ə l ɪ z m̩
haecceitist	h iː k s iː ə t ɪ s t
morbihan	m ɔː ɹ b i ə n
ebony	ɛ b ə n i
quiche	k iː ʃ
bacchant	b æ k ə n t
twelvemonth	t w ɛ l v m ʌ n θ
fip	f ɪ p
connecting	k ə n ɛ k t ɪ ŋ
chippendale	t͡ʃ ɪ p n̩ d e ɪ l
buckaroo	b ʌ k ə ɹ u
thanksgiving	θ æ ŋ k s ɡ ɪ v ɪ ŋ
recover	ɹ i k ʌ v ɚ
kyrgyzstan	k ɛː ɹ ɡ ɪ s t ɑː n
wreathe	ɹ iː ð
duckling	d ʌ k l ɪ ŋ
erythematoedematous	ɛ ɹ ə t h ɛ m ə t o ʊ ə d ɛ m ə t ə s
thimbled	θ ɪ m b ə l d
determinant	d ɪ t ɝ m ɪ n ə n t
puffling	p ʌ f l ɪ ŋ
declaring	d ɪ k l ɛ ɹ ɪ ŋ
walkthrough	w ɔː k θ ɹ uː
subtrahend	s ʌ b t ɹ ə h ɛ n d
turkey	t ɝ k i
labefaction	l æ b ə f æ k ʃ ə n
anatoli	æ n ə t o ʊ l i
academical	æ k ə d ɛ m ɪ k l̩
aureus	ɔː ɹ ɪ ə s
bedash	b ɪ d æ ʃ
undulant	ʌ n d͡ʒ ʊ l ə n t
standfield	s t æ n d f iː l d
rigging	ɹ ɪ ɡ ɪ ŋ
sever	s ɛ v ɚ
apt	æ p t
tsade	t s ɑː d e ɪ
anemia	ə n i m i ə
polytheism	p ɒ l ɪ θ iː ɪ z ə m
overran	o ʊ v ɚ ɹ a n
commonplace	k ɑ m ə n p l e ɪ s
haecceitistic	h iː k s iː ə t ɪ s t i k
communist	k ɑ m j u n ɪ s t
unbosom	ʌ n b ʊ z ə m
friend	f ɹ ɛ n d
indium	ɪ n d i ə m
despotic	d ɛ s p ɑ t ɪ k
flavorsome	f l e ɪ v ɚ s ə m
anguine	æ ŋ ɡ w ɪ n
indifferent	ɪ n d ɪ f ə ɹ ə n t
balrog	b æ l ɹ ɑ ɡ
mortal	m ɔ ɹ t ə l
wren	ɹ ɛ n
minigun	m ɪ n i ɡ ʌ n
châteaux	ʃ æː t o ʊ z
epaulement	e ɪ p o ʊ l m ɑ n t
piers	p ɪ ɹ z
romsey	ɹ ɒ m z i
cosmopoleis	k ɒ z m ɒ p ɒ l ɛ ɪ z
dipole	d a ɪ p o ʊ l
statutory	s t æ t͡ʃ ə t ɔ ɹ i
quarrel	k w ɔ ɹ ə l
viga	v iː ɡ ə
spell	s p ɛ l
malaxable	m ə l æ k s ə b ə l
baggage	b æ ɡ ɪ d͡ʒ
dissension	d ɪ s ɛ n ʃ ə n
slutsk	s l ʊ t s k
cheery	t͡ʃ ɪ ə ɹ i
humanist	h j uː m ə n ɪ s t
infinitesimal	ɪ n f ɪ n ɪ t ɛ s ɪ m ə l
abbotcy	æ b ə t s i
absaroke	æ b s o ɹ k i
commencement	k ə m ɛ n s m ə n t
cephalopod	s ɛ f a l a p ɑ d
dais	d e ɪ ɪ s
disinherit	d ɪ s ɪ n h ɛ ɹ ɪ t
clavichord	k l æ v ɪ k ɔ ɹ d
quartararo	k w ɔ ɹ t ə ɹ ɑː ɹ o ʊ
viable	v a ɪ ə b ə l
dentate	d ɛ n t e ɪ t
isogriv	a ɪ s o ʊ ɡ ɹ ɪ v
taqueria	t ɑ k ə ɹ iː ə
yawp	j ɔː p
psychotic	s a ɪ k ɒ t ɪ k
vie	v a ɪ
ingushetia	ɪ ŋ ɡ ʊ ʃ ɛ t i ə
oganesson	o ʊ ɡ ə n ɛ s ɒ n
gummings	ɡ ʌ m ɪ ŋ z
visceral	v ɪ s ɚ ə l
bentley	b e n t l iː
espresso	ɛ k s p ɹ ɛ s o ʊ
versipel	v ɜː s ɪ p ɛ l
bale	b e ɪ̯ l
paralipomenon	p æ ɹ ə l ɪ p ɒ m ɪ n ɒ n
backness	b æ k n ɪ s
jambeau	d͡ʒ æ m b o ʊ
bluntly	b l ʌ n t l i
scoop	s k uː p
disparadise	d ɪ s p æ ɹ ə d a ɪ s
doo	d u
url	j u ɑ ɹ ɛ l
jbiebs	d͡ʒ e ɪ b i b s
yardbird	j ɑ ɹ d b ɝ d
female	f iː m e ɪ l
sherman	ʃ ɜː ɹ m ə n
blamable	b l e ɪ m ə b ə l
punishing	p ʌ n ɪ ʃ ɪ ŋ
audrey	ɔː d ɹ i
resubject	ɹ iː s ə b d͡ʒ ɛ k t
scimitar	s ɪ m ɪ t ɑː ɹ
outwall	a ʊ t w ɔː l
epistemic	ɛ p ə s t e m ɪ k
hardscrabble	h ɑ ɹ d s k ɹ æ b ə l
gaga	ɡ ɑː ɡ ɑː
petite	p ə t iː t
publicly	p ʌ b l ɪ k l i
awaze	ɑ w ɑ z e ɪ
twinge	t w ɪ n d͡ʒ
wicked	w ɪ k t
reticulate	ɹ ə t ɪ k j u l e ɪ t
foredispose	f ɔː ɹ d ɪ s p ə ʊ z
quaich	k w e ɪ k
mondegreen	m ɑ n d ə ɡ ɹ iː n
jarrah	d͡ʒ æ ɹ ə
newfangled	n u f æ ŋ ɡ ə l d
micropaedic	m a ɪ k ɹ ə p i d i k
cefozopran	s ə f ɑ z ə p ɹ æ n
echo	ɛ k o ʊ
exorbitancy	ɪ ɡ z ɔː ɹ b ɪ t ə n s i
tokanui	t ɒ k ɑː n uː iː
poontang	p uː n t æ ŋ
countings	k a ʊ n t ɪ ŋ z
epicaricacy	ɛ p ɪ k æ ɹ ɪ k ə s i
cowslip	k a ʊ s l ɪ p
organisation	ɔ ɹ ɡ ə n ɪ z e ɪ ʃ ə n
reran	ɹ iː ɹ æ n
extrapsychic	ɛ k s t ɹ ə s a ɪ k ɪ k
runs	ɹ ʌ n z
broadsword	b ɹ ɔ d s ɔ ɹ d
dominical	d ə m ɪ n ə k ə l
chirurgical	k a ɪ ɹ ɜː ɹ d͡ʒ ɪ k ə l
oceany	o ʊ ʃ ə n i
wares	w ɛ ɹ z
hermeneutical	h ɝ m ə n j uː t ɪ k ə l
fraughan	f ɹ ɒ h ə n
teschenite	t ɛ ʃ ə n a ɪ t
broil	b ɹ ɔ ɪ l
salary	s æ l ɚ i
greens	ɡ ɹ iː n z
contort	k ə n t ɔː ɹ t
muntjac	m ʌ n t d͡ʒ æ k
harpagon	h ɑː ɹ p ə ɡ ɒ n
arthur	ɑ ɹ θ ɚ
hitched	h ɪ t͡ʃ t
hefemale	h i f i m e ɪ l
advent	æ d v ə n t
ventured	v ɛ n t͡ʃ ɚ d
mancipatory	m æ n s ɪ p e ɪ t ə ɹ i
fitzpatrick	f ɪ t s p æ t ɹ ɪ k
gibbet	d͡ʒ ɪ b ɪ t
foraminifer	f ɔ ɹ ə m ɪ n ə f ɚ
blackings	b l æ k ɪ ŋ z
yage	j ɑː h e ɪ
viviane	v ɪ v i æ n
pudge	p ʌ d͡ʒ
desires	d ɪ z a ɪ ɹ z
privative	p r ɪ v ə t ɪ v
thumbtack	θ ʌ m t æ k
kerygma	k ə ɹ ɪ ɡ m ə
deadline	d ɛ d l a ɪ n
karnataka	k ɑː ɹ n ɑː t ə k ə
climber	k l a ɪ m ɚ
futon	f u t ɑ n
alphas	æ ɫ f ə z
victims	v ɪ k t ɪ m z
asceticist	ə s ɛ t ə s ɪ s t
remixture	ɹ iː m ɪ k s t j ʊ ə ɹ
enthronize	ɛ n θ ɹ o ʊ n a ɪ z
intone	ɪ n t o ʊ n
nostril	n ɒ s t ɹ ə l
huffaz	h ʊ f ɑː z
broiler	b ɹ ɔ ɪ l ɚ
dictionary	d ɪ k ʃ ə n ɛ ɹ i
powldoody	p a ʊ l d uː d i
disulfiram	d a ɪ s ʌ l f ə ɹ æ m
raajmahal	r ɑː d͡ʒ m ə h ə l
eightieth	e ɪ t i ə θ
y'ave	j æ v
lote	l ə ʊ t
spittoon	s p ɪ t uː n
omnipresent	ɑ m n ɪ p ɹ ɛ z n̩ t
dishevelled	d ɪ s ʃ ɛ v ə l d
pines	p a ɪ n z
tanuki	t ɑ n u k i
scrab	s k ɹ æ b
judd	d͡ʒ ʌ d
risker	ɹ ɪ s k ə ɹ
add	æ d
thermometer	θ ɚ m ɑ m ɪ t ɚ
prenuptual	p ɹ i n ʌ p t͡ʃ w ə ɫ
enslave	ɪ n s l e ɪ v
phenylsilatrane	f ɛ n ɪ l s ɪ l ə t ɹ e ɪ n
virtue	v ɝ t͡ʃ u
complains	k ə m p l e ɪ n z
sue	s uː
salazar	s æ l ə z ɑ ɹ
reaction	ɹ i æ k ʃ ə n
acumination	ə k j uː m ɪ n e ɪ ʃ ə n
tearful	t ɪ ɹ f ə l
numberous	n ʌ m b ə ɹ ə s
football	f ʊ t b ɔ l
arbitration	ɑ ɹ b ɪ t ɹ e ɪ ʃ ə n
theogony	θ ɪ ɑː ɡ ə n ɪ
saccharoid	s æ k ə ɹ ɔ ɪ d
winetrough	w a ɪ n t ɹ ɔ f
abacost	æ b ə k ɑ s t
floor	f l o ɹ
cheese	t͡ʃ i z
brunch	b ɹ ʌ n t͡ʃ
slimebucket	s l a i m b ʌ k ɪ t
ferryl	f ɛ ɹ ə l
reterritorialization	ɹ iː t ɛ ɹ ɪ t ɔː ɹ i ə l a ɪ z e ɪ ʃ ə n
feelings	f iː l ɪ ŋ z
navvy	n æ v i
rested	ɹ ɛ s t ə d
paraparaumu	p a ɹ ə p a ɹ ə uː m uː
unmerited	ʌ n m ɛ ɹ ɪ t ɪ d
havant	h æ v ə n t
dick	d ɪ k
ostensive	ɒ s t ɛ n s ɪ v
honeysuckle	h ʌ n iː s ʌ k ə l
pulpit	p ʊ l p ɪ t
satisfaction	s æ t ɪ s f æ k ʃ ə n
fusospirochetal	f j uː z ə ʊ s p a ɪ ɹ ə ʊ k iː t ə l
gorget	ɡ o ɹ d͡ʒ ə t
snaked	s n e ɪ k t
parture	p ɑː ɹ t j ʊ ə ɹ
lever	l iː v ɚ
consonantal	k ɑ n s ə n æ n t ə l
pisciculture	p ɪ s ɪ k ʌ l t͡ʃ ə ɹ
requisite	ɹ ɛ k w ɪ z ɪ t
billet	b ɪ l ɪ t
rheumy	ɹ uː m i
report	ɹ ɪ p ɔ ɹ t
bebusy	b ɪ b ɪ z i
osborne	ɒ z b ɔː ɹ n
danicize	d e ɪ n ɪ s a ɪ z
geophyte	d͡ʒ i o ʊ f a ɪ t
ensue	ɪ n s uː
spurrier	s p ɝ ɹ i ɚ
subterranean	s ʌ b t ə ɹ e ɪ n i ə n
cried	k ɹ a ɪ d
ante	æ n t i
superomnipotence	s uː p ə ɹ ɒ m n ɪ p ə t ə n s
laryngitis	l ɛ ɹ ɪ n d͡ʒ a ɪ t ɪ s
purdah	p ɝ d ə
leapfrog	l iː p f ɹ ɑ ɡ
glyptology	ɡ l ɪ p t ɒ l ə d͡ʒ i
inceptive	ɪ n s ɛ p t ɪ v
spectral	s p ɛ k t ɹ ə ɫ
parthenon	p ɑː ɹ θ ə n ɑː n
myiasis	m a ɪ a ɪ ə s ɪ s
flabellate	f l ə b ɛ l ə t
liniment	l ɪ n ə m ə n t
subscriber	s ə b s k ɹ a ɪ b ɚ
sequelae	s ɪ k w iː l i
green	ɡ ɹ i n
righteousness	ɹ a ɪ t͡ʃ ə s n ə s
astrobleme	æ s t ɹ o ʊ b l i m
quadriplegic	k w ɑ d ɹ ɪ p l i d͡ʒ ɪ k
intricate	ɪ n t ɹ ɪ k e ɪ t
longevous	l ɔ n d͡ʒ iː v ə s
pulsate	p ʌ l s e ɪ t
abscondence	æ b s k ɑ n d n̩ s
strengthened	s t ɹ ɛ ŋ θ ə n d
brethren	b ɹ ɛ ð ɹ ə n
shortest	ʃ ɔ ɹ t ɪ s t
tenses	t ɛ n s ɪ z
siglum	s ɪ ɡ l ə m
adianoeta	e ɪ d a ɪ ə n ə ʊ iː t ə
woohoo	w uː h uː
pubs	p ʌ b z
firelock	f a ɪ ə ɹ l ɑ k
clinopyroxene	k l a ɪ n o ʊ p a ɪ ɹ ɑ k s i n
bavaroy	b æ v ə ɹ ɔ ɪ
abroad	ə b ɹ ɔ d
andersen	æ n d ə ɹ s ə n
verse	v ɝ s
grid	ɡ ɹ ɪ d
mown	m o ʊ n
tholeiite	θ o ʊ l i a ɪ t
twelvetide	t w ɛ l v t a ɪ d
hallucinogen	h ə l uː s ɪ n ə d͡ʒ e n
conscience	k ɑ n ʃ ə n s
argon	ɑː ɹ ɡ ɒ n
poise	p ɔ ɪ z
