bayawak	b a ˈj a w a k
pabor	p a ˈb o ɾ
Cobarrubias	k o b a ˈɾ u b j a s
luminis	l u ˈm i n i s
Arevalo	ʔ a ˈɾ e v a l o
malikhain	m a l i k ˈh a ʔ i n
Kuwaresma	k u a ˈɾ e s m a
propesyonalismo	p ɾ o p e s j o n a ˈl i s m o
ingkorporasyon	ʔ i ŋ k o ɾ p o ɾ a s ˈj o n
Lumibao	l u ˈm i b a w
mahinhin	m a h i n ˈh i n
sapak	s a ˈp a k
lamasin	l a ˈm a s i n
letsugas	l e ˈt͡ʃ u ɡ a s
panwelo	p a n ˈw e l o
milagro	m i ˈl a ɡ ɾ o
Collado	k o l ˈj a d o
kolehiyal	k o l e h i ˈa l
samo	ˈs a m o ʔ
mambabarang	ˌm a m b a ˈb a ɾ a ŋ
bibliyoteka	b i b l i o ˈt e k a
magaan	m a ɡ a ˈʔ a n
literatura	l i t e ɾ a ˈt u ɾ a
z	z i
Clemente	k l e ˈm e n t e
mamuhay	m a ˈm u h a j
entero	ʔ e n ˈt e ɾ o
teista	t e ˈi s t a
korido	k o ˈɾ i d o
rehente	ɾ e ˈh e n t e
ibabaan	ʔ i b a b a ˈʔ a n
patol	ˈp a t o l
pinansiyal	p i ˌn a n s i ˈa l
sigwasan	s i ɡ ˈw a s a n
Gabaldon	ɡ a b a l ˈd o n
pinapagtawanan	p i ˌn a p a ɡ t a w a ˈn a n
bulsa	b u l ˈs a
baligtad	b a l i ɡ ˈt a d
balimbing	b a l i m ˈb i ŋ
asog	ˈʔ a s o ɡ
matitibay	m a t i ˈt i b a j
Cu	ˈk u
Heminis	ˈh e m i n i s
Cavite	k a ˈv i t e
giwa	ˈɡ i w a ʔ
Odeste	ʔ o ˈd e s t e
Lascano	l a s ˈk a n o
sumunod	s u m u ˈn o d
konsumido	k o n s u ˈm i d o
bokya	ˈb o k j a ʔ
misis	ˈm i s i s
Montemayor	m o n t e m a ˈj o ɾ
bungaw	b u ˈŋ a w
halumigmig	h a l u m i ɡ ˈm i ɡ
makuha	m a ˈk u h a
butot	b u ˈt o t
langhap	l a ŋ ˈh a p
ermita	ʔ e ɾ ˈm i t a
bansalagin	b a n s a l a ˈɡ i n
kakabig	k a ˈk a b i ɡ
bansot	b a n ˈs o t
nabuwisit	n a b u ˈi s i t
pagerper	ˌp a ˈɡ e ɾ p e ɾ
luwang	l u ˈa ŋ
perspektiba	p e ɾ s p e k ˈt i b a
tsitsa	ˈt͡ʃ i t͡ʃ a
makaramdam	m a k a ɾ a m ˈd a m
eksperimento	ʔ e k s p e ɾ i ˈm e n t o
tako	ˈt a k o
hirol	ˈh i ɾ o l
Indotsina	ʔ i n d o ˈt͡ʃ i n a
alisangsang	ʔ a l i s a ŋ ˈs a ŋ
Libjo	l i b ˈh o ʔ
Gerda	ˈɡ e ɾ d a
baat	b a ˈʔ a t
sidlan	s i d ˈl a n
kanal	k a ˈn a l
mamutla	m a m u t ˈl a ʔ
trabahador	t ɾ a b a h a ˈd o ɾ
adiksiyon	ʔ a d i k s ˈj o n
batubalani	b a t u b a ˈl a n i ʔ
abyugin	ʔ a b j u ˈɡ i n
kompiyuteran	k o m p i ˈu t e ɾ a n
abuhin	ʔ a b u ˈh i n
adisyon	ʔ a d i s ˈj o n
kukis	ˈk u k i s
kandidatura	k a n d i d a ˈt u ɾ a
kawingan	k a ˈw i ŋ a n
duwag	d u ˈa ɡ
palaisipan	p a ˌl a ʔ i s i ˈp a n
himlay	h i m ˈl a j
entremetido	ʔ e n t ɾ e m e ˈt i d o
tupak	t u ˈp a k
parlamentaryo	p a ɾ l a m e n ˈt a ɾ j o
dinagipik	d i n a ˈɡ i p i k
Anunsiyasyon	ʔ a n u n s i a s ˈj o n
tugi	t u ˈɡ i ʔ
hukuman	h u ˈk u m a n
Mallare	m a l ˈj a ɾ e
dagasa	d a ɡ a ˈs a ʔ
iresponsable	ʔ i r e s p o n ˈs a b l e
Diamante	d j a ˈm a n t e
megalomanya	m e ɡ a l o ˈm a n j a
sidhi	s i d ˈh i ʔ
Tiongco	t i ˈo ŋ k o
manlait	m a n ˈl a ʔ i t
gabay	ɡ a ˈb a j
singaw	s i ˈŋ a w
gusilaw	ɡ u ˈs i l a w
kudlong	k u d ˈl o ŋ
Closa	ˈk l o s a
konektado	k o n e k ˈt a d o
GRO	ˈd j i ʔ a ɾ ʔ o
pagkaigkasin	p a ɡ k a ʔ i ɡ ˈk a s i n
Lubiano	l u b ˈj a n o
kumpensasyon	k u m p e n s a s ˈj o n
malakas	m a l a ˈk a s
diyablo	d i ˈa b l o
hangganan	h a ŋ ˈɡ a n a n
Layco	ˈl a j k o
Aliga	ʔ a ˈl i ɡ a
taglamig	t a ɡ l a ˈm i ɡ
Kaprikorniyo	k a p ɾ i ˈk o ɾ n j o
maski	m a s ˈk i
enagwas	ʔ e ˈn a ɡ w a s
kinyang	k i n ˈj a ŋ
arkitektura	ʔ a ɾ k i t e k ˈt u ɾ a
masikip	m a s i ˈk i p
kilitis	k i l i ˈt i s
habulan	h a b u ˈl a n
sawil	s a ˈw i l
masamid	m a s a ˈm i d
disko	ˈd i s k o
parinlas	p a ˈɾ i n l a s
labanderiya	l a ˌb a n d e ˈɾ i a
pasma	p a s ˈm a
hawsyaw	ˈh a w s j a w
orasyon	ʔ o ɾ a s ˈj o n
Maranan	m a ˈɾ a n a n
Singgapur	s i ŋ ɡ a ˈp u ɾ
eskapularyo	ʔ e s k a p u ˈl a ɾ j o
peryodista	p e ɾ j o ˈd i s t a
gatilyo	ɡ a ˈt i l j o
burak	ˈb u ɾ a k
bini	ˈb i n i ʔ
bulo	b u ˈl o ʔ
tangay	t a ˈŋ a j
humiram	h u m i ˈɾ a m
ibinigay	ʔ i b i n i ˈɡ a j
dupa	d u ˈp a ʔ
pison	p i ˈs o n
kurot	k u ˈɾ o t
Asistio	ʔ a ˈs i s t j o
kabinet	ˈk a b i n e t
kuros	k u ˈɾ o s
yumanig	j u m a ˈn i ɡ
Sarenas	s a ˈɾ e n a s
primo	ˈp ɾ i m o
Barbie	ˈb a ɾ b i
timayok	t i ˈm a j o k
letson	l e ˈt͡ʃ o n
ruwina	ɾ u ˈi n a
Pansol	p a n ˈs o l
sambong	s a m ˈb o ŋ
kakanin	k a k a ˈn i n
apak	ˈʔ a p a k
sisid	ˈs i s i d
matangkad	m a t a ŋ ˈk a d
Awstralya	ʔ a w s ˈt ɾ a l j a
Tagaytay	t a ɡ a j ˈt a j
Ruedas	ɾ u ˈe d a s
magbasanlot	m a ɡ b a s a n ˈl o t
mahalaga	m a h a l a ˈɡ a
ipatapon	ʔ i p a ˈt a p o n
sinturon	s i n t u ˈɾ o n
linggatong	l i ŋ ˈɡ a t o ŋ
kugita	k u ˈɡ i t a ʔ
tabi	t a ˈb i
haltak	h a l ˈt a k
polaynas	p o ˈl a j n a s
dale	ˈd a l e
kalamismis	k a l a m i s ˈm i s
Maloles	m a ˈl o l e s
isakay	ʔ i s a ˈk a j
balo	ˈb a l o
tsang	ˈt͡ʃ a ŋ
Katoliko	k a ˈt o l i k o
Pinagkaisahan	p i n a ɡ k a ʔ i s a ˈh a n
Llanera	l j a ˈn e ɾ a
dibdibin	d i b d i ˈb i n
demokrasya	d e m o ˈk ɾ a s j a
sugapa	s u ˈɡ a p a ʔ
kasero	k a ˈs e ɾ o
kutsukutso	k u ˌt͡ʃ u k u ˈt͡ʃ o
ubo	ʔ u ˈb o
halimbawa	h a l i m ˈb a w a ʔ
mamilis	m a m i ˈl i s
Sin	ˈs i n
Summer	ˈs a m e ɾ
muhala	m u ˈh a l a ʔ
mamaya	m a m a ˈj a ʔ
gumuho	ɡ u ˈm u h o ʔ
taludtod	t a l u d ˈt o d
lalawigan	l a l a ˈw i ɡ a n
onlayn	ˈʔ o n l a j n
kumbulsiyon	k u m b u l s i ˈo n
taympers	ˈt a j m p e ɾ s
Manilenya	m a n i ˈl e n j a
maghati	m a ɡ ˈh a t i ʔ
kapansanan	k a p a n ˈs a n a n
opresyon	ʔ o p ɾ e s ˈj o n
peram	ˈp e ɾ a m
pamamahagi	p a m a m a ˈh a ɡ i ʔ
suhol	ˈs u h o l
kriket	ˈk ɾ i k e t
ragsak	ɾ a ɡ ˈs a k
alipin	ʔ a ˈl i p i n
bilugan	b i l u ˈɡ a n
radyo	ˈɾ a d j o
cato	k a ˈt o
misayl	ˈm i s a j l
mabalasik	m a b a ˈl a s i k
rebelyon	ɾ e b e l ˈj o n
dagison	d a ˈɡ i s o n
iring	ˈʔ i ɾ i ŋ
talang	ˈt a l a ŋ
NAPOLCOM	ˈn a p o l k o m
manloloko	m a n l o ˈl o k o
budhi	b u d ˈh i ʔ
mangalandakan	m a ŋ a l a n ˈd a k a n
katha	k a t ˈh a ʔ
Tumacder	t u ˈm a k d e ɾ
botelya	b o ˈt e l j a
muyangit	m u ˈj a ŋ i t
umusbong	ʔ u m u s ˈb o ŋ
Mañalac	m a ˈɲ a l a k
alahero	ʔ a l a ˈh e ɾ o
kaalit	k a ˈʔ a l i t
maabo	m a ʔ a ˈb o
sisne	ˈs i s n e
dengge	ˈd e ŋ ɡ e
karelyebo	k a ɾ e l ˈj e b o
kabukiran	k a b u ˈk i ɾ a n
sabi	ˈs a b i
tabatsingtsing	t a b a ˈt͡ʃ i ŋ t͡ʃ i ŋ
tarang	t a ˈɾ a ŋ
sikolohiya	s i k o l o ˈh i a
ortograpiya	ʔ o ɾ t o ɡ ɾ a ˈp i a
haro	ˈh a ɾ o
Soledad	s o l e ˈd a d
marites	ˈm a ɾ i t e s
heneral	h e n e ˈɾ a l
Kankanaey	k a n k a ˈn a ʔ e j
baniaga	b a n ˈj a ɡ a ʔ
Cueto	k u ˈe t o
yakyak	j a k ˈj a k
lahi	ˈl a h i ʔ
imoralidad	ʔ i m o ɾ a l i ˈd a d
daungan	ˌd a ˈʔ u ŋ a n
desente	d e ˈs e n t e
magkaaway	m a ɡ k a ˈʔ a w a j
magkasakit	m a ɡ k a s a ˈk i t
burol	b u ˈɾ o l
adres	ˈʔ a d ɾ e s
traidor	t ɾ a j ˈd o ɾ
palpak	p a l ˈp a k
melokoton	m e l o k o ˈt o n
sentido	s e n ˈt i d o
ayon	ˈʔ a j o n
pagalingin	p a ɡ a l i ˈŋ i n
lambanog	l a m b a ˈn o ɡ
santelmo	s a n ˈt e l m o
karangalan	k a ɾ a ˈŋ a l a n
Vigan	ˈv i ɡ a n
iskul	ʔ i s ˈk u l
tao	ˈt a ʔ o
talibas	t a l i ˈb a s
almirol	ʔ a l m i ˈɾ o l
balinsasayaw	b a ˌl i n s a s a ˈj a w
Ann	ˈʔ a n
siwang	ˈs i w a ŋ
Marulas	m a ɾ u ˈl a s
linisan	l i ˈn i s a n
sibika	ˌs i b i ˈk a
Banaag	b a ˈn a ʔ a ɡ
Bajado	b a ˈh a d o
deliryo	d e ˈl i ɾ j o
nagnanakaw	n a ɡ n a ˈn a k a w
bubuweltahan	b u b u ˌe l t a ˈh a n
inggit	ʔ i ŋ ˈɡ i t
pagkasuplado	p a ɡ k a s u p ˈl a d o
pribilehiyo	p ɾ i b i ˈl e h i o
pintor	p i n ˈt o ɾ
rotonda	ɾ o ˈt o n d a
'di	d i ʔ
tuna	t u ˈn a ʔ
kita	k i ˈt a
panahon	p a n a ˈh o n
pampanitikan	p a m ˈp a n i t i k a n
Nadine	n a ˈd i n
limay	ˈl i m a j
talunton	t a l u n ˈt o n
hapit	ˈh a p i t
balita	b a ˈl i t a ʔ
Soliven	s o l i ˈv e n
kampanaryo	k a m p a ˈn a ɾ j o
seks	ˈs e k s
bigtihin	b i ɡ t i ˈh i n
nakainom	n a k a ʔ i ˈn o m
uway	ʔ u ˈa j
hapay	h a ˈp a j
magkuwenta	m a ɡ k u ˈe n t a
magbababoy	m a ɡ b a b a ˈb o j
Munsayac	m u n s a ˈj a k
bayad	ˈb a j a d
Dionisio	d j o ˈn i s j o
tonelada	t o n e ˈl a d a
Elizaga	ʔ e l i ˈz a ɡ a
madre	ˈm a d ɾ e
disaluyan	d i s a ˈl u j a n
gumimik	ɡ u ˈm i m i k
Tayabense	t a j a ˈb e n s e
tinig	ˈt i n i ɡ
dekorasyon	d e k o ɾ a s ˈj o n
burahin	b u ɾ a ˈh i n
aksiyon	ʔ a k s i ˈo n
tindalo	t i n ˈd a l o ʔ
kaanib	k a ˈʔ a n i b
bigotilyo	b i ɡ o ˈt i l j o
balandra	b a ˈl a n d ɾ a
ekselensiya	ʔ e k s e ˈl e n s j a
angkan	ʔ a ŋ ˈk a n
ligamento	l i ɡ a ˈm e n t o
telepatiya	t e l e p a ˈt i a
tuma	ˈt u m a
bertebrado	b e ɾ t e b ˈɾ a d o
Aranda	ʔ a ˈɾ a n d a
sumpa	s u m ˈp a ʔ
bronse	ˈb ɾ o n s e
desilitro	d e s i ˈl i t ɾ o
pasukan	p a s u ˈk a n
responsable	ɾ e s p o n ˈs a b l e
piyesa	p i ˈe s a
mapanira	m a p a ˈn i ɾ a ʔ
Pagaspas	p a ɡ a s ˈp a s
ugnay	ʔ u ɡ ˈn a j
talupak	t a ˈl u p a k
Agusan	ʔ a ˈɡ u s a n
magkautang	m a ɡ k a ˈʔ u t a ŋ
akwaryum	ʔ a k ˈw a ɾ j u m
bumasa	b u ˈm a s a
Tarnate	t a ɾ ˈn a t e
DOLE	ˈd o l e
komplikasyon	k o m p l i k a s ˈj o n
manawagan	m a n a ˈw a ɡ a n
mayuldumo	m a j u l ˈd u m o
ahon	ˈʔ a h o n
kumapal	k u m a ˈp a l
bagal	ˈb a ɡ a l
elye	ˈʔ e l j e
lakre	ˈl a k ɾ e
prinsa	ˈp ɾ i n s a
kapas	ˈk a p a s
rehistro	ɾ e ˈh i s t ɾ o
tatagukan	t a t a ɡ u ˈk a n
bungbong	b u ŋ ˈb o ŋ
dagsa	d a ɡ ˈs a ʔ
Montecillo	m o n t e ˈs i l j o
personal	p e ɾ s o ˈn a l
Ragudo	ɾ a ˈɡ u d o
banyas	b a n ˈj a s
erehiya	ʔ e ɾ e ˈh i a
umawit	ʔ u ˈm a w i t
siyesta	s i ˈe s t a
abla	ˈʔ a b l a
'ka	ˈk a ʔ
utot	ʔ u ˈt o t
mangailangan	m a ŋ a ʔ i ˈl a ŋ a n
istorbo	ʔ i s ˈt o ɾ b o
pisan	ˈp i s a n
bumabahing	b u m a b a ˈh i ŋ
aplikasyon	ʔ a p l i k a s ˈj o n
rebulto	ɾ e ˈb u l t o
agwamarina	ʔ a ɡ w a m a ˈɾ i n a
Sariaya	s a ɾ ˈj a j a
lugo	l u ˈɡ o
Rajah	ˈɾ a h a
putok	p u ˈt o k
bira	b i ˈɾ a
asa	ˈʔ a s a
kabituinan	k a b i t u ʔ i ˈn a n
Buhain	b u ˈh a ʔ i n
Garcia	ɡ a ɾ ˈs i a
g̃	ŋ
Manaois	m a ˈn a w i s
paniniwala	p a n i n i ˈw a l a ʔ
sikologo	s i ˈk o l o ɡ o
tarik	t a ˈɾ i k
tanggi	t a ŋ ˈɡ i
katre	ˈk a t ɾ e
Ticzon	ˈt i k s o n
kupal	ˈk u p a l
huwataw	h u ˈa t a w
betis	ˈb e t i s
hagunot	h a ɡ u ˈn o t
maputik	m a ˈp u t i k
dolar	ˈd o l a ɾ
bahid	ˈb a h i d
dalubtala	d a ˌl u b ˈt a l a ʔ
alugin	ʔ a l u ˈɡ i n
anislag	ʔ a ˈn i s l a ɡ
tiyahin	t i ˈa h i n
oso	ˈʔ o s o
Hinduismo	h i n d u ˈi s m o
Yasmin	ˈj a s m i n
bigo	b i ˈɡ o ʔ
obhetibismo	ʔ o b h e t i ˈb i s m o
Pederio	p e ˈd e ɾ j o
labandera	l a b a n ˈd e ɾ a
tabas	ˈt a b a s
Weste	ˈw e s t e
kloropormo	k l o ɾ o ˈp o ɾ m o
gamutin	ɡ a m u ˈt i n
notaryo	n o ˈt a ɾ j o
Villamayor	v i l j a m a ˈj o ɾ
dalubituinan	d a ˌl u b i t u ʔ i ˈn a n
kisay	k i ˈs a j
panuwelo	p a n u ˈe l o
urang	ˈʔ u ɾ a ŋ
inaabisuhan	ʔ i n a ʔ a b i ˈs u h a n
suplay	s u p ˈl a j
Lucero	l u ˈs e ɾ o
pagnanakaw	p a ɡ n a ˈn a k a w
triduo	ˈt ɾ i d u ʔ o
mabulaklak	m a b u l a k ˈl a k
balde	b a l ˈd e
magmadali	m a ɡ m a d a ˈl i ʔ
inspektor	ʔ i n s p e k ˈt o ɾ
balikan	ˌb a ˈl i k a n
sandaigdigan	s a n d a ʔ i ɡ ˈd i ɡ a n
kubil	k u ˈb i l
sangkatauhan	s a ŋ k a t a ˈʔ u h a n
Dimailig	d i m a ˈʔ i l i ɡ
Juana	h u ˈa n a
bangkiling	b a ŋ k i ˈl i ŋ
semantika	s e ˌm a n t i ˈk a
kubtangkas	k u b t a ŋ ˈk a s
karbungkulo	k a ɾ ˈb u ŋ k u l o
empirisismo	ˌʔ e m p i ɾ i ˈs i s m o
lukto	l u k ˈt o ʔ
Estigoy	ʔ e s t i ˈɡ o j
puwente	p u ˈe n t e
kantot	k a n ˈt o t
yuko	j u ˈk o ʔ
ani	ˈʔ a n i
iglesya	ʔ i ɡ ˈl e s j a
guya	ˈɡ u j a ʔ
hinlog	h i n ˈl o ɡ
luoy	l u ˈʔ o j
okra	ˈʔ o k ɾ a
palaman	p a l a ˈm a n
ilot	ʔ i ˈl o t
Pekto	ˈp e k t o
kursonada	k u ɾ s o ˈn a d a
tabatsing	t a ˈb a t͡ʃ i ŋ
nanananghalian	n a n a n a ŋ h a ˈl i ʔ a n
lamod	ˈl a m o d
Borlaza	b o ɾ ˈl a z a
yukod	j u ˈk o d
tapos	t a ˈp o s
lumbay	l u m ˈb a j
magsuot	m a ɡ s u ˈʔ o t
sepelin	ˈs e p e l i n
bakawan	b a ˈk a w a n
pagakpak	p a ɡ a k ˈp a k
kalaswaan	k a l a s w a ˈʔ a n
kerosin	ˌk e ɾ o ˈs i n
Silayan	s i ˈl a j a n
husto	h u s ˈt o
dobolyu	ˈd o b o l j u
empleado	ʔ e m p l e ˈa d o
bakong	ˈb a k o ŋ
pasigan	p a ˈs i ɡ a n
maanak	m a ʔ a ˈn a k
masilya	m a ˈs i l j a
peste	ˈp e s t e
ibigay	ʔ i b i ˈɡ a j
oeste	ʔ o ˈe s t e
seradura	s e ɾ a ˈd u ɾ a
Artiaga	ʔ a ɾ t i ˈa ɡ a
lamat	ˈl a m a t
Carunungan	k a ɾ u ˈn u ŋ a n
pupu	ˈp u p u ʔ
gagad	ɡ a ˈɡ a d
magwahil	m a ɡ w a ˈh i l
ibenta	ʔ i ˈb e n t a
dokumentaryo	d o k u m e n ˈt a ɾ j o
waray	w a ˈɾ a j
pasilidad	p a s i l i ˈd a d
mambuwisit	m a m b u ˈi s i t
Katipunan	k a t i ˈp u n a n
marungis	m a ˈɾ u ŋ i s
hapis	ˈh a p i s
sinigwelas	s i n i ɡ ˈw e l a s
salalay	s a ˈl a l a j
kulit	k u ˈl i t
ikalawa	ʔ i k a l a ˈw a
Disyembre	d i s ˈj e m b ɾ e
Tupas	ˈt u p a s
Peñaflor	p e ɲ a ˈf l o ɾ
kidsulid	k i d ˈs u l i d
lantutay	l a n ˈt u t a j
bahagan	b a h a ˈɡ a n
banyo	ˈb a n j o
maarte	m a ˈʔ a ɾ t e
Epikureismo	ʔ e p i k u ɾ e ˈi s m o
klabos	ˈk l a b o s
lakbay	l a k ˈb a j
leopardo	l e o ˈp a ɾ d o
Yabut	ˈj a b u t
Kiamzon	k i ˈa m s o n
talas	ˈt a l a s
puna	p u ˈn a
Eloriaga	ʔ e l o ɾ ˈj a ɡ a
pananampalataya	p a n a n a m p a l a ˈt a j a
tumawag	t u ˈm a w a ɡ
punongkahoy	ˌp u n o ŋ ˈk a h o j
labis	ˈl a b i s
gahi	ˈɡ a h i ʔ
kuro	ˈk u ɾ o ʔ
ulnukalnangin	ʔ u l n u k a l n a ˈŋ i n
nagbabaon	n a ɡ b a ˈb a ʔ o n
Laylo	ˈl a j l o
relohero	ɾ e l o ˈh e ɾ o
pinirmahan	p i n i ɾ m a ˈh a n
Aragon	ʔ a ɾ a ˈɡ o n
sapul	s a ˈp u l
uso	ˈʔ u s o
mas	ˈm a s
ohetes	ʔ o ˈh e t e s
lambing	l a m ˈb i ŋ
Jaro	ˈh a ɾ o
wisik	w i ˈs i k
ladlad	l a d ˈl a d
humatsing	h u m a ˈt͡ʃ i ŋ
bertdey	ˈb e ɾ t d e j
Songco	ˈs o ŋ k o
agos	ˈʔ a ɡ o s
inam	ˈʔ i n a m
alog	ʔ a ˈl o ɡ
tsok	ˈt͡ʃ o k
Bolivar	b o ˈl i v a ɾ
buang	b u ˈʔ a ŋ
taklab	t a k ˈl a b
samain	s a m a ˈʔ i n
dilikas	d i l i ˈk a s
alimuran	ʔ a l i m u ˈɾ a n
hiwalay	h i w a ˈl a j
bisa	ˈb i s a ʔ
tuyo	t u ˈj o ʔ
wangis	ˈw a ŋ i s
panday	p a n ˈd a j
bra	ˈb ɾ a
haka	ˈh a k a ʔ
haspe	h a s ˈp e
lampong	l a m ˈp o ŋ
tayamutam	t a j a ˈm u t a m
maimot	m a ˈʔ i m o t
ligis	l i ˈɡ i s
nagkukuwento	n a ɡ k u k u ˈe n t o
maggiba	m a ɡ ɡ i ˈb a ʔ
magluto	m a ɡ ˈl u t o ʔ
Chedeng	ˈt͡ʃ e d e ŋ
signo	ˈs i ɡ n o
ekskomunikado	ʔ e k s k o m u n i ˈk a d o
Kapampangan	k a p a m ˈp a ŋ a n
estasyon	ʔ e s t a s ˈj o n
Balmes	ˈb a l m e s
mantala	m a n t a ˈl a
okasyon	ʔ o k a s ˈj o n
Cayabyab	k a j a b ˈj a b
Kristiyano	k ɾ i s t i ˈa n o
sisante	s i ˈs a n t e
Hau	ˈh a w
pulseras	p u l ˈs e ɾ a s
agnas	ʔ a ɡ ˈn a s
bisaklat	b i s a k ˈl a t
tilao	t i l a ˈʔ o
pintuan	p i n ˈt u ʔ a n
mami	ˈm a m i
abat	ʔ a ˈb a t
nagaganap	n a ɡ a ɡ a ˈn a p
gansal	ɡ a n ˈs a l
plantsa	ˈp l a n t͡ʃ a
kutsada	k u ˈt͡ʃ a d a
daluhaka	d a l u ˈh a k a ʔ
Ty	t i
tumulong	t u ˈm u l o ŋ
Haponesa	h a p o ˈn e s a
kamelyo	k a ˈm e l j o
masiba	m a ˈs i b a ʔ
lubang	ˈl u b a ŋ
Jara	ˈh a ɾ a
nakayukyok	n a k a j u k ˈj o k
paliguan	ˈp a l i ɡ u ʔ a n
abiso	ʔ a ˈb i s o
kuwento	k u ˈe n t o
samakatwid	s a m a k a t ˈw i d
analitika	ʔ a n a ˌl i t i ˈk a
apoy	ʔ a ˈp o j
Jalandoni	h a l a n ˈd o n i
asnan	ʔ a s ˈn a n
magyaya	m a ɡ ˈj a j a ʔ
sabak	ˈs a b a k
sodiyako	s o ˈd i a k o
Haw	ˈh a w
mulkaphay	m u l k a p ˈh a j
agoy	ˈʔ a ɡ o j
busilak	b u ˈs i l a k
krimen	ˈk ɾ i m e n
sunuran	ˌs u ˈn u ɾ a n
lapastanganin	l a p a s t a ˈŋ a n i n
talukab	t a ˈl u k a b
ᜊ	b a ˈb a ʔ
tikling	t i k ˈl i ŋ
bulalayak	ˌb u l a l a ˈj a k
pambihira	p a m b i ˈh i ɾ a ʔ
yumurak	j u ˈm u ɾ a k
teleserye	t e l e ˈs e ɾ j e
suweter	s u ˈe t e ɾ
bati	b a ˈt i ʔ
aberya	ʔ a b e ɾ ˈj a
panggang	p a ŋ ˈɡ a ŋ
gilid	ˈɡ i l i d
wis	ˈw i s
Basallote	b a s a l ˈj o t e
burara	b u ɾ a ˈɾ a ʔ
agulo	ʔ a ˈɡ u l o
Sobrepeña	s o b ɾ e ˈp e ɲ a
pusaw	p u ˈs a w
arok	ʔ a ˈɾ o k
bakuran	b a ˈk u ɾ a n
tokador	t o k a ˈd o ɾ
dayan	d a ˈj a n
talukbong	t a l u k ˈb o ŋ
sila	s i ˈl a
kubrekama	k u b ɾ e ˈk a m a
sentimo	ˌs e n t i ˈm o
buwagin	b u a ˈɡ i n
Magdangal	m a ɡ d a ˈŋ a l
sotanghon	ˈs o t a ŋ h o n
ulol	ʔ u ˈl o l
gaong	ˈɡ a ʔ o ŋ
patag	ˈp a t a ɡ
samaral	s a ˈm a ɾ a l
saksakin	s a k s a ˈk i n
X	ʔ e k s
hilaga	h i ˈl a ɡ a ʔ
ibangsilyo	ʔ i b a ŋ ˈs i l j o
ngakngak	ŋ a k ˈŋ a k
idroheno	ʔ i ˈd ɾ o h e n o
linatsay	l i n a ˈt͡ʃ a j
tate	t a ˈt e ʔ
tsarera	t͡ʃ a ˈɾ e ɾ a
terminal	ˌt e ɾ m i ˈn a l
pagkabigo	p a ɡ k a b i ˈɡ o ʔ
historikal	h i s t o ɾ i ˈk a l
Franco	ˈf ɾ a ŋ k o
anakroniko	ʔ a n a k ˌɾ o n i ˈk o
Pagdanganan	p a ɡ d a ˈŋ a n a n
barko	b a ɾ ˈk o
kendo	ˈk e n d o
Kurisma	k u ˈɾ i s m a
mawala	m a w a ˈl a ʔ
sinaing	s i ˈn a ʔ i ŋ
madamot	m a ˈd a m o t
panadero	p a n a ˈd e ɾ o
ospitalidad	ʔ o s p i t a l i ˈd a d
makita	m a ˈk i t a ʔ
agwahas	ʔ a ɡ ˈw a h a s
entusyasmo	ʔ e n t u s ˈj a s m o
kabaretista	k a b a ɾ e ˈt i s t a
obligasyon	ʔ o b l i ɡ a s ˈj o n
nanamantala	n a n a m a n t a ˈl a
taliba	t a ˈl i b a ʔ
likot	l i ˈk o t
varyant	ˈv a ɾ j a n t
hangad	h a ˈŋ a d
Montenegro	m o n t e ˈn e ɡ ɾ o
mangaliwa	m a ŋ a l i ˈw a ʔ
Inglesero	ʔ i ŋ ɡ l e ˈs e ɾ o
protina	p ɾ o ˈt i n a
lagislis	l a ɡ i s ˈl i s
giba	ɡ i ˈb a ʔ
miswa	ˈm i s w a
bihilante	b i h i ˈl a n t e
persigido	p e ɾ s i ˈɡ i d o
tambanggalan	t a m b a ŋ ɡ a ˈl a n
maanggo	m a ʔ a ŋ ˈɡ o
tapak	ˈt a p a k
puyat	ˈp u j a t
espantaho	ʔ e s p a n ˈt a h o
Nagtalon	n a ɡ ˈt a l o n
bagalan	b a ˈɡ a l a n
tagulamin	t a ɡ u l a ˈm i n
pekas	ˈp e k a s
dapithapon	ˌd a p i t ˈh a p o n
timpi	t i m ˈp i ʔ
satelayt	ˈs a t e l a j t
nagpapaubaya	n a ɡ p a p a ʔ u ˈb a j a ʔ
takip	t a ˈk i p
Clarence	ˈk l a ɾ e n s
bukana	b u ˈk a n a
tugya	t u ɡ ˈj a ʔ
ebakwasyon	ʔ e b a k w a s ˈj o n
ketongin	k e ˈt o ŋ i n
Geraldine	ˌd j e ɾ a l ˈd i n
senado	s e ˈn a d o
tipaklong	t i p a k ˈl o ŋ
limahi	l i m a ˈh i ʔ
inaanak	ʔ i ˌn a ʔ a ˈn a k
paboritismo	p a b o ɾ i ˈt i s m o
termos	ˈt e ɾ m o s
sawing	s a ˈw i ŋ
tagmangga	t a ɡ m a ŋ ˈɡ a
tagisuyo	t a ɡ i ˈs u j o ʔ
tekwan	ˈt e k w a n
madagta	m a d a ɡ ˈt a ʔ
Nagcarlan	n a ɡ k a ɾ ˈl a n
pulupito	p u ˈl u p i t o
balatik	b a l a ˈt i k
espongha	ʔ e s ˈp o ŋ h a
kapagka	k a p a ɡ ˈk a ʔ
abangan	ˌʔ a ˈb a ŋ a n
dagundong	d a ɡ u n ˈd o ŋ
kalyos	k a l ˈj o s
sundot	s u n ˈd o t
irebisa	ʔ i ɾ e b i ˈs a
upahan	ʔ u ˈp a h a n
ambubuyog	ʔ a m b u ˈb u j o ɡ
binibini	b i n i ˈb i n i
kuwa	k u ˈa ʔ
kooperasyon	k o ʔ o p e ɾ a s ˈj o n
yaon	j a ˈʔ o n
alangan	ʔ a l a ˈŋ a n
letmaku	ˈl e t m a k u
mangobra	m a ˈŋ o b ɾ a
kulugo	k u l u ˈɡ o
Fariñas	f a ˈɾ i ɲ a s
tinapa	t i n a ˈp a
singkamas	s i ŋ k a ˈm a s
heko	ˈh e k o
Majayjay	m a h a j ˈh a j
arsilya	ʔ a ɾ ˈs i l j a
Isko	ʔ i s ˈk o ʔ
barker	ˈb a ɾ k e ɾ
dagitban	d a ɡ i t ˈb a n
peluka	p e ˈl u k a
tsikot	t͡ʃ i ˈk o t
Moralde	m o ˈɾ a l d e
rito	ˈɾ i t o
Malibiran	m a l i ˈb i ɾ a n
par	ˈp a ɾ
Bascoguin	b a s ˈk o ɡ i n
Naomi	n a ˈj o w m i
sakramento	s a k ɾ a ˈm e n t o
Naujan	n a ʔ u ˈh a n
tumoma	t u ˈm o m a ʔ
bulilyaso	b u l i l ˈj a s o
datiles	ˌd a t i ˈl e s
umulit	ʔ u ˈm u l i t
isangkot	ʔ i s a ŋ ˈk o t
pastilyas	p a s ˈt i l j a s
gumising	ɡ u ˈm i s i ŋ
kabuwanan	k a b u ˈa n a n
sakal	s a ˈk a l
pulburon	p u l b u ˈɾ o n
langal	l a ˈŋ a l
kadugo	k a d u ˈɡ o ʔ
pananawagan	p a n a n a ˈw a ɡ a n
diyosesis	d i o ˈs e s i s
Nelson	ˈn e l s o n
Chiyoko	t͡ʃ i ˈo k o
lagayan	ˌl a ˈɡ a j a n
Banayad	b a ˈn a j a d
hupa	ˈh u p a ʔ
Anor	ʔ a ˈn o ɾ
brodkast	ˈb ɾ o d k a s t
tigmata	t i ɡ m a ˈt a
Banal	b a ˈn a l
Ala	ʔ a ˈl a
hanip	ˈh a n i p
malabnaw	m a l a b ˈn a w
retratista	ɾ e t ɾ a ˈt i s t a
ipakita	ʔ i p a ˈk i t a
dating	d a ˈt i ŋ
ulunan	ʔ u l u ˈn a n
kahelada	k a h e ˈl a d a
Setsuko	s e t ˈs u k o
kasulatan	k a s u l a ˈt a n
Vecino	v e ˈs i n o
libid	ˈl i b i d
manlibak	m a n l i ˈb a k
kosta	ˈk o s t a
mutya	m u t ˈj a ʔ
timbanin	t i m ˈb a n i n
labintador	l a b i n t a ˈd o ɾ
paraiso	p a ɾ a ˈʔ i s o
datung	d a ˈt u ŋ
kasera	k a ˈs e ɾ a
gawangan	ɡ a ˈw a ŋ a n
arsobispo	ʔ a ɾ s o ˈb i s p o
hayop	ˈh a j o p
sebekoy	ˌs e ˈb e k o j
Camarines	k a m a ˈɾ i n e s
sintomas	ˈs i n t o m a s
mamanhikan	m a m a n ˈh i k a n
lalagyan	l a l a ɡ ˈj a n
babaye	b a ˈb a j e
magpaskil	m a ɡ p a s ˈk i l
alalahanin	ʔ a l a l a ˈh a n i n
Bermudez	b e ɾ ˈm u d e s
olats	ˈʔ o l a t s
sota	ˈs o t a
tokaya	t o ˈk a j a
Olaguer	ʔ o l a ˈɡ e ɾ
hagulhol	h a ɡ u l ˈh o l
echosera	ʔ e t͡ʃ o ˈs e ɾ a
subla	s u b ˈl a
Asyano	ʔ a s ˈj a n o
propesora	p ɾ o p e ˈs o ɾ a
maghinala	m a ɡ h i ˈn a l a ʔ
pangadyi	p a ŋ a d ˈj i ʔ
umiintindi	ʔ u m i ʔ i n t i n ˈd i
pagkabata	p a ɡ k a ˈb a t a ʔ
Carreon	k a ɾ e ˈo n
payamanin	p a j a ˈm a n i n
irekomenda	ʔ i ɾ e k o m e n ˈd a
inyo	ʔ i n ˈj o
tagapagmana	t a ɡ a ˌp a ɡ ˈm a n a
lisa	l i ˈs a ʔ
mayaw	ˈm a j a w
kotamaya	k o t a ˈm a j a
koral	k o ˈɾ a l
palangiti	p a l a ŋ i ˈt i ʔ
oraryo	ʔ o ˈɾ a ɾ j o
ostiya	ˈʔ o s t j a
manigo	m a ˈn i ɡ o ʔ
kartesyano	ˌk a ɾ t e s ˈj a n o
akit	ˈʔ a k i t
akala	ʔ a ˈk a l a ʔ
biyolohiya	b i o l o ˈh i a
akurdiyon	ʔ a k u ɾ d i ˈo n
Domantay	d o m a n ˈt a j
madrama	m a ˈd ɾ a m a
Litwanya	l i t ˈw a n j a
sangandaan	s a ˌŋ a n d a ˈʔ a n
Romana	ɾ o ˈm a n a
singki	s i ŋ ˈk i ʔ
timos	ˈt i m o s
kamya	ˈk a m j a
Arnaiz	ʔ a ɾ ˈn a ʔ i s
matibay	m a ˈt i b a j
pulubi	p u ˈl u b i
amot	ˈʔ a m o t
ugaga	ʔ u ˈɡ a ɡ a ʔ
akbay	ʔ a k ˈb a j
panananim	p a n a n a ˈn i m
makipot	m a ˈk i p o t
ikabilanggo	ʔ i k a b i l a ŋ ˈɡ o ʔ
pakpak	p a k ˈp a k
Libra	ˈl i b ɾ a
ungkat	ʔ u ŋ ˈk a t
baisi	b a ˈʔ i s i ʔ
kasalukuyan	k a s a l u ˈk u j a n
matindi	m a t i n ˈd i
nobyo	ˈn o b j o
santa	ˈs a n t a
adelpa	ʔ a ˈd e l p a
manood	m a n o ˈʔ o d
Saog	ˈs a ʔ o ɡ
tekas	ˈt e k a s
tangke	t a ŋ ˈk e
lagim	l a ˈɡ i m
alaman	ʔ a ˈl a m a n
masaker	ˈm a s a k e ɾ
kritiko	ˈk ɾ i t i k o
mabagyo	m a b a ɡ ˈj o
imperatibo	ʔ i m p e ɾ a ˈt i b o
kristo	ˈk ɾ i s t o
kontralason	k o n t ɾ a ˈl a s o n
mestiso	m e s ˈt i s o
Irlandesa	ʔ i ɾ l a n ˈd e s a
Jaruda	h a ˈɾ u d a
Hayag	ˈh a j a ɡ
asawa	ʔ a ˈs a w a
'y	j
balbon	b a l ˈb o n
bigting	b i ɡ ˈt i ŋ
mainsekto	m a ʔ i n ˈs e k t o
dalawit	d a ˈl a w i t
alabwab	ʔ a l a b ˈw a b
iha	ˈʔ i h a
Ylagan	ʔ i ˈl a ɡ a n
maawain	m a ʔ a w a ˈʔ i n
bigti	b i ɡ ˈt i
Gatchalian	ɡ a t͡ʃ a l ˈj a n
kaliitan	k a l i ʔ i ˈt a n
alyado	ʔ a l ˈj a d o
tikoy	ˈt i k o j
uyom	ˈʔ u j o m
kepo	ˈk e p o
putspa	ˈp u t s p a
sapiro	ˈs a p i ɾ o
Binubusan	b i n u ˈb u s a n
magulat	m a ˈɡ u l a t
senador	s e n a ˈd o ɾ
yatyat	j a t ˈj a t
testamento	t e s t a ˈm e n t o
emosyon	ʔ e m o s ˈj o n
bulakbol	b u l a k ˈb o l
silidkatwan	s i ˌl i d k a t ˈw a n
Michiko	m i ˈt͡ʃ i k o
likaw	ˈl i k a w
Alabat	ʔ a l a ˈb a t
q	ˈk j u
nais	ˈn a ʔ i s
Aquino	ʔ a ˈk i n o
albahaka	ʔ a l b a ˈh a k a
Quimson	ˈk i m s o n
Maranaw	m a ɾ a ˈn a w
Luzviminda	l u z v i ˈm i n d a
bagnet	b a ɡ ˈn e t
tipuno	t i ˈp u n o ʔ
hibang	h i ˈb a ŋ
peseta	p e ˈs e t a
Dijamco	d i ˈh a m k o
soltada	s o l ˈt a d a
detalye	d e ˈt a l j e
lipa	l i ˈp a
awtor	ʔ a w ˈt o ɾ
saro	ˈs a ɾ o
bingwit	b i ŋ ˈw i t
lityo	ˈl i t j o
senyal	s e n ˈj a l
imbudo	ʔ i m ˈb u d o
samaya	s a m a ˈj a ʔ
kibit	k i ˈb i t
siyete	s i ˈe t e
elektrisista	ʔ e l e k t ɾ i ˈs i s t a
batchoy	b a ˈt͡ʃ o j
pikaporte	p i k a ˈp o ɾ t e
balda	b a l ˈd a
gapong	ɡ a ˈp o ŋ
utdo	ʔ u t ˈd o
palaso	p a l a ˈs o ʔ
lansang	l a n ˈs a ŋ
bugaw	ˈb u ɡ a w
tatap	t a ˈt a p
drama	ˈd ɾ a m a
budots	b u ˈd o t s
balse	ˈb a l s e
magkausap	m a ɡ k a ˈʔ u s a p
lakip	ˈl a k i p
Orendain	ʔ o ɾ e n d a ˈʔ i n
ebak	ˈʔ e b a k
Sarcia	ˈs a ɾ s j a
salik	ˈs a l i k
Triviño	t ɾ i ˈv i ɲ o
kalima	k a l i ˈm a
binhi	b i n ˈh i ʔ
masuwerte	m a s u ˈe ɾ t e
Caluya	k a ˈl u j a
petisyon	p e t i s ˈj o n
sadsad	s a d ˈs a d
tilasitha	t i l a s i t ˈh a ʔ
papagtawanan	ˌp a p a ɡ t a w a ˈn a n
Contreras	k o n ˈt ɾ e ɾ a s
magulo	m a ɡ u ˈl o
gawan	ɡ a ˈw a n
Baquiran	b a ˈk i ɾ a n
matiyaga	m a t j a ˈɡ a ʔ
biskonde	b i s ˈk o n d e
Abulencia	ʔ a b u ˈl e n s j a
turista	t u ˈɾ i s t a
suwerte	s u ˈe ɾ t e
ikalat	ʔ i ˈk a l a t
talulot	t a ˈl u l o t
tabak	t a ˈb a k
kasal	k a ˈs a l
es	ʔ e s
usod	ˈʔ u s o d
sanaysay	s a n a j ˈs a j
lamog	l a ˈm o ɡ
bangkito	b a ŋ ˈk i t o ʔ
lubak	l u ˈb a k
numipis	n u m i ˈp i s
salmo	ˈs a l m o
keri	ˈk e ɾ i
mahahapdi	m a h a h a p ˈd i ʔ
yumahod	j u ˈm a h o d
peyneta	p e j ˈn e t a
bumatak	b u ˈm a t a k
matimbang	m a t i m ˈb a ŋ
ambisyon	ʔ a m b i s ˈj o n
inugsukat	ʔ i n u ɡ ˈs u k a t
organisado	ʔ o ɾ ɡ a n i ˈs a d o
Sandoval	s a n d o ˈv a l
arnibal	ʔ a ɾ ˈn i b a l
biyaya	b i ˈa j a ʔ
seleksiyon	s e l e k s i ˈo n
ngatal	ŋ a ˈt a l
yumi	ˈj u m i ʔ
purgatoryo	p u ɾ ɡ a ˈt o ɾ j o
hikayat	h i ˈk a j a t
ardilya	ʔ a ɾ ˈd i l j a
bolera	b o ˈl e ɾ a
Marinduque	m a ɾ i n ˈd u k e
amaranto	ʔ a m a ˈɾ a n t o
paligsa	p a l i ɡ ˈs a
pangkat	p a ŋ ˈk a t
LL	ˈʔ e l j e
Turkmenistan	t u ɾ k m e n i s ˈt a n
initsupil	ˌʔ i n i t ˈs u p i l
mapurol	m a p u ˈɾ o l
balikatin	b a l i ˈk a t i n
ibahin	ʔ i b a ˈh i n
diblinig	d i b l i ˈn i ɡ
hatiin	h a ˈt i ʔ i n
bayag	b a ˈj a ɡ
magiting	m a ˈɡ i t i ŋ
hati	ˈh a t i ʔ
tinggil	t i ŋ ˈɡ i l
ligo	ˈl i ɡ o ʔ
burges	b u ɾ ˈɡ e s
Remulla	ɾ e ˈm u l j a
Islam	ʔ i s ˈl a m
babag	b a ˈb a ɡ
Ricardo	ɾ i ˈk a ɾ d o
lumabo	l u ˈm a b o ʔ
Ablog	ʔ a b ˈl o ɡ
sibsib	s i b ˈs i b
kampyon	k a m ˈp j o n
saysay	s a j ˈs a j
Sagitaryo	s a ɡ i ˈt a ɾ j o
madamo	m a d a ˈm o
mapansin	m a p a n ˈs i n
obaryo	ʔ o ˈb a ɾ j o
tamales	t a ˈm a l e s
mangangaso	m a ŋ a ˈŋ a s o
inunan	ʔ i ˈn u n a n
alahado	ʔ a l a ˈh a d o
Shohei	ˈs j o h e j
tsitsaron	t͡ʃ i t͡ʃ a ˈɾ o n
umawat	ʔ u ˈm a w a t
alkatsopas	ʔ a l k a ˈt͡ʃ o p a s
malutong	m a l u ˈt o ŋ
Kurita	k u ˈɾ i t a
Italyano	ʔ i t a l ˈj a n o
Michelena	m i t͡ʃ e ˈl e n a
salsa	ˈs a l s a
maningil	m a n i ˈŋ i l
kumbinsido	k u m b i n ˈs i d o
pangkagawaran	p a ŋ k a ɡ a w a ˈɾ a n
gahasa	ɡ a ˈh a s a ʔ
parol	p a ˈɾ o l
Hapones	h a p o ˈn e s
Froilan	ˈf ɾ o j l a n
balatong	b a ˈl a t o ŋ
barkada	b a ɾ ˈk a d a
nabubuwisit	n a b u b u ˈi s i t
kapatawaran	k a p a t a w a ˈɾ a n
asinan	ʔ a ˈs i n a n
taluiryap	t a l u ʔ i ɾ ˈj a p
Indarapatra	ʔ i n d a ɾ a ˈp a t ɾ a
Macalalad	m a k a ˈl a l a d
tokneneng	t o k ˈn e n e ŋ
mikroorganismo	m i k ɾ o ʔ o ɾ ɡ a ˈn i s m o
mabibigat	m a b i b i ˈɡ a t
rupok	ɾ u ˈp o k
antok	ʔ a n ˈt o k
yangyang	j a ŋ ˈj a ŋ
saniban	s a ˈn i b a n
kalangay	k a ˈl a ŋ a j
Masilungan	m a s i ˈl u ŋ a n
Abelgas	ʔ a b e l ˈɡ a s
Capili	k a ˈp i l i
kundena	k u n d e ˈn a
ipagmayabang	ʔ i p a ɡ m a j a ˈb a ŋ
Pinas	p i ˈn a s
Oliveros	ʔ o l i ˈv e ɾ o s
ganansiya	ɡ a ˈn a n s j a
bara	b a ˈɾ a
limusina	l i m u ˈs i n a
alanganin	ʔ a l a ˈŋ a n i n
pangangailangan	p a ŋ a ŋ a ʔ i ˈl a ŋ a n
peg	ˈp e ɡ
sais	s a ˈʔ i s
riyesgo	ɾ i ˈe s ɡ o
Libya	ˈl i b j a
laro	l a ˈɾ o ʔ
sagwan	s a ɡ ˈw a n
Barayuga	b a ɾ a ˈj u ɡ a
Kho	ˈk o
tambakol	t a m ˈb a k o l
balahak	b a ˈl a h a k
umbok	ʔ u m ˈb o k
polo	ˈp o l o
bilasa	b i l a ˈs a ʔ
hagak	ˈh a ɡ a k
polyeto	p o l ˈj e t o
gilib	ɡ i ˈl i b
kaniyugan	k a n i ˈu ɡ a n
hardin	h a ɾ ˈd i n
batia	b a t i ˈa ʔ
magkatay	m a ɡ ˈk a t a j
mandadangkal	m a n d a d a ŋ ˈk a l
antala	ʔ a n ˈt a l a
hila	ˈh i l a
kabaiyuan	k a b a ʔ i u ˈʔ a n
barberya	b a ɾ b e ɾ ˈj a
julalay	d͡ʒ u ˈl a l a j
maghalili	m a ɡ h a l i ˈl i
gobernador	ɡ o b e ɾ n a ˈd o ɾ
alapaap	ʔ a l a ˈp a ʔ a p
Flora	ˈf l o ɾ a
lupig	ˈl u p i ɡ
masiyasip	m a s i ˈa s i p
kakawati	k a k a ˈw a t i
fotobam	ˈf o t o b a m
birtud	b i ɾ ˈt u d
mabalang	m a ˈb a l a ŋ
Ivy	ˈʔ a j v i
tulad	ˈt u l a d
reengkarnasyon	ɾ e ʔ e ŋ k a ɾ n a s ˈj o n
pananamantala	p a n a n a m a n t a ˈl a
manahimik	m a n a ˈh i m i k
tagaangkat	t a ɡ a ʔ a ŋ ˈk a t
sinigurado	s i n i ɡ u ˈɾ a d o
bahagi	b a ˈh a ɡ i ʔ
Catindig	k a t i n ˈd i ɡ
Tauro	ˈt a w ɾ o
Abellano	ʔ a b e l ˈj a n o
lutad	l u ˈt a d
yano	ˈj a n o
medyas	ˈm e d j a s
Lantican	l a n ˈt i k a n
Cenizal	s e n i ˈz a l
tambuli	t a m ˈb u l i ʔ
pirata	p i ˈɾ a t a
udon	ˈʔ u d o n
lingkod	l i ŋ ˈk o d
enerhiya	ʔ e n e ɾ ˈh i a
C	s i
tahure	ˈt a h u ɾ e
yama	j a ˈm a
tiyope	t i ˈo p e ʔ
seko	ˈs e k o
liing	l i ˈʔ i ŋ
gulot	ɡ u ˈl o t
kondo	ˈk o n d o
korni	ˈk o ɾ n i
Lupao	l u ˈp a w
Fung	ˈf u ŋ
mayaman	m a ˈj a m a n
namnam	n a m ˈn a m
liwat	ˈl i w a t
ma	m a
Valmores	v a l ˈm o ɾ e s
dalubwikaan	d a ˌl u b w i ˈk a ʔ a n
ginto	ɡ i n ˈt o ʔ
Cadapan	k a ˈd a p a n
haligutgot	h a l i ɡ u t ˈɡ o t
estandarte	ʔ e s t a n ˈd a ɾ t e
magparami	m a ɡ p a ˈɾ a m i
dagasdas	d a ɡ a s ˈd a s
sebo	ˈs e b o
Jasmine	ˈd͡ʒ a s m i n
kadiri	k a ˈd i ɾ i
iwas	ˈʔ i w a s
basurero	b a s u ˈɾ e ɾ o
miklawas	m i k ˈl a w a s
bisikleta	b i s i k ˈl e t a
dehado	d e ˈh a d o
Datu	ˈd a t u
inggitero	ʔ i ŋ ɡ i ˈt e ɾ o
Danesa	d a ˈn e s a
uhod	ˈʔ u h o d
kategorikal	k a t e ɡ o ɾ i ˈk a l
asendero	ʔ a s e n ˈd e ɾ o
singkad	s i ŋ ˈk a d
diskuwento	d i s k u ˈe n t o
elepante	ʔ e l e ˈp a n t e
bolta	ˈb o l t a
tunggak	t u ŋ ˈɡ a k
diyaryo	d i ˈa ɾ j o
abyog	ʔ a b ˈj o ɡ
sutla	s u t ˈl a ʔ
suki	ˈs u k i ʔ
Sumadsad	s u ˈm a d s a d
maako	m a ʔ a ˈk o
atim	ʔ a ˈt i m
labaw	ˈl a b a w
dukwangin	d u k w a ˈŋ i n
tolerable	t o l e ˈɾ a b l e
panlikod	p a n l i ˈk o d
Makaw	m a ˈk a w
kasilyas	k a ˈs i l j a s
asam	ʔ a ˈs a m
halihaw	h a ˈl i h a w
Salandanan	s a l a n ˈd a n a n
Moymoy	ˈm o j m o j
kumporme	k u m ˈp o ɾ m e
humagulhol	h u m a ɡ u l ˈh o l
dalubhayupan	d a ˌl u b h a ˈj u p a n
wiski	ˈw i s k i
ugali	ʔ u ˈɡ a l i ʔ
oposisyon	ʔ o p o s i s ˈj o n
Jurado	h u ˈɾ a d o
panuntunan	p a n u n ˈt u n a n
tumangkad	t u m a ŋ ˈk a d
hinguto	h i ˈŋ u t o
tilos	ˈt i l o s
sapupuhin	s a p u ˈp u h i n
pinabubulaanan	p i n a b u b u l a ˈʔ a n a n
nitrogliserina	n i t ɾ o ɡ l i s e ˈɾ i n a
radikal	ɾ a d i ˈk a l
berdugo	b e ɾ ˈd u ɡ o
Kalantiaw	k a l a n ˈt j a w
mahistrado	m a h i s ˈt ɾ a d o
sipol	ˈs i p o l
Biyer.	b i ˈe ɾ
malapot	m a ˈl a p o t
asno	ˈʔ a s n o
repleksiyon	ɾ e p l e k s i ˈo n
dagusdos	d a ɡ u s ˈd o s
salwak	s a l ˈw a k
kabisera	k a b i ˈs e ɾ a
paninindigan	p a n i n i n ˈd i ɡ a n
higa	h i ˈɡ a ʔ
kelan	ˈk e l a n
sinehan	s i n e ˈh a n
deskripsiyon	d e s k ɾ i p s i ˈo n
korupsiyon	k o ɾ u p s i ˈo n
mamumuhunan	m a m u m u ˈh u n a n
buryong	b u ɾ ˈj o ŋ
hapag	h a ˈp a ɡ
pudpod	p u d ˈp o d
unawa	ʔ u ˈn a w a ʔ
kawawa	k a ˈw a w a ʔ
kumpisal	k u m p i ˈs a l
diso	d i ˈs o
Lumad	ˈl u m a d
yumamot	j u m a ˈm o t
kuha	ˈk u h a
hasain	h a ˈs a ʔ i n
kadyos	k a d ˈj o s
Manalaysay	m a n a l a j ˈs a j
sapalaran	ˈs a p a l a ɾ a n
labawliknayan	l a b a w l i k ˈn a j a n
bagol	b a ˈɡ o l
kwenta	ˈk w e n t a
sipot	s i ˈp o t
dote	ˈd o t e
hambaw	h a m ˈb a w
be	ˈb e
sus	ˈs u s
magbili	m a ɡ b i ˈl i
wawa	ˈw a w a ʔ
renta	ˈɾ e n t a
pumanig	p u ˈm a n i ɡ
senakulo	s e ˈn a k u l o
boto	ˈb o t o
panaguri	p a n a ɡ u ˈɾ i ʔ
hagkan	h a ɡ ˈk a n
maimbot	m a ʔ i m ˈb o t
Kaye	k e j
mangopya	m a ˈŋ o p j a
sampid	s a m ˈp i d
isapribado	ʔ i s a p ɾ i ˈb a d o
sekreto	s e k ˈɾ e t o
Kardo	ˈk a ɾ d o
golp	ˈɡ o l p
tigis	ˈt i ɡ i s
manukan	m a ˈn u k a n
depresasyon	d e p ɾ e s a s ˈj o n
aninag	ʔ a ˈn i n a ɡ
landa	l a n ˈd a
magtapat	m a ɡ t a ˈp a t
Kamaynilaan	k a m a j n i ˈl a ʔ a n
magugulo	m a ɡ u ɡ u ˈl o
Natanauan	n a t a ˈn a w a n
kubo	ˈk u b o
taimtim	t a ʔ i m ˈt i m
palya	p a l ˈj a
Sabado	ˈs a b a d o
konyak	k o n ˈj a k
hindi	h i n ˈd i ʔ
hinang	ˈh i n a ŋ
ditablo	d i t a b ˈl o
reportahe	ɾ e p o ɾ ˈt a h e
tulos	ˈt u l o s
Soon	ˈs u n
Princess	ˈp ɾ i n s e s
Po	ˈp o
medyebal	m e d j e ˈb a l
dalubguro	d a ˌl u b ˈɡ u ɾ o ʔ
aborsiyon	ʔ a ˌb o ɾ s ˈj o n
Netoy	ˈn e t o j
manguna	m a ˈŋ u n a
humba	h u m ˈb a ʔ
pusakal	p u s a ˈk a l
basar	b a ˈs a ɾ
ukab	ˈʔ u k a b
pano	ˈp a n o
lugar	l u ˈɡ a ɾ
disiotso	d i s i ˈʔ o t͡ʃ o
Inocencio	ʔ i n o ˈs e n s j o
bentaha	b e n ˈt a h a
bitak	b i ˈt a k
kauntian	k a ʔ u n t i ˈʔ a n
panuruan	ˈp a n u ɾ u ʔ a n
rotasyon	ɾ o t a s ˈj o n
sisihan	s i s i ˈh a n
yeso	ˈj e s o
ibabaw	ʔ i ˈb a b a w
malindol	m a l i n ˈd o l
lawaan	l a ˈw a ʔ a n
madiwa	m a ˈd i w a ʔ
sigsa	s i ɡ ˈs a
higante	h i ˈɡ a n t e
mayayabang	m a j a ˈj a b a ŋ
Manatad	m a ˈn a t a d
Aleman	ʔ a l e ˈm a n
Hamayka	h a ˈm a j k a
Caguiat	ˈk a ɡ j a t
rambol	ˈɾ a m b o l
galagala	ɡ a l a ɡ a ˈl a
katukayo	k a t u ˈk a j o
aswang	ʔ a s ˈw a ŋ
maggantsilyo	m a ɡ ɡ a n ˈt͡ʃ i l j o
resitasyon	ɾ e s i t a s ˈj o n
ipatong	ʔ i ˈp a t o ŋ
Cajucom	k a ˈh u k o m
boba	ˈb o b a
hampol	h a m ˈp o l
Villablanca	v i l j a ˈb l a n k a
ko	k o
haya	ˈh a j a ʔ
takuri	t a k u ˈɾ i ʔ
awtorisasyon	ʔ a w t o ɾ i s a s ˈj o n
tiwasay	t i w a ˈs a j
nanghawa	n a ŋ ˈh a w a
birsin	b i ɾ ˈs i n
gahaman	ɡ a h a ˈm a n
sagupa	s a ˈɡ u p a ʔ
bulyaw	b u l ˈj a w
Cortez	k o ɾ ˈt e s
dinsol	d i n ˈs o l
lilok	ˈl i l o k
hingalo	h i ŋ a ˈl o ʔ
kyu	ˈk j u
radikalismo	ɾ a d i k a ˈl i s m o
labandero	l a b a n ˈd e ɾ o
Caparas	k a p a ˈɾ a s
Maribel	m a ɾ i ˈb e l
usngal	ʔ u s ˈŋ a l
ra	ɾ a
lambot	l a m ˈb o t
kodigo	ˈk o d i ɡ o
daloy	ˈd a l o j
Aplasca	ʔ a p ˈl a s k a
magpaalam	m a ɡ p a ˈʔ a l a m
ayungin	ʔ a ˈj u ŋ i n
hamak	ˈh a m a k
banlaw	b a n ˈl a w
tahong	t a ˈh o ŋ
barkilyos	b a ɾ ˈk i l j o s
tributaryo	t ɾ i b u ˈt a ɾ j o
Malicdem	m a l i k ˈd e m
piyudalismo	p i u d a ˈl i s m o
malasado	m a l a ˈs a d o
kaldero	k a l ˈd e ɾ o
Tseko	ˈt͡ʃ e k o
manghawa	m a ŋ ˈh a w a
siyokoy	s i ˈo k o j
beses	ˈb e s e s
magdemanda	m a ɡ d e ˈm a n d a
korea	k o ˈɾ e a
magtipid	m a ɡ t i ˈp i d
diyan	d i ˈa n
Pilipinismo	p i l i p i ˈn i s m o
daos	ˈd a ʔ o s
jabol	d͡ʒ a ˈb o l
lawlaw	l a w ˈl a w
inampalan	ʔ i n a m ˈp a l a n
dagdag	d a ɡ ˈd a ɡ
kimona	k i ˈm o n a
halibhib	h a l i b ˈh i b
salagimsim	s a l a ɡ i m ˈs i m
garbo	ˈɡ a ɾ b o
maleta	m a ˈl e t a
mawsoleo	m a w s o ˈl e o
talentado	t a l e n ˈt a d o
alangilan	ʔ a l a ˈŋ i l a n
Karunungan	k a ɾ u ˈn u ŋ a n
luwad	l u ˈa d
dagta	d a ɡ ˈt a ʔ
Ortea	ʔ o ɾ ˈt e a
paksa	p a k ˈs a ʔ
Roxas	ˈɾ o h a s
simetriya	s i m e t ˈɾ i a
paggatas	p a ɡ ˈɡ a t a s
rehas	ˈɾ e h a s
restitusyon	ɾ e s t i t u s ˈj o n
labaha	l a ˈb a h a
balbakwa	b a l b a k ˈw a
tagarito	t a ɡ a ˈɾ i t o
hibi	ˈh i b i
sasapnan	s a s a p ˈn a n
determinismo	d e t e ɾ m i ˈn i s m o
almuwerso	ʔ a l m u ˈe ɾ s o
Batangueña	b a t a ŋ ˈɡ e n j a
kabulagsakan	k a b u l a ɡ s a ˈk a n
lintik	l i n ˈt i k
Encarnacion	ʔ e n k a ɾ n a s ˈj o n
panahinga	p a n a ˈh i ŋ a
magsimba	m a ɡ s i m ˈb a
turong	ˈt u ɾ o ŋ
Kaputsino	k a p u ˈt͡ʃ i n o
aguho	ʔ a ˈɡ u h o ʔ
atrebida	ʔ a t ɾ e ˈb i d a
papagtalunan	ˌp a p a ɡ t a ˈl u n a n
pisikalan	ˌp i s i ˈk a l a n
kaligkig	k a l i ɡ ˈk i ɡ
chaka	t͡ʃ a ˈk a ʔ
tibag	t i ˈb a ɡ
kakosa	k a ˈk o s a
gumaling	ɡ u m a ˈl i ŋ
lang	ˈl a ŋ
abuab	ʔ a b u ˈʔ a b
kandaro	k a n ˈd a ɾ o
dantaon	d a n t a ˈʔ o n
etika	ˈʔ e t i k a
parinig	p a ɾ i ˈn i ɡ
Solano	s o ˈl a n o
akompanya	ʔ a k o m p a n ˈj a
samat	ˈs a m a t
lanting	l a n ˈt i ŋ
empleyado	ʔ e m p l e ˈa d o
tauhan	t a ˈʔ u h a n
koponan	k o p o ˈn a n
Leyte	ˈl e j t e
destabilisasyon	d e s t a b i l i s a s ˈj o n
reperensiya	ɾ e p e ˈɾ e n s j a
pakialam	p a k i ʔ a ˈl a m
Pedregal	p e d ɾ e ˈɡ a l
kuwenta	k u ˈe n t a
Alolod	ʔ a l o ˈl o d
Aldover	ʔ a l d o ˈv e ɾ
SK	ˈʔ e s k e j
anis	ʔ a ˈn i s
iwang	ˈʔ i w a ŋ
anino	ʔ a ˈn i n o
sibuyas	s i ˈb u j a s
Magallanes	m a ɡ a l ˈj a n e s
alandahaw	ʔ a l a n ˈd a h a w
warlahin	ˈw a ɾ l a h i n
akrostik	ʔ a k ˈɾ o s t i k
takatak	t a k a ˈt a k
kahit	ˈk a h i t
sasakyan	s a s a k ˈj a n
kilos	ˈk i l o s
Suan	ˈs w a n
hininga	h i n i ˈŋ a
pasasalamat	p a s a s a ˈl a m a t
sangkatutak	s a ŋ k a ˈt u t a k
Opeña	ʔ o ˈp e ɲ a
Nobuhisa	n o b u ˈh i s a
tagatuos	t a ɡ a t u ˈʔ o s
dedikasyon	d e d i k a s ˈj o n
detalyado	d e t a l ˈj a d o
banggerahan	b a ŋ ɡ e ɾ a ˈh a n
lapulapu	ˌl a p u ˈl a p u
iho	ˈʔ i h o
oryente	ʔ o ɾ ˈj e n t e
Sergio	ˈs e ɾ h i o
Javier	h a v i ˈe ɾ
gariya	ɡ a ˈɾ i a ʔ
baklad	b a k ˈl a d
sipon	s i ˈp o n
lohiko	ˈl o h i k o
suklay	s u k ˈl a j
lasinggera	l a s i ŋ ˈɡ e ɾ a
kontestant	k o n ˈt e s t a n t
pilik	p i ˈl i k
Mabato	m a b a ˈt o
balnikapnayan	b a l n i k a p ˈn a j a n
sipat	ˈs i p a t
Corazon	k o ɾ a ˈz o n
agnostiko	ʔ a ɡ ˈn o s t i k o
instituto	ʔ i n s t i ˈt u t o
talangka	t a l a ŋ ˈk a ʔ
Imperial	ʔ i m p e ɾ ˈj a l
Malilay	m a ˈl i l a j
koteho	k o ˈt e h o
suplada	s u p ˈl a d a
metodo	ˈm e t o d o
balino	b a ˈl i n o
walwal	w a l ˈw a l
usisain	ʔ u s i ˈs a ʔ i n
erpats	ˈʔ e ɾ p a t s
uslak	ʔ u s ˈl a k
shiboli	ˈʃ i b o l i
pispis	p i s ˈp i s
lapit	ˈl a p i t
lawulta	l a w u l ˈt a
halungkat	h a l u ŋ ˈk a t
dara	d a ˈɾ a
mahikaw	m a ˈh i k a w
kalapati	k a l a ˈp a t i
mayoldomo	m a j o l ˈd o m o
ineng	ʔ i ˈn e ŋ
lithaw	l i t ˈh a w
pinabulaanan	p i n a b u l a ˈʔ a n a n
Salvatierra	s a l v a t i ˈe r a
Lanao	ˈl a n a w
ritrato	ɾ i t ˈɾ a t o
alipunga	ʔ a l i p u ˈŋ a
omsim	ˈʔ o m s i m
palakpakan	p a l a k ˈp a k a n
matatauhan	m a t a t a ˈʔ u h a n
Mabulo	m a ˈb u l o
aborsiyonista	ʔ a b o ɾ s i o ˈn i s t a
kupo	ˈk u p o ʔ
monopolyo	m o n o ˈp o l j o
Tupa	ˈt u p a
hikmat	h i k ˈm a t
katotohanan	k a t o t o ˈh a n a n
tikang	t i ˈk a ŋ
kromosoma	k ɾ o m o ˈs o m a
Pilipino	p i l i ˈp i n o
Elorde	ʔ e ˈl o ɾ d e
binatilyo	b i n a ˈt i l j o
estranghero	ʔ e s t ɾ a ŋ ˈh e ɾ o
marmol	m a ɾ ˈm o l
gulang	ˈɡ u l a ŋ
tiyobibo	t i o ˈb i b o
lara	ˈl a ɾ a ʔ
simulasyon	s i m u l a s ˈj o n
palabasa	p a l a b a ˈs a
magmukmok	m a ɡ m u k ˈm o k
Untalan	ʔ u n t a ˈl a n
pilyo	ˈp i l j o
almanake	ʔ a l m a ˈn a k e
sutmondilaw	s u t ˌm o n d i ˈl a w
ᜐ	s a ˈs a ʔ
Alfredo	ʔ a l ˈf ɾ e d o
guham	ɡ u ˈh a m
latay	ˈl a t a j
yabangan	j a b a ˈŋ a n
Ching	ˈt͡ʃ i ŋ
sambalilo	s a m b a ˈl i l o
matipuno	m a t i ˈp u n o ʔ
makipagtalik	m a k i p a ɡ ˈt a l i k
Ebanghelyo	ʔ e b a ŋ ˈh e l j o
santan	s a n ˈt a n
sundin	s u n ˈd i n
bunggabilya	b u ŋ ɡ a ˈb i l j a
bobo	ˈb o b o
Montañez	m o n ˈt a ɲ e s
Escueta	ʔ e s k u ˈe t a
pagkakaisa	p a ɡ k a k a ʔ i ˈs a
taltak	t a l ˈt a k
maambunan	m a ʔ a m b u ˈn a n
heranyo	h e ˈɾ a n j o
blangko	ˈb l a ŋ k o
bilas	b i ˈl a s
Manalang	m a ˈn a l a ŋ
maglaway	m a ɡ l a ˈw a j
ahas	ˈʔ a h a s
slang	ˈs l a ŋ
ipakuha	ʔ i p a ˈk u h a
lunsod	l u n ˈs o d
lunday	l u n ˈd a j
panganan	p a ˈŋ a n a n
sabila	ˈs a b i l a
lansangan	l a n ˈs a ŋ a n
April	ˈʔ e j p ɾ i l
kongkreto	k o ŋ ˈk ɾ e t o
maghalabos	m a ɡ h a l a ˈb o s
tulod	ˈt u l o d
anib	ˈʔ a n i b
bangketa	b a ŋ ˈk e t a
tagigapay	t a ɡ i ɡ a ˈp a j
sulid	ˈs u l i d
tawge	ˈt a w ɡ e
engrande	ʔ e ŋ ˈɡ ɾ a n d e
bubog	ˈb u b o ɡ
sulit	ˈs u l i t
lagkit	l a ɡ ˈk i t
Togo	ˈt o ɡ o
sumalangit	s u m a ˈl a ŋ i t
Cabungcal	k a b u ŋ ˈk a l
adelanto	ʔ a d e ˈl a n t o
lugami	l u ɡ a ˈm i ʔ
sugadagitban	s u ɡ a d a ɡ i t ˈb a n
maano	m a ʔ a ˈn o
Decena	d e ˈs e n a
uyad	ˈʔ u j a d
pararayos	ˌp a ɾ a ˈɾ a j o s
tinik	t i ˈn i k
ateismo	ʔ a t e ˈi s m o
Korean	k o ˈɾ i a n
gora	ˈɡ o ɾ a
ugaw	ʔ u ˈɡ a w
umaakyat	ʔ u m a ʔ a k ˈj a t
organista	ʔ o ɾ ɡ a ˈn i s t a
lumutang	l u ˈm u t a ŋ
heologo	h e ˈo l o ɡ o
Miraflores	m i ɾ a f ˈl o ɾ e s
manunula	m a n u n u ˈl a ʔ
manirahan	m a n i ˈɾ a h a n
adhika	ʔ a d h i ˈk a ʔ
relasyon	ɾ e l a s ˈj o n
pananambang	p a n a n a m ˈb a ŋ
Samar	ˈs a m a ɾ
obserbatoryo	ʔ o b s e ɾ b a ˈt o ɾ j o
magbanda	m a ɡ ˈb a n d a
pakikiramay	p a k i k i ˈɾ a m a j
Vizconde	v i s ˈk o n d e
abandonado	ʔ a b a n d o ˈn a d o
baway	ˈb a w a j
ingklitik	ʔ i ŋ ˈk l i t i k
himagsik	h i m a ɡ ˈs i k
Orejudos	ʔ o ɾ e ˈh u d o s
taksan	t a k ˈs a n
guwatsinanggo	ɡ u a t͡ʃ i ˈn a ŋ ɡ o
suspensiyon	s u s p e n s i ˈo n
kumbensiyon	k u m b e n s i ˈo n
bisyo	ˈb i s j o
talikakas	t a l i k a ˈk a s
guyabano	ɡ u j a ˈb a n o
punla	p u n ˈl a ʔ
tsek	ˈt͡ʃ e k
Escuadro	ʔ e s k u ˈa d ɾ o
Iloko	ʔ i ˈl o k o
ratratin	ɾ a t ɾ a ˈt i n
David	ˈd e j v i d
ninuno	n i ˈn u n o ʔ
Loo	ˈl u
Biyernes	b i ˈe ɾ n e s
mansanas	m a n ˈs a n a s
gunimbilang	ɡ u n i m ˈb i l a ŋ
tigbuhol	t i ɡ b u ˈh o l
espesyalista	ʔ e s p e s j a ˈl i s t a
lesbiyana	l e s b i ˈa n a
himagas	h i ˈm a ɡ a s
mapuknat	m a p u k ˈn a t
opsiyon	ʔ o p s i ˈo n
dabdab	d a b ˈd a b
Tayao	ˈt a j a w
utas	ʔ u ˈt a s
Medrano	m e d ˈɾ a n o
semento	s e ˈm e n t o
Laude	ˈl a w d e
lipstik	ˈl i p s t i k
kurakot	k u ˈɾ a k o t
sangat	ˈs a ŋ a t
sagubang	s a ɡ u ˈb a ŋ
talino	t a ˈl i n o
sakto	ˈs a k t o
aruskaldo	ʔ a ɾ u s ˈk a l d o
kalinggalan	k a l i ŋ ɡ a ˈl a n
aroma	ʔ a ˈɾ o m a
manghihipo	m a ŋ h i ˈh i p o ʔ
Nebraska	n e b ˈɾ a s k a
kalungsuran	k a l u ŋ s u ˈɾ a n
gamol	ɡ a ˈm o l
dinsulan	d i n ˈs u l a n
iso	ˈʔ i s o
na	n a
tinapay	t i ˈn a p a j
Gascon	ɡ a s ˈk o n
Hupiter	ˈh u p i t e ɾ
katay	ˈk a t a j
denggoy	ˈd e ŋ ɡ o j
orihinal	ʔ o ɾ i h i ˈn a l
malalakas	m a l a l a ˈk a s
iskandalo	ʔ i s ˈk a n d a l o
negosyo	n e ˈɡ o s j o
reptil	ɾ e p ˈt i l
tinedyer	t i ˈn e d j e ɾ
NAWASA	n a ˈw a s a
balaglawas	b a l a ɡ ˈl a w a s
tulag	t u ˈl a ɡ
halayhay	h a l a j ˈh a j
bandehado	b a n d e ˈh a d o
dibdib	d i b ˈd i b
haj	ˈh a d͡ʒ
Corcuera	k o ɾ k u ˈe ɾ a
mahuli	m a ˈh u l i
dyudo	ˈd j u d o
laguyo	l a ˈɡ u j o ʔ
medalya	m e ˈd a l j a
kordero	k o ɾ ˈd e ɾ o
kiyeme	k i ˈe m e
Candelaria	k a n d e ˈl a ɾ j a
Londres	ˈl o n d ɾ e s
Samantha	s a ˈm a n t a
latundan	l a t u n ˈd a n
ene	ˈʔ e n e
donasyon	d o n a s ˈj o n
laping	l a ˈp i ŋ
badap	b a ˈd a p
lagap	l a ˈɡ a p
ornitolohiya	ʔ o ɾ n i t o l o ˈh i a
maging	m a ˈɡ i ŋ
Dalangin	d a ˈl a ŋ i n
Bayot	ˈb a j o t
salahilo	s a l a ˈh i l o
Arcillas	ʔ a ɾ ˈs i l j a s
Sanson	ˈs a n s o n
silidkulay	s i ˌl i d k u ˈl a j
publiko	ˈp u b l i k o
sapantaha	s a p a n ˈt a h a ʔ
Casiguran	k a s i ˈɡ u ɾ a n
Isabang	ʔ i ˈs a b a ŋ
baitang	b a ʔ i ˈt a ŋ
malambot	m a l a m ˈb o t
tiple	ˈt i p l e
melodiya	m e l o ˈd i a
bako	b a ˈk o ʔ
Inglatera	ʔ i ŋ ɡ l a ˈt e ɾ a
abnormalidad	ʔ a b n o ɾ m a l i ˈd a d
muwi	ˈm u i ʔ
alat	ˈʔ a l a t
Eden	ʔ e ˈd e n
f	ˈʔ e f
abain	ʔ a b a ˈʔ i n
soberaniya	s o b e ɾ a ˈn i a
Negros	ˈn e ɡ ɾ o s
sapsuy	s a p ˈs u j
kantutin	k a n t u ˈt i n
destornilyador	d e s t o ɾ n i l j a ˈd o ɾ
magigi	m a ˈɡ i ɡ i ʔ
Corro	ˈk o r o
Rosete	ɾ o ˈs e t e
kabalyo	k a ˈb a l j o
pagsasaka	p a ɡ s a ˈs a k a
sikreto	s i k ˈɾ e t o
maliw	ˈm a l i w
katol	k a ˈt o l
mahumaling	m a h u m a ˈl i ŋ
Budista	b u ˈd i s t a
kusinero	k u s i ˈn e ɾ o
apostol	ʔ a p o s ˈt o l
residente	ɾ e s i ˈd e n t e
halabos	h a l a ˈb o s
maglustay	m a ɡ l u s ˈt a j
inupas	ʔ i ˈn u p a s
andaderas	ʔ a n d a ˈd e ɾ a s
yaya	ˈj a j a
bagaso	b a ˈɡ a s o
Mangalindan	m a ŋ a l i n ˈd a n
maburol	ˌm a ˈb u ɾ o l
pumanghaw	p u m a ŋ ˈh a w
harapan	h a ɾ a ˈp a n
dinuduguan	d i n u d u ɡ u ˈʔ a n
permiso	p e ɾ ˈm i s o
Mamburao	m a m b u ˈɾ a w
lumamig	l u m a ˈm i ɡ
astinggal	ʔ a s t i ŋ ˈɡ a l
timbulog	t i m ˈb u l o ɡ
Cabasag	k a ˈb a s a ɡ
tilandoy	t i l a n ˈd o j
manulat	m a ˈn u l a t
kaliko	k a ˈl i k o
artipisyal	ʔ a ɾ t i p i s ˈj a l
magbabasa	m a ɡ b a b a ˈs a
tanghal	t a ŋ ˈh a l
luwag	l u ˈa ɡ
J	d j e j
umisod	ʔ u ˈm i s o d
ermat	ˈʔ e ɾ m a t
palaba	p a l a ˈb a
Godiñez	ɡ o ˈd i ɲ e s
kabaktan	k a b a k ˈt a n
inidoro	ʔ i n i ˈd o ɾ o
Abad	ʔ a ˈb a d
hunyango	h u n ˈj a ŋ o ʔ
okey	ˈʔ o k e j
ahiya	ˈʔ a h i a
impluwensiya	ʔ i m p l u ˈe n s j a
simana	s i ˈm a n a
bisyon	b i s ˈj o n
pipirmahan	p i p i ɾ m a ˈh a n
panloob	p a n ˈl o ʔ o b
naganap	n a ɡ a ˈn a p
palapatik	p a l a ˈp a t i k
pagong	p a ˈɡ o ŋ
kali	k a ˈl i
tanghali	t a ŋ ˈh a l i ʔ
mesa	ˈm e s a
sumingaw	s u m i ˈŋ a w
duwende	d u ˈe n d e
administrasyon	ʔ a d m i n i s t ɾ a s ˈj o n
buwitre	b u ˈi t ɾ e
Eukaristiya	j u k a ɾ i s ˈt i a
Cariño	k a ˈɾ i ɲ o
kingke	k i ŋ ˈk e
tanawan	t a ˈn a w a n
Wong	ˈw o ŋ
bakli	b a k ˈl i ʔ
dulas	d u ˈl a s
ikalabingwalo	ʔ i k a l a ˌb i ŋ w a ˈl o
pukyutan	p u k ˈj u t a n
importante	ʔ i m p o ɾ ˈt a n t e
alguwasil	ʔ a l ɡ u a ˈs i l
paminta	p a m i n ˈt a
hagap	ˈh a ɡ a p
nguso	ˈŋ u s o ʔ
Paligsahan	p a l i ɡ ˈs a h a n
ya	j a
N	ʔ e n
Igorot	ʔ i ɡ o ˈɾ o t
konsentidora	k o n s e n t i ˈd o ɾ a
palitada	p a l i ˈt a d a
Grace	ˈɡ ɾ e j s
uom	ʔ u ˈʔ o m
Ubalde	ʔ u ˈb a l d e
mabunutan	m a b u ˈn u t a n
magjakol	m a ɡ d͡ʒ a ˈk o l
Malihan	m a ˈl i h a n
palasimba	p a l a s i m ˈb a
Kuniko	k u ˈn i k o
Marife	m a ɾ i ˈf e
repriherador	ɾ e p ɾ i h e ɾ a ˈd o ɾ
sinsay	s i n ˈs a j
tsibog	t͡ʃ i ˈb o ɡ
lalaki	l a ˈl a k i
dalubsining	d a l u b ˈs i n i ŋ
katulong	k a ˈt u l o ŋ
senadora	s e n a ˈd o ɾ a
Nacpil	n a k ˈp i l
lako	ˈl a k o ʔ
tagiktik	t a ɡ i k ˈt i k
balnisukat	b a l n i ˈs u k a t
bayabasan	ˌb a j a b a ˈs a n
katarungan	k a t a ˈɾ u ŋ a n
tsispa	ˈt͡ʃ i s p a
Suansing	s u a n ˈs i ŋ
retirada	ɾ e t i ˈɾ a d a
ramdam	ɾ a m ˈd a m
lingming	l i ŋ ˈm i ŋ
Manaoag	m a ˈn a w a ɡ
Castañeda	k a s t a ˈɲ e d a
soli	ˈs o l i ʔ
uranyo	ʔ u ˈɾ a n j o
lingguwista	l i ŋ ɡ u ˈi s t a
Tindoc	t i n ˈd o k
nakakabwisit	n a k a k a ˈb w i s i t
iringan	ʔ i ˈɾ i ŋ a n
endyi	ˈʔ e n d j i
hane	h a ˈn e
Maniquiz	m a n i ˈk i s
eksaherado	ʔ e k s a h e ˈɾ a d o
banggit	b a ŋ ˈɡ i t
mawasak	m a ˈw a s a k
iskolarsyip	ʔ i s ˈk o l a ɾ s j i p
kutya	k u t ˈj a ʔ
Epipanya	ʔ e p i ˈp a n j a
saks	ˈs a k s
hinga	h i ˈŋ a
akap	ˈʔ a k a p
ow	ˈʔ o w
seksi	ˈs e k s i
gunaw	ˈɡ u n a w
Melchor	m e l ˈt͡ʃ o ɾ
hawig	h a ˈw i ɡ
salimao	s a l i m a ˈʔ o
adhikain	ʔ a d h i ˈk a ʔ i n
yukyok	j u k ˈj o k
pasayahin	p a s a j a ˈh i n
matraka	m a t ˈɾ a k a
tonsura	t o n ˈs u ɾ a
Ting	ˈt i ŋ
kainin	k a ˈʔ i n i n
depinisyon	d e p i n i s ˈj o n
labimpito	l a b i m p i ˈt o
proyekto	p ɾ o ˈj e k t o
halari	h a ˈl a ɾ i ʔ
ipagsanggalang	ʔ i p a ɡ s a ŋ ɡ a ˈl a ŋ
tuldik	t u l ˈd i k
eskaparate	ʔ e s k a p a ˈɾ a t e
saklob	s a k ˈl o b
kusing	k u ˈs i ŋ
lagong	ˈl a ɡ o ŋ
pasipismo	p a s i ˈp i s m o
suminga	s u m i ˈŋ a
alimpuyo	ʔ a l i m p u ˈj o
Hehoba	h e ˈh o b a
dismayado	d i s m a ˈj a d o
saya	s a ˈj a
tapon	ˈt a p o n
Aprika	ˈʔ a p ɾ i k a
panghalip	p a ŋ h a ˈl i p
silinyador	s i l i n j a ˈd o ɾ
babaero	b a b a ˈʔ e ɾ o
alusitha	ʔ a l u s i t ˈh a ʔ
amin	ˈʔ a m i n
kanino	k a ˈn i n o
laspag	l a s ˈp a ɡ
bagsakan	b a ɡ ˈs a k a n
tagapamagitan	t a ɡ a p a m a ˈɡ i t a n
lilipad	l i l i ˈp a d
lungkag	l u ŋ ˈk a ɡ
palanggana	p a l a ŋ ˈɡ a n a
Keiko	ˈk e j k o
tolerante	t o l e ˈɾ a n t e
misteryoso	m i s t e ɾ ˈj o s o
estrikto	ʔ e s ˈt ɾ i k t o
reto	ˈɾ e t o
Pasamba	p a ˈs a m b a
Marquez	m a ɾ ˈk e s
Coquia	ˈk o k j a
gamot	ɡ a ˈm o t
panrelihiyon	p a n ɾ e l i h i ˈo n
Dulay	ˈd u l a j
tanggap	t a ŋ ˈɡ a p
rosaryo	ɾ o ˈs a ɾ j o
Sesus	s e ˈs u s
heodesya	h e o ˈd e s j a
rin	ˈɾ i n
boksing	ˈb o k s i ŋ
iset	ʔ i ˈs e t
Cabiao	k a b ˈj a w
balas	b a ˈl a s
humigit	h u m i ˈɡ i t
ordenansa	ʔ o ɾ d e ˈn a n s a
langlang	l a ŋ ˈl a ŋ
sorbetes	s o ɾ ˈb e t e s
tingting	t i ŋ ˈt i ŋ
sakate	s a ˈk a t e
Acuña	ʔ a ˈk u ɲ a
Alcaide	ʔ a l ˈk a j d e
Camantigue	k a m a n t i ˈɡ e
mangomisyon	m a ŋ o m i s ˈj o n
kartamoneda	k a ɾ t a m o ˈn e d a
hanger	ˈh a ŋ e ɾ
takong	t a ˈk o ŋ
ka	k a
dapo	ˈd a p o ʔ
butanding	b u t a n ˈd i ŋ
kontrasenyas	k o n t ɾ a ˈs e n j a s
ikit	ˈʔ i k i t
sumbong	s u m ˈb o ŋ
diyesmo	d i ˈe s m o
sanib	ˈs a n i b
eskala	ʔ e s ˈk a l a
hupot	h u ˈp o t
lukong	l u ˈk o ŋ
sanggumay	s a ŋ ˈɡ u m a j
bino	ˈb i n o
obserba	ʔ o b s e ɾ ˈb a
tumpa	t u m ˈp a
sibasib	s i ˈb a s i b
jontis	ˈd͡ʒ o n t i s
kabit	k a ˈb i t
itapat	ʔ i t a ˈp a t
tabon	ˈt a b o n
maghasik	m a ɡ h a ˈs i k
balana	ˈb a l a n a
pagatasan	p a ɡ a ˈt a s a n
yagong	ˈj a ɡ o ŋ
sarsaparilya	s a ɾ s a p a ˈɾ i l j a
kasapuwego	k a s a p u ˈe ɡ o
tambolero	t a m b o ˈl e ɾ o
usong	ˈʔ u s o ŋ
direktora	d i ɾ e k ˈt o ɾ a
pulpol	p u l ˈp o l
gawin	ɡ a ˈw i n
panggatong	p a ŋ ˈɡ a t o ŋ
habonero	h a b o ˈn e ɾ o
ostrasismo	ʔ o s t ɾ a ˈs i s m o
magnate	m a ɡ ˈn a t e
Montaño	m o n ˈt a ɲ o
maagap	m a ˈʔ a ɡ a p
perspektibo	p e ɾ s p e k ˈt i b o
bituka	b i ˈt u k a
balakyot	b a l a k ˈj o t
bulig	b u ˈl i ɡ
sumite	s u m i ˈt e
dekwatin	ˈd e k w a t i n
pandangal	p a n ˈd a ŋ a l
tagahanga	t a ɡ a ˈh a ŋ a ʔ
hilaw	h i ˈl a w
Ayako	ʔ a ˈj a k o
Samonte	s a ˈm o n t e
Fukien	ˈf u k j e n
Kapitan	k a p i ˈt a n
gulat	ˈɡ u l a t
Garces	ˈɡ a ɾ s e s
sagot	s a ˈɡ o t
karta	ˈk a ɾ t a
tunggali	t u ŋ ˈɡ a l i ʔ
oranggutan	ʔ o ˈɾ a ŋ ɡ u t a n
kuwarenta	k u a ˈɾ e n t a
lugaw	ˈl u ɡ a w
Kulas	k u ˈl a s
singa	s i ˈŋ a
bilyon	b i l ˈj o n
pantalon	p a n t a ˈl o n
paskuwa	ˈp a s k u a
aaaban	ʔ a ʔ a ʔ a ˈb a n
aduwana	ʔ a d u ˈa n a
dado	ˈd a d o
Amelia	ʔ a ˈm i l j a
kuwadrilyon	k u a d ɾ i l ˈj o n
pasintabi	p a s i n ˈt a b i ʔ
tsireta	t͡ʃ i ˈɾ e t a
bigla	b i ɡ ˈl a ʔ
Satanas	s a t a ˈn a s
lugal	l u ˈɡ a l
grumadweyt	ɡ ɾ u ˈm a d w e j t
taniman	t a n i ˈm a n
kalsiyo	ˈk a l s j o
Leyson	ˈl e j s o n
pamahaw	p a ˈm a h a w
sundan	s u n ˈd a n
magyasyas	m a ɡ j a s ˈj a s
oslo	ˈʔ o s l o
baliwag	b a ˈl i w a ɡ
pinapagtalunan	p i ˌn a p a ɡ t a ˈl u n a n
dunong	ˈd u n o ŋ
mahalin	m a h a ˈl i n
mangmang	m a ŋ ˈm a ŋ
deretso	d e ˈɾ e t͡ʃ o
minsanan	m i n ˈs a n a n
Yoshiko	j o ˈʃ i k o
pamilyaridad	p a m i l j a ɾ i ˈd a d
Elcano	ʔ e l ˈk a n o
lakwatsera	l a k w a ˈt͡ʃ e ɾ a
kamakalawa	k a m a k a l a ˈw a
bilo	b i ˈl o
pagkasuplada	p a ɡ k a s u p ˈl a d a
pasa	p a ˈs a
empleyada	ʔ e m p l e ˈa d a
kutong	ˈk u t o ŋ
yumabong	j u ˈm a b o ŋ
patola	p a ˈt o l a
bunggo	b u ŋ ˈɡ o ʔ
Leung	ˈl j u ŋ
kalyo	ˈk a l j o
gumban	ɡ u m ˈb a n
buwa	b u ˈa ʔ
madrasta	m a d ˈɾ a s t a
basbasan	b a s b a ˈs a n
nipis	n i ˈp i s
nagdedeliryo	n a ɡ d e d e ˈl i ɾ j o
nagagandahan	n a ɡ a ɡ a n d a ˈh a n
sereno	s e ˈɾ e n o
Bolbok	b o l ˈb o k
lumot	ˈl u m o t
biyudo	b i ˈu d o
oktaba	ʔ o k ˈt a b a
Ormoc	ʔ o ɾ ˈm o k
panaderya	p a n a d e ɾ ˈj a
pamilyado	p a m i l ˈj a d o
Bogota	b o ɡ o ˈt a
amnestiya	ʔ a m n e s ˈt i a
Allison	ˈʔ a l i s o n
alinman	ʔ a l i n ˈm a n
dagos	ˈd a ɡ o s
galang	ˈɡ a l a ŋ
walo	w a ˈl o
lunaw	l u ˈn a w
Manalastas	m a n a l a s ˈt a s
makatarungan	m a k a t a ˈɾ u ŋ a n
balipik	b a ˈl i p i k
Mandaluyong	m a n d a ˈl u j o ŋ
panenteismo	p a n e n t e ˈi s m o
pumasok	p u ˈm a s o k
probinsiyana	p ɾ o b i n s i ˈa n a
Megumi	m e ˈɡ u m i
setro	ˈs e t ɾ o
kakampink	k a k a m ˈp i n k
ngani	ˈŋ a n i ʔ
Esperanto	ʔ e s p e ˈɾ a n t o
Abarca	ʔ a ˈb a ɾ k a
hitik	h i ˈt i k
banas	b a ˈn a s
pasiya	p a s i ˈa
deskumpiyado	d e s k u m p i ˈa d o
alikabok	ʔ a l i k a ˈb o k
saing	ˈs a ʔ i ŋ
noon	n o ˈʔ o n
maghimagsik	m a ɡ h i m a ɡ ˈs i k
adisyonal	ʔ a d i s j o ˈn a l
walumpu	w a l u m ˈp u ʔ
pilit	p i ˈl i t
kuwitis	k u ˈi t i s
kapre	ˈk a p ɾ e
teleolohiya	t e l e o l o ˈh i a
pakikiapid	p a k i k i ʔ a ˈp i d
Punzalan	p u n z a ˈl a n
apresyasyon	ʔ a p ɾ e s ˈj a s j o n
pating	p a ˈt i ŋ
endoso	ʔ e n ˈd o s o
tsarter	ˈt͡ʃ a ɾ t e ɾ
dutaan	d u ˈt a ʔ a n
libang	l i ˈb a ŋ
paepek	p a ʔ e ˈp e k
mangjumbag	m a ŋ ˈd͡ʒ u m b a ɡ
pamahalaan	ˌp a m a h a l a ˈʔ a n
laklak	l a k ˈl a k
buyo	ˈb u j o
polbo	ˈp o l b o
balbal	b a l ˈb a l
kuripot	k u ˈɾ i p o t
silog	s i ˈl o ɡ
daspanin	ˈd a s p a n i n
payak	p a ˈj a k
matinis	m a ˈt i n i s
talimang	t a l i ˈm a ŋ
estilo	ʔ e s ˈt i l o
beho	ˈb e h o
kupad	ˈk u p a d
Zosimo	ˈz o s i m o
palasyo	p a ˈl a s j o
pasiglahin	p a s i ɡ l a ˈh i n
Saavedra	s a ʔ a ˈv e d ɾ a
agam	ˈʔ a ɡ a m
baranggay	b a ɾ a ŋ ˈɡ a j
anubing	ʔ a ˈn u b i ŋ
eskarlata	ʔ e s k a ɾ ˈl a t a
damuho	d a ˈm u h o ʔ
lalamunan	l a l a ˈm u n a n
maselan	m a ˈs e l a n
bulyos	b u l ˈj o s
propagandista	p ɾ o p a ɡ a n ˈd i s t a
Sanchez	ˈs a n t͡ʃ e s
ngipin	ˈŋ i p i n
Barangka	b a ɾ a ŋ ˈk a ʔ
apdo	ʔ a p ˈd o
gulumihan	ɡ u l u ˈm i h a n
bilang	ˈb i l a ŋ
kontento	k o n ˈt e n t o
bilauo	b i ˈl a w o
kausap	k a ˈʔ u s a p
mabunganga	m a b u ˈŋ a ŋ a ʔ
kurus	k u ˈɾ u s
banayad	b a ˈn a j a d
apula	ʔ a ˈp u l a ʔ
Esguerra	ʔ e s ˈɡ e r a
inhenyeriya	ʔ i n h e n j e ˈɾ i a
Z	z i
Corpus	ˈk o ɾ p u s
golpe	ˈɡ o l p e
Alvaro	ˈʔ a l v a ɾ o
bukadkad	b u k a d ˈk a d
pangyari	p a ŋ ˈj a ɾ i
diko	ˈd i k o
waley	w a ˈl e j
bumigay	b u m i ˈɡ a j
Alabang	ʔ a l a ˈb a ŋ
Canoy	ˈk a n o j
durog	d u ˈɾ o ɡ
gahol	ˈɡ a h o l
trabahadora	t ɾ a b a h a ˈd o ɾ a
kahero	k a ˈh e ɾ o
kulungan	ˌk u ˈl u ŋ a n
Siason	ˈs j a s o n
kabata	k a ˈb a t a ʔ
uwak	ʔ u ˈa k
apatita	ʔ a p a ˈt i t a
klinik	ˈk l i n i k
bilangguan	b i l a ŋ ˈɡ u ʔ a n
ariangaw	ʔ a ɾ i ˈʔ a ŋ a w
aguha	ʔ a ˈɡ u h a
magusot	m a ɡ u ˈs o t
depensibo	d e p e n ˈs i b o
dalubtao	d a ˌl u b ˈt a ʔ o
dipterya	d i p ˈt e ɾ j a
ilap	ʔ i ˈl a p
kahoy	ˈk a h o j
Dagupan	d a ˈɡ u p a n
Pesigan	p e ˈs i ɡ a n
optimista	ʔ o p t i ˈm i s t a
lona	ˈl o n a
paraluman	p a ɾ a ˈl u m a n
asul	ʔ a ˈs u l
alibutran	ʔ a l i b u t ˈɾ a n
dalya	ˈd a l j a
biskuwit	b i s k u ˈi t
tula	t u ˈl a ʔ
hain	ˈh a ʔ i n
ewan	ˈʔ e w a n
albakora	ʔ a l b a ˈk o ɾ a
lentehas	l e n ˈt e h a s
gagi	ˈɡ a ɡ i ʔ
Maristela	m a ɾ i s ˈt e l a
seminaryo	s e m i ˈn a ɾ j o
garya	ˈɡ a ɾ j a ʔ
kamuning	k a m u ˈn i ŋ
mambiktima	m a m ˈb i k t i m a
ganda	ɡ a n ˈd a
okultismo	ʔ o k u l ˈt i s m o
raan	ˈɾ a ʔ a n
singsing	s i ŋ ˈs i ŋ
kolado	k o ˈl a d o
gasera	ɡ a ˈs e ɾ a
Kamatayan	k a m a ˈt a j a n
sapagkat	s a p a ɡ ˈk a t
yamo	ˈj a m o ʔ
asupre	ʔ a ˈs u p ɾ e
Salgado	s a l ˈɡ a d o
integral	ʔ i n t e ɡ ˈɾ a l
bilao	b i ˈl a ʔ o
padyak	p a d ˈj a k
disposisyon	d i s p o s i s ˈj o n
bamos	b a ˈm o s
kayumanis	k a j u ˈm a n i s
hayahay	h a ˈj a h a j
kalihim	k a ˈl i h i m
maglalaway	m a ɡ l a l a ˈw a j
anyaya	ʔ a n ˈj a j a
eskalera	ʔ e s k a ˈl e ɾ a
lingguhan	l i ŋ ˈɡ u h a n
asapran	ʔ a s a p ˈɾ a n
also	ˈʔ a l s o
deskaril	d e s k a ˈɾ i l
kariton	k a ɾ i ˈt o n
Lakan	l a ˈk a n
ligwan	l i ɡ ˈw a n
tayabutab	t a j a ˈb u t a b
helikopter	h e l i ˈk o p t e ɾ
tampay	t a m ˈp a j
Hizon	ˈh i z o n
tabernakulo	t a b e ɾ ˌn a k u ˈl o
pagkabuhay	p a ɡ k a ˈb u h a j
palintong	p a l i n ˈt o ŋ
sukdulan	s u k ˈd u l a n
Biring	b i ˈɾ i ŋ
inskripsiyon	ʔ i n s k ɾ i p s i ˈo n
redaksiyon	ɾ e d a k s i ˈo n
tikim	t i ˈk i m
Siam	s i ˈa m
reyalista	ɾ e a ˈl i s t a
makalima	m a ˈk a l i m a
pilak	ˈp i l a k
Manalo	m a ˈn a l o
Zafra	ˈz a f ɾ a
eto	ˈʔ e t o
saloy	ˈs a l o j
iyelo	ʔ i ˈe l o
ulbo	ʔ u l ˈb o ʔ
pagandahin	p a ɡ a n d a ˈh i n
lusog	l u ˈs o ɡ
Huwebes	h u ˈe b e s
oras	ˈʔ o ɾ a s
Damulag	d a ˈm u l a ɡ
Ochoa	ʔ o ˈt͡ʃ o a
karisma	k a ˈɾ i s m a
tinga	t i ˈŋ a
balabal	b a ˈl a b a l
alternatibo	ʔ a l t e ɾ n a ˈt i b o
Zamora	z a ˈm o ɾ a
arwa	ʔ a ɾ ˈw a ʔ
anghang	ʔ a ŋ ˈh a ŋ
Bulakan	b u l a ˈk a n
estapa	ʔ e s ˈt a p a
kamyas	k a m ˈj a s
sukol	s u ˈk o l
takoyaki	t a k o ˈj a k i
tiwali	t i w a ˈl i ʔ
kana	k a ˈn a ʔ
esmeralda	ʔ e s m e ˈɾ a l d a
alilis	ʔ a l i ˈl i s
pangmatanda	p a ŋ m a t a n ˈd a ʔ
bango	b a ˈŋ o
toniko	ˈt o n i k o
tingni	t i ŋ ˈn i
ponema	p o ˈn e m a
balansang	b a l a n ˈs a ŋ
danumsigwasan	d a n u m s i ɡ ˈw a s a n
penitensiya	p e n i ˈt e n s j a
batad	b a ˈt a d
biyopisika	b i o ˈp i s i k a
Maunahan	m a ʔ u ˈn a h a n
daplis	d a p ˈl i s
talos	t a ˈl o s
anek	ʔ a ˈn e k
bumagal	b u ˈm a ɡ a l
kanila	k a n i ˈl a
kuhol	k u ˈh o l
patnugot	p a t ˈn u ɡ o t
mulinilyo	m u l i ˈn i l j o
salang	ˈs a l a ŋ
Dayang	ˈd a j a ŋ
Guillermo	ɡ i l ˈj e ɾ m o
Malaruhatan	m a l a ɾ u h a ˈt a n
pagsusunog	p a ɡ s u s u ˈn o ɡ
Koji	ˈk o d͡ʒ i
sulatan	s u ˈl a t a n
siyantung	s i ˈa n t u ŋ
kampanya	k a m ˈp a n j a
taling	ˈt a l i ŋ
pambansa	p a m b a n ˈs a ʔ
letrina	l e t ˈɾ i n a
lumakas	l u m a ˈk a s
kamandag	k a m a n ˈd a ɡ
aikido	ʔ a j ˈk i d o
Bugtong	b u ɡ ˈt o ŋ
pitundaan	p i t u n d a ˈʔ a n
nino	ˈn i n o
distansiya	d i s ˈt a n s j a
mabalakid	m a b a ˈl a k i d
kulaysukat	k u l a j ˈs u k a t
anemya	ʔ a ˈn e m j a
emyenda	ʔ e m ˈj e n d a
tsokolate	t͡ʃ o k o ˈl a t e
maalamat	m a ʔ a l a ˈm a t
uraw	ʔ u ˈɾ a w
salaula	s a l a ˈʔ u l a ʔ
talaba	t a l a ˈb a
tagiliran	t a ɡ i ˈl i ɾ a n
kunsumisyon	k u n s u m i s ˈj o n
pambata	p a m ˈb a t a
awtonomiya	ʔ a w t o n o ˈm i a
Tamiko	t a ˈm i k o
gatid	ˈɡ a t i d
patidyugto	p a t i d j u ɡ ˈt o ʔ
sakong	ˈs a k o ŋ
bukambibig	b u k a m b i ˈb i ɡ
Jocson	ˈh o k s o n
lagundi	l a ɡ u n ˈd i ʔ
nananamantala	n a n a n a m a n t a ˈl a
Lupa	ˈl u p a ʔ
bungangera	b u ŋ a ˈŋ e ɾ a
kalo	ˈk a l o ʔ
magdaos	p a ɡ ˈd a ʔ o s
impormal	ʔ i m p o ɾ ˈm a l
Salcedo	s a l ˈs e d o
katastrope	k a ˈt a s t ɾ o p e
padyama	p a d ˈj a m a
duweto	d u ˈe t o
Dee	d i
bumalikwas	b u m a l i k ˈw a s
dagim	d a ˈɡ i m
lumboy	l u m ˈb o j
tol	ˈt o l
paglilitis	p a ɡ l i ˈl i t i s
halip	h a ˈl i p
kalumbahin	k a l u m b a ˈh i n
soberano	s o b e ˈɾ a n o
Albano	ʔ a l ˈb a n o
lumuklok	l u m u k ˈl o k
pitsel	p i ˈt͡ʃ e l
olat	ˈʔ o l a t
Enero	ʔ e ˈn e ɾ o
solusyon	s o l u s ˈj o n
masalimuot	m a s a l i ˈm u ʔ o t
Tien	ˈt j e n
tanghalian	t a ŋ h a ˈl i ʔ a n
nang	n a ŋ
maulanan	m a ʔ u l a ˈn a n
tilarok	t i ˈl a ɾ o k
rumupok	ɾ u m u ˈp o k
iti	ˈʔ i t i
Gumaca	ɡ u ˈm a k a
inspeksiyon	ʔ i n s p e k s i ˈo n
balon	b a ˈl o n
Piñon	p i ˈɲ o n
dumaigdig	d u m a ʔ i ɡ ˈd i ɡ
maaari	m a ʔ a ˈʔ a ɾ i ʔ
alamang	ʔ a l a ˈm a ŋ
lambayog	l a m ˈb a j o ɡ
tsumaka	t͡ʃ u ˈm a k a
silbiro	s i l ˈb i ɾ o
gagapang	ɡ a ˈɡ a p a ŋ
bilingguwal	b i l i ŋ ɡ u ˈa l
praning	p ɾ a ˈn i ŋ
landi	l a n ˈd i ʔ
palarindingan	p a l a ɾ i n ˈd i ŋ a n
tungki	t u ŋ ˈk i ʔ
pangko	p a ŋ ˈk o
bisitahin	b i s i ˈt a h i n
Manaog	m a ˈn a ʔ o ɡ
yate	ˈj a t e
Valera	v a ˈl e ɾ a
bahagdan	b a h a ɡ ˈd a n
sepilyo	s e ˈp i l j o
pakyaw	p a k ˈj a w
Gonzales	ɡ o n ˈz a l e s
panlinis	p a n ˈl i n i s
higliknayan	h i ɡ l i k ˈn a j a n
dulis	ˈd u l i s
wilik	ˈw i l i k
eksorsismo	ʔ e k s o ɾ ˈs i s m o
