كثيرا	k a θ iː r aː
تساوى	t a s aː w aː
شاط	ʃ aː tˤ a
مغلق	m i ɣ l a q
سلسل	s a l s a l a
كلوتة	k a l l a w t a
حيران	ħ a j r aː n
أصغى	ʔ a sˤ ɣ aː
أهلي	ʔ a h l i j j
نخشوش	n a x ʃ uː ʃ
أعاصير	ʔ a ʕ aː sˤ iː r
أفرط	ʔ a f r a tˤ a
قرن	q a r a n a
طلعة	tˤ a l ʕ a
خرس	x a r a s a
أصلع	ʔ a sˤ l a ʕ
خسأ	x a s a ʔ a
إلى	ʔ i l aː
مكمل	m u k a m m a l
حديد	ħ a d iː d
مستفرغ	m u s t a f r a ɣ
عنبروت	ʕ a n b a r uː t
تراوح	t a r aː w a ħ a
دحرج	d a ħ r a d͡ʒ a
مبرة	m a b a r r a
اغتنم	i ɣ t a n a m a
بسفايج	b a s f aː j a d͡ʒ
نيوزيلاندا	n i j uː z iː l aː n d aː
إبادة	ʔ i b aː d a
مهرة	m u h r a
أمضى	ʔ a m dˤ aː
مجن	m i d͡ʒ a n n
لحاق	l a ħ aː q
تفاوض	t a f aː w a dˤ a
أدهش	ʔ a d h a ʃ a
اقتسم	i q t a s a m a
قاليقالا	q aː l iː q aː l aː
ركلة	r a k l a
إنما	ʔ i n n a m aː
سفينة	s a f iː n a
دجلة	d i d͡ʒ l a
كثافة	k a θ aː f a
بادية	b aː d i j a
سجنجل	s a d͡ʒ a n d͡ʒ a l
منبه	m u n a b b i h
بارد	b aː r i d
متجر	m a t d͡ʒ a r
أجل	ʔ a d͡ʒ a l
لاحم	l aː ħ i m
جوذاب	d͡ʒ uː ð aː b
زفر	z a f a r a
طاقم	tˤ aː q a m
أسترالي	ʔ u s t u r aː l i j j
شظية	ʃ a ðˤ i j j a
أباسخيرون	ʔ a b aː s x iː r uː n
عادات	ʕ aː d aː t
مؤنث	m u ʔ a n n a θ
فيثاغورس	f iː θ aː ɣ uː r a s
دونمة	d uː n m a
عربز	ʕ a r b a z
كوسا	k uː s aː
قادوس	q aː d uː s
لعبة	l a ʕ b a
أسبوع	ʔ u s b uː ʕ
قفلوط	q a f a l uː tˤ
أعل	ʔ a ʕ a l l a
ساط	s aː tˤ a
ذال	ð aː l
الوداع	a l w a d aː ʕ
لبنان	l u b n aː n
طريق	tˤ a r iː q
صهيوني	sˤ a h j uː n i j j
اكتنف	i k t a n a f a
لهي	l a h i j a
تخلص	t a x a l l a sˤ a
جشاء	d͡ʒ u ʃ aː ʔ
مطاف	m a tˤ aː f
صحافة	sˤ a ħ aː f a
أنفحة	ʔ a n f i ħ a
مكان	m a k aː n
هذه	h aː ð i h
أوج	ʔ a w d͡ʒ
يابس	j aː b i s
رضيع	r a dˤ iː ʕ
شاورما	ʃ aː w a r m aː
شاهد	ʃ aː h a d a
مقود	m i q w a d
متزوج	m u t a z a w w i d͡ʒ
أناغلس	ʔ a n aː ɣ a l i s
توارى	t a w aː r aː
جميز	d͡ʒ u m m a j z
آشوري	ʔ aː ʃ uː r i j j
إجبار	ʔ i d͡ʒ b aː r
حماس	ħ a m aː s
راكب	r aː k i b
مستقبلي	m u s t a q b a l i j j
سنونو	s u n uː n uː
حرير	ħ a r iː r
بعث	b a ʕ a θ a
النرويج	a n n u r w iː d͡ʒ
سمويل	s a m a w iː l
كعبة	k a ʕ b a
انسجام	i n s i d͡ʒ aː m
ليلي	l a j l i j j
ناصور	n aː sˤ uː r
عنى	ʕ a n aː
تداعى	t a d aː ʕ aː
أنتم	ʔ a n t u m
شيردال	ʃ iː r d aː l
مرأة	m a r ʔ a
تبرير	t a b r iː r
تناسق	t a n aː s u q
ساوم	s aː w a m a
جور	d͡ʒ a w r
شارع	ʃ aː r i ʕ
معيار	m i ʕ j aː r
أباخس	ʔ a b aː x i s u
يلب	j a l a b
عظيم	ʕ a ðˤ iː m
مخطئ	m u x tˤ i ʔ
تاوريرت	t aː w r iː r t
جانرك	d͡ʒ aː n a r i k
بغتة	b a ɣ t a
نواكشوط	n a w aː k ʃ uː tˤ
حاجة	ħ aː d͡ʒ a
أميرة	ʔ a m iː r a
فضول	f dˤ uː l
استجار	i s t a d͡ʒ aː r a
الصويرة	a sˤ sˤ a w iː r a
عفريت	ʕ a f r iː t
كفاح	k i f aː ħ
إغناطيوس	ʔ i ɣ n aː tˤ i j uː s
حجن	ħ a d͡ʒ a n a
منيرة	m u n iː r a
ملموم	m a l m uː m
مأدبة	m a ʔ d u b a
صفن	sˤ a f a n
خالف	x aː l a f a
مردي	m u r d i j j
بامية	b aː m i j a
ركيزة	r a k iː z a
هنغاري	h a n ɣ aː r i j j
منور	m a n w a r
بخص	b a x a sˤ
جمان	d͡ʒ u m aː n
منهج	m a n h a d͡ʒ
خوي	x a w i j a
شماس	ʃ a m m aː s
ذبابة	ð u b aː b a
ديس	d iː s
قشمير	q i ʃ m iː r
اعتلى	i ʕ t a l aː
جمانة	d͡ʒ u m aː n a
ليل	l a j l
خور	x a w r
رئاسي	r i ʔ aː s i j j
نعناع	n a ʕ n aː ʕ
متصل	m u t t a sˤ i l
تغريدة	t a ɣ r iː d a
فور	f a w r
رعراع	r a ʕ r aː ʕ
دارويني	d aː r w iː n i j j
بربير	b a r b iː r
أنواط	ʔ a n w aː tˤ
صورة	sˤ uː r a
أنوق	ʔ a n uː q
خرشوف	x u r ʃ uː f
تزامن	t a z aː m a n a
جوهري	d͡ʒ a w h a r i j j
نون	n a w w a n a
خصية	x i sˤ j a
شمبانيا	ʃ a m b aː n j aː
سمن	s a m i n a
بيع	b a j ʕ
أرضي	ʔ a r dˤ i j j
أجنبي	ʔ a d͡ʒ n a b i j j
تايوان	t aː j w aː n
عطر	ʕ a tˤ i r
زنباع	z a n b aː ʕ
هرول	h a r w a l
عبودية	ʕ u b uː d i j j a
أعض	ʔ a ʕ a dˤ dˤ a
قرصعنة	q a r sˤ a ʕ a n n a
حاذق	ħ aː ð i q
الصين	a sˤ sˤ iː n
فاثور	f aː θ uː r
قناع	q i n aː ʕ
صحا	sˤ a ħ aː
ناخوذاة	n aː x uː ð aː h
مثلث	m u θ a l l a θ
سكة	s i k k a
أوقية	ʔ uː q i j j a
فحشاء	f a ħ ʃ aː ʔ
دردق	d a r d a q
صمام	sˤ i m aː m
عنوسة	ʕ u n uː s a
تراخوما	t a r aː x uː m aː
ثوب	θ a w b
موقد	m a w q i d
تخت	t a x t
سبتمبر	s a b t a m b a r
تسلم	t a s a l l a m a
آنسة	ʔ aː n i s a
إريس	ʔ i r r iː s
يهوه	j a h w a h
كربون	k a r b uː n
قصاب	q a sˤ sˤ aː b
منار	m a n aː r
إهداء	ʔ i h d aː ʔ
إيران	ʔ iː r aː n
ناعور	n aː ʕ uː r
رابطة	r aː b i tˤ a
عبادة	ʕ i b aː d a
عنصر	ʕ u n sˤ u r
تناوم	t a n aː w a m a
حنجري	ħ a n d͡ʒ a r i j j
قستوس	q i s t uː s
كثيب	k a θ iː b
زربطانة	z a r b a tˤ aː n a
لاط	l aː tˤ a
سلا	s a l aː
معهد	m a ʕ h a d
بحيرة	b u ħ a j r a
غالب	ɣ aː l i b
نظر	n a ðˤ a r
شلة	ʃ a l l a
هوادة	h a w aː d a
باريس	b aː r iː s
تشبث	t a ʃ a b b a θ a
رؤوس	r u ʔ uː s
بسمة	b a s m a
رابط	r aː b i tˤ
عظمى	ʕ u ðˤ m aː
قاوون	q aː w uː n
ركع	r a k a ʕ a
انبث	i n b a θ θ a
زاوية	z aː w i j a
بندر	b a n d a r
ترياق	t i r j aː q
تكفيري	t a k f iː r i j j
طشقند	tˤ a ʃ q a n d
ملاحقة	m u l aː ħ a q a
مفوف	m u f a w w a f
فاقة	f aː q a
غدير	ɣ a d iː r
أهيف	ʔ a h j a f
اللات	a l l aː t
خزينة	x a z iː n a
تدريب	t a d r iː b
ركن	r u k n
أدان	ʔ a d aː n a
رصع	r a sˤ sˤ a ʕ a
جنطيانا	d͡ʒ a n tˤ i j aː n aː
مغلوب	m a ɣ l uː b
مدرسة	m a d r a s a
بذرقطونا	b a ð a r q a tˤ uː n aː
شمات	ʃ a m aː t
حذار	ħ a ð aː r i
وديعة	w a d iː ʕ a
إصبع	ʔ i sˤ b a ʕ
وعدة	w a ʕ d a
فيجن	f a j d͡ʒ a n
مرقد	m a r q a d
هزيل	h a z iː l
غامق	ɣ aː m i q
إسحاق	ʔ i s ħ aː q
شهادة	ʃ a h aː d a
عدمية	ʕ a d a m i j j a
أجيال	ʔ a d͡ʒ j aː l
سويسري	s u w iː s r i j j
تاريخ	t aː r iː x
خربش	x a r b a ʃ a
أسفر	ʔ a s f a r a
شهدانق	ʃ a h d aː n a q
رسغ	r u s ɣ
جاذبية	d͡ʒ aː ð i b i j j a
حصرم	ħ a sˤ r a m
دعوة	d a ʕ w a
فدان	f a d d aː n
تعصر	t a ʕ a sˤ sˤ a r a
صوة	sˤ u w w a
تدليك	t a d l iː k
كشمش	k i ʃ m i ʃ
لثم	l a θ a m a
مصفاة	m i sˤ f aː h
حافظة	ħ aː f i ðˤ a
قلل	q a l l a l a
خلفي	x a l f i j j
راتينج	r aː t iː n a d͡ʒ
فانيذ	f aː n iː ð
حدوة	ħ a d w a
إذاعة	ʔ i ð aː ʕ a
بوتان	b uː t aː n
كفى	k a f aː
سانية	s aː n i j a
إنموذج	ʔ i n m uː ð a d͡ʒ
مقارنة	m u q aː r a n a
ابتذل	i b t a ð a l a
اكتحل	i k t a ħ a l a
شوح	ʃ uː ħ
انسلخ	i n s a l a x a
الإنجيل	a l ʔ i n d͡ʒ iː l
قبالة	q a b aː l a
حوجلة	ħ a w d͡ʒ a l a
فهم	f a h h a m a
غضاضة	ɣ a dˤ aː dˤ a
السويد	a s s u w a j d
أنيون	ʔ a n j uː n
ولكن	w a l aː k i n
بنان	b a n aː n
أزعج	ʔ a z ʕ a d͡ʒ a
تاء	t aː ʔ
بيش	b iː ʃ
خامس	x aː m i s
عتيق	ʕ a t iː q
روس	r a w w a s a
طرمبة	tˤ r u m b a
متشكر	m u t a ʃ a k k i r
محاضرة	m u ħ aː dˤ a r a
مزدهر	m u z d a h i r
غافت	ɣ aː f a t
كازاخستان	k aː z aː x i s t aː n
نحال	n a ħ ħ aː l
سريع	s a r iː ʕ
لكن	l aː k i n
غسق	ɣ a s a q
ديسم	d a j s a m
أقضى	ʔ a q dˤ aː
فادي	f aː d iː
دلب	d u l b
أنيسون	ʔ a n iː s uː n
طنجير	tˤ a n d͡ʒ iː r
عودة	ʕ a w d a
سهل	s a h h a l a
غضب	ɣ a dˤ a b
اندلع	i n d a l a ʕ a
صيفة	sˤ a j f a
سعار	s u ʕ aː r
إملاء	ʔ i m l aː ʔ
وجوم	w u d͡ʒ uː m
اتجه	i t t a d͡ʒ a h a
كسيح	k a s iː ħ
ضمني	dˤ i m n i j j
ستار	s i t aː r
ميتوكندريون	m iː t uː k u n d r i j uː n
مجموعة	m a d͡ʒ m uː ʕ a
بليحا	b a l iː ħ aː
سهر	s a h i r a
إجاصة	ʔ i d͡ʒ d͡ʒ aː sˤ a
بسكرة	b i s k a r a
بين	b a j n a
جنين	d͡ʒ a n iː n
ضائن	dˤ aː ʔ i n
هبيد	h a b iː d
جنيف	d͡ʒ i n iː f
نسبوية	n i s b a w i j j a
فعالية	f a ʕ ʕ aː l i j j a
بغي	b a ɣ i j j
نسبي	n i s b i j j
شكال	ʃ i k aː l
حاط	ħ aː tˤ a
هالوك	h aː l uː k
هجليج	h a d͡ʒ l iː d͡ʒ
سدر	s a d i r a
أطل	ʔ a tˤ a l l a
تأسف	t a ʔ a s s a f a
تقدس	t a q a d d a s a
ملقن	m u l a q q i n
ضمير	dˤ a m iː r
أوريغون	ʔ uː r iː ɣ uː n
سكي	s a k k i j j
مزاد	m a z aː d
شيعة	ʃ iː ʕ a
خصيب	x a sˤ iː b
أخلاط	ʔ a x l aː tˤ
فرهد	f a r h a d
نعال	n i ʕ aː l
تذمر	t a ð a m m a r a
كستيج	k u s t iː d͡ʒ
إغريقي	ʔ i ɣ r iː q i j j
صادف	sˤ aː d a f a
تالي	t aː l iː
أفلاطون	ʔ a f l aː tˤ uː n
فرث	f a r a θ a
مائت	m aː ʔ i t
نساء	n a s aː ʔ
علاجي	ʕ i l aː d͡ʒ iː
أوكلاهوما	ʔ uː k l aː h uː m aː
سيرج	s a j r a d͡ʒ
أبله	ʔ a b l a h
غاص	ɣ aː sˤ a
جيم	d͡ʒ iː m
خلاط	x i l aː tˤ
عصير	ʕ a sˤ iː r
تحوط	t a ħ a w w a tˤ a
كاراطي	k aː r aː tˤ iː
إرهابي	ʔ i r h aː b i j j
عادم	ʕ aː d i m
ثدياء	θ a d j aː ʔ
تحكم	t a ħ a k k a m a
رقبة	r a q a b a
ترنجان	t u r u n d͡ʒ aː n
ضمة	dˤ a m m a
هدس	h a d a s
تساقط	t a s aː q a tˤ a
اعتنى	i ʕ t a n aː
أرسطوطاليس	ʔ a r i s tˤ uː tˤ aː l iː s
إفريقية	ʔ i f r iː q i j a
إشغال	ʔ i ʃ ɣ aː l
عقرب	ʕ a q r a b
عنق	ʕ a n a q
تململ	t a m a l m a l a
ظمئ	ðˤ a m i ʔ a
سعدان	s a ʕ d aː n
تغلب	t a ɣ a l l a b a
كناب	k i n aː b
عرعر	ʕ a r ʕ a r
تعسفي	t a ʕ a s s u f i j j
بلجيكا	b a l d͡ʒ iː k a
أرجواني	ʔ a r d͡ʒ u w aː n i j j
رمان	r u m m aː n
دويبة	d u w a j b b a
تقدم	t a q a d d a m a
موسمي	m a w s i m i j j
وصيد	w a sˤ iː d
ميانمار	m i j aː n m aː r
القرآن	a l q u r ʔ aː n
بسباسة	b a s b aː s a
رثية	r a θ j a
أنعم	ʔ a n ʕ a m
ناجذ	n aː d͡ʒ i ð
كره	k a r h
اشهلال	i ʃ h i l aː l
ثلاثون	θ a l aː θ uː n a
فنلندا	f i n l a n d aː
محدلة	m i ħ d a l a
ياي	j aː j
مبالغة	m u b aː l a ɣ a
معتدل	m u ʕ t a d i l
جلهم	d͡ʒ a l h a m
أكاذيب	ʔ a k aː ð iː b
مواطنة	m u w aː tˤ a n a
أريكا	ʔ a r iː k aː
رقم	r a q m
كذينق	k u ð iː n a q
أشهل	ʔ a ʃ h a l
استغاث	i s t a ɣ aː θ a
قطبي	q u tˤ b i j j
طمث	tˤ a m θ
شيلثا	ʃ iː l θ aː
حصان	ħ i sˤ aː n
جذر	d͡ʒ a ð a r a
شعرى	ʃ a ʕ r aː
درأ	d a r a ʔ a
أيقن	ʔ a j q a n a
خطام	x i tˤ aː m
ثقيل	θ a q iː l
صحل	sˤ a ħ i l a
طموحات	tˤ u m uː ħ aː t
تليس	t a l l iː s
صومعة	sˤ a w m a ʕ a
تأمور	t a ʔ m uː r
طباق	tˤ a b b aː q
خوف	x a w f
تسعة	t i s ʕ a
مبكر	m u b a k k i r
اجتماع	i d͡ʒ t i m aː ʕ
تاريخية	t aː r iː x i j j a
ريح	r a j j a ħ a
معمل	m a ʕ m a l
خوخ	x a w x
سياسة	s i j aː s a
أسطمة	ʔ u s tˤ u m m a
حرج	ħ a r i d͡ʒ a
مقدار	m i q d aː r
أنعل	ʔ a n ʕ u l
دبغ	d a b a ɣ a
نهزة	n u h z a
اكتفى	i k t a f aː
أنسون	ʔ a n s uː n
فرفيري	f i r f iː r i j j
ضوء	dˤ a w ʔ
دشمة	d u ʃ m a
قملة	q a m l a
رتيل	r u t a j l
سويدي	s u w a j d i j j
تعشيقة	t a ʕ i ʃ iː q a
فاجرة	f aː d͡ʒ i r a
قصيل	q a sˤ iː l
قرظ	q a r a ðˤ
طرق	tˤ a r a q a
شاهدانق	ʃ aː h d aː n a q
نيفق	n a j f a q
قيلولة	q a j l uː l a
نمر	n a m i r
كستج	k a s t a d͡ʒ
مريء	m a r iː ʔ
جبران	d͡ʒ u b r aː n
نفقة	n a f a q a
صحة	sˤ i ħ ħ a
مسخ	m a s a x a
صناب	sˤ i n aː b
براق	b a r r aː q
مليق	m a l iː q
تلاشى	t a l aː ʃ aː
أيرلندا	ʔ a j i r l a n d aː
شحن	ʃ a ħ a n a
ثقبة	θ u q b a
عجلة	ʕ a d͡ʒ a l a
صفع	sˤ a f a ʕ a
جبت	d͡ʒ i b t
اشهل	i ʃ h a l l a
جوز	d͡ʒ a w z
نفوذ	n a f uː ð
عمروسة	ʕ a m r uː s a
قصرية	q a sˤ r i j j a
أطيان	ʔ a tˤ j aː n
حاشا	ħ aː ʃ aː
ضمان	dˤ a m aː n
شهاب	ʃ i h aː b
بواب	b a w w aː b
البرازيل	a l b a r aː z iː l
فلو	f a l u w w
هدهد	h a d h a d a
دكان	d u k k aː n
بذج	b a ð a d͡ʒ
جمال	d͡ʒ a m aː l
وزراء	w u z a r aː ʔ
مبدأ	m a b d a ʔ
سدارة	s a d aː r a
تترى	t a t r aː
بكين	b i k iː n
جزمازق	d͡ʒ a z m aː z a q
جرثوم	d͡ʒ u r θ uː m
سكنجبين	s i k a n d͡ʒ a b iː n
عباءة	ʕ a b aː ʔ a
وغل	w a ɣ a l a
بغاء	b i ɣ aː ʔ
وضوح	w u dˤ uː ħ
استمنى	i s t a m n aː
قالب	q aː l a b
وصى	w a sˤ sˤ aː
طواجن	tˤ a w aː d͡ʒ i n
جثة	d͡ʒ u θ θ a
فردي	f a r d i j j
علة	ʕ i l l a
ببنودة	b a b n uː d a
نخاسة	n i x aː s a
بيطرة	b a j tˤ a r a
ساحلي	s aː ħ i l i j j
كعك	k a ʕ k
تدخين	t a d x iː n
آدمي	ʔ aː d a m i j j
أخدود	ʔ u x d uː d
ابتلى	i b t a l aː
زنبور	z a n b uː r
احتكار	i ħ t i k aː r
قذيفة	q a ð iː f a
عالمي	ʕ aː l a m i j j
مساطر	m a s aː tˤ i r
بيفام	b iː f aː m
نصاب	n a sˤ sˤ aː b
تجارة	t i d͡ʒ aː r a
منالاوس	m i n aː l aː w u s
بازار	b aː z aː r
هبد	h a b d
سلجم	s a l d͡ʒ a m
سائمة	s aː ʔ i m a
آخرة	ʔ aː x i r a
لكمة	l a k m a
مخروطي	m a x r uː tˤ i j j
ماثل	m aː θ a l a
فوضى	f a w dˤ aː
فالوذة	f aː l uː ð a
إقالة	ʔ i q aː l a
صئم	sˤ a ʔ i m a
بوسكورة	b uː s k uː r a
هدى	h a d aː
تحدى	t a ħ a d d aː
السنغال	a s s i n i ɣ aː l
عاطفي	ʕ aː tˤ i f i j j
محايد	m u ħ aː j i d
مغن	m u ɣ a n n i n
دنر	d a n n a r a
استثمار	i s t i θ m aː r
ممتلئ	m u m t a l i ʔ
سلة	s a l l a
أكسيد	ʔ u k s iː d
كرج	k a r i d͡ʒ a
معاء	m i ʕ aː ʔ
ضمخ	dˤ a m a x a
أنطاكية	ʔ a n tˤ aː k i j a
قيتار	q iː t aː r
مصعد	m i sˤ ʕ a d
قنطرة	q a n tˤ a r a
ودج	w a d a d͡ʒ
طفولة	tˤ u f uː l a
السبت	a s s a b t
سخبر	s a x b a r
شاكرة	ʃ aː k i r a
رخيص	r a x iː sˤ
أفاويه	ʔ a f aː w iː h
اختلف	i x t a l a f a
دشداشة	d i ʃ d aː ʃ a
حجر	ħ a d͡ʒ a r
إسكاف	ʔ i s k aː f
تواقف	t a w aː q a f a
شدد	ʃ a d d a d a
محمد	m a ħ m a d
قنبيط	q u n n a b iː tˤ
استفز	i s t a f a z z a
السودان	a s s uː d aː n
تانبول	t aː n a b uː l
لسع	l a s a ʕ a
بربري	b a r b a r i j j
مشوي	m a ʃ w i j j
باروق	b aː r uː q
مينا	m iː n aː
تسعمائة	t i s ʕ u m i ʔ a
جرذ	d͡ʒ u r a ð
منتخب	m u n t a x a b
نقطة	n u q tˤ a
بهشية	b a h a ʃ i j j a
جريد	d͡ʒ a r iː d
براءة	b a r aː ʔ a
سجلاط	s i d͡ʒ i l l aː tˤ
أخشن	ʔ a x ʃ a n
مدلجة	m i d l a d͡ʒ a
أعتن	ʔ a ʕ t a n a
سبب	s a b a b
سلبي	s a l b i j j
شفة	ʃ a f a
تنديل	t a n d iː l
شهوة	ʃ a h w a
بركان	b a r k aː n
مخدر	m u x a d d i r
مقصلة	m i q sˤ a l a
قوة	q u w w a
دفتر	d a f t a r
هزل	h a z a l a
هالك	h aː l i k
انتقد	i n t a q a d a
بنما	b a n a m aː
مماثلة	m u m aː θ a l a
نصراني	n a sˤ r aː n i j j
ذكر	ð a k a r
نشيد	n a ʃ iː d
لقمة	l u q m a
بئسما	b i ʔ s a m aː
عقاري	ʕ a q aː r i j j
اعتمد	i ʕ t a m a d a
غمغم	ɣ a m ɣ a m a
لبوس	l a b uː s
أناخ	ʔ a n aː x a
زكام	z u k aː m
لهجة	l a h d͡ʒ a
اتهام	i t t i h aː m
مستوقد	m u s t a w q a d
طما	tˤ a m aː
دبج	d a b b a d͡ʒ a
مدفأ	m i d f a ʔ
فقري	f i q r i j j
سبسب	s a b s a b
فجل	f a d͡ʒ a l
هنيهة	h u n a j h a
أنموذج	ʔ u n m uː ð a d͡ʒ
استنفد	i s t a n f a d a
متوفر	m u t a w a f f i r
غابي	ɣ aː b i j j
برسيم	b i r s iː m
عمودي	ʕ a m uː d i j j
عفت	ʕ a f a t a
صغار	sˤ i ɣ aː r
مجراف	m i d͡ʒ r aː f
ملأك	m a l ʔ a k
أحاط	ʔ a ħ aː tˤ a
هجاء	h a d͡ʒ d͡ʒ aː ʔ
ارتقب	i r t a q a b a
مخيم	m u x a j j a m
سخيف	s a x iː f
مجادلة	m u d͡ʒ aː d a l a h
قاقلة	q aː q i l l a
قيتارة	q iː t aː r a
غلب	ɣ a l a b
نيلج	n a j l a d͡ʒ
أسمر	ʔ a s m a r
بعير	b a ʕ iː r
حنجرة	ħ a n d͡ʒ a r a
شمشار	ʃ a m ʃ aː r
قول	q a w l
برذعة	b a r ð a ʕ a
دبلجة	d a b l a d͡ʒ a
صيدلية	sˤ a j d a l i j j a
دبي	d i b b iː
فرقاطة	f i r q aː tˤ a
جذع	d͡ʒ a ð a ʕ
مأزق	m a ʔ z i q
قنصلية	q u n sˤ u l i j j a
تلفاز	t i l f aː z
سمك	s a m a k
بلوة	b i l w a
لفف	l a f f a f a
ساج	s aː d͡ʒ
قيثارات	q iː θ aː r aː t
شرب	ʃ a r i b a
كسا	k a s aː
اشتهى	i ʃ t a h aː
نجي	n a d͡ʒ i j j
مجسمة	m u d͡ʒ a s s a m a
مناة	m a n aː h
يانصيب	j aː n a sˤ iː b
شذر	ʃ a ð r
حنيف	ħ a n iː f
كدس	k a d a s a
شريان	ʃ a r j aː n
تناعس	t a n aː ʕ a s a
حزاء	ħ a z aː ʔ
حفار	ħ a f f aː r
تمتم	t a m t a m a
مقدونس	m a q d uː n i s
رباعيات	r u b aː ʕ i j j aː t
بهرج	b a h r a d͡ʒ
شقة	ʃ a q q a
رذاذ	r a ð aː ð
كندس	k u n d u s
ناقص	n aː q i sˤ
أعمى	ʔ a ʕ m aː
احتفال	i ħ t i f aː l
أمسك	ʔ a m s a k a
حطاب	ħ a tˤ tˤ aː b
هذر	h a ð a r a
اتحاد	i t t i ħ aː d
عانى	ʕ aː n aː
خلر	x u l l a r
منتصف	m u n t a sˤ a f
إفادة	ʔ i f aː d a
الأرجنتين	a l ʔ a r d͡ʒ a n t iː n
منبر	m i n b a r
صيدلي	sˤ a j d a l i j j
أنضج	ʔ a n dˤ a d͡ʒ a
الحارث	a l ħ aː r i θ
زرزر	z u r z u r
اصطدأ	i sˤ tˤ a d a ʔ a
رسداق	r u s d aː q
أنور	ʔ a n w a r
مديرة	m u d iː r a
ترصد	t a r a sˤ sˤ a d a
مراوغة	m u r aː w a ɣ a
ثوم	θ uː m
تقني	t i q n i j j
أمهل	ʔ a m h a l a
كازخستان	k aː z a x i s t aː n
أعز	ʔ a ʕ a z z
أيهقان	ʔ a j h a q aː n
إلياس	ʔ i l j aː s
وردة	w a r d a
أهدى	ʔ a h d aː
تجرع	t a d͡ʒ a r r a ʕ a
نافى	n aː f aː
كهرومغناطيسي	k a h r uː m i ɣ n aː tˤ iː s i j j
مثنوية	m a θ n a w i j j a
مسطرة	m i s tˤ a r a
جنح	d͡ʒ u n ħ
ديبوذ	d a j b uː ð
آلة	ʔ aː l a
سيس	s a j j a s a
قرصنة	q a r sˤ a n a
أفلس	ʔ a f l a s a
ارتعش	i r t a ʕ a ʃ a
مخفر	m a x f a r
رام	r aː m a
بنجر	b a n d͡ʒ a r
قيطون	q a j tˤ uː n
تبريز	t a b r iː z
يوسف	j uː s i f
اشتباه	i ʃ t i b aː h
إبريل	ʔ i b r iː l
انسل	i n s a l l a
لواط	l i w aː tˤ
معنوي	m a ʕ n a w i j j
بيض	b a j dˤ
حلول	ħ u l uː l
فتة	f a t t a
جخى	d͡ʒ a x x aː
تدريج	t a d r iː d͡ʒ
تجوف	t a d͡ʒ a w w a f a
جماد	d͡ʒ a m aː d
استعمر	i s t a ʕ m a r a
أكرى	ʔ a k r aː
اعتقل	i ʕ t a q a l a
سجستان	s a d͡ʒ i s t aː n
بيت	b a j j a t a
إيصاء	ʔ iː sˤ aː ʔ
غنيمة	ɣ a n iː m a
حانوت	ħ aː n uː t
جزدان	d͡ʒ i z d aː n
أقر	ʔ a q a r r a
عمة	ʕ a m m a
صاخب	sˤ aː x i b
حادث	ħ aː d a θ a
الكويت	a l k u w a j t
مسموح	m a s m uː ħ
أمصوخ	ʔ u m sˤ uː x
حصبة	ħ a sˤ b a
منذ	m u n ð u
جميلة	d͡ʒ a m iː l a
اختتم	i x t a t a m a
مالاوي	m aː l aː w iː
نشادر	n u ʃ aː d i r
كوم	k a w m
نباهة	n a b aː h a
أدب	ʔ a d a b
رغوة	r a ɣ w a
بقبق	b a q b a q a
بقشة	b u q ʃ a
ميزان	m iː z aː n
لذلك	l i ð aː l i k a
ملوخية	m u l uː x i j j a
أمس	ʔ a m a s s a
تشاعر	t a ʃ aː ʕ a r a
قلاية	q a l l aː j a
مطبعة	m a tˤ b a ʕ a
بؤر	b u ʔ a r
استوقف	i s t a w q a f a
رضة	r a dˤ dˤ a
إسكتلندا	ʔ i s k u t l a n d aː
طار	tˤ aː r a
أخامص	ʔ a x aː m i sˤ
وحل	w a ħ l
قارون	q aː r uː n
مفلفل	m u f a l f a l
عزيمة	ʕ a z iː m a
تغريد	t a ɣ r iː d
فريسة	f a r iː s a
استهلك	i s t a h l a k a
هوري	h uː r i j j
دماغي	d i m aː ɣ i j j
أمير	ʔ a m iː r
أزعر	ʔ a z ʕ a r
طرخون	tˤ a r x uː n
زنبوع	z a n b uː ʕ
منتظم	m u n t a ðˤ a m
بطرك	b a tˤ r a k
دخل	d a x a l
عند	ʕ i n d a
أرخبيل	ʔ a r x a b iː l
طبيبة	tˤ a b iː b a
صفر	sˤ a f a r
معاينة	m u ʕ aː j a n a
زمن	z a m a n
سلاطين	s a l aː tˤ iː n
استعاذ	i s t a ʕ aː ð a
حنة	ħ i n n a
كيول	k a j j uː l
فاح	f aː ħ a
رهط	r a h a tˤ a
غافث	ɣ aː f a θ
قرقع	q a r q a ʕ a
استفسار	i s t i f s aː r
عبرة	ʕ i b r a
عادة	ʕ aː d a
بتع	b i t ʕ
ريشة	r iː ʃ a
أبدية	ʔ a b a d i j j a
تلميذ	t i l m iː ð
صدرية	sˤ a d r i j j a
ليلتذاك	l a j l a t a ð aː k a
تعالم	t a ʕ aː l a m a
بارز	b aː r a z a
قرفص	q a r f a sˤ a
باطني	b aː tˤ i n i j j
استثناء	i s t i θ n aː ʔ
بغداد	b a ɣ d aː d
بدلة	b a d l a
فودنج	f uː d a n a d͡ʒ
أنزع	ʔ a n z a ʕ a
معدات	m u ʕ a d d aː t
طائرة	tˤ aː ʔ i r a
وضوء	w u dˤ uː ʔ
أطلسي	ʔ a tˤ l a s i j j
زحف	z a ħ a f a
شمروخ	ʃ u m r uː x
أكتوبر	ʔ a k t uː b a r
قرطاجي	q a r tˤ aː d͡ʒ i j j
معاونة	m u ʕ aː w a n a
نارنج	n aː r a n d͡ʒ
انكتاب	i n k i t aː b
معروف	m a ʕ r uː f
تلفت	t a l a f f a t a
نجاة	n a d͡ʒ aː h
وثيقة	w a θ iː q a
غرب	ɣ a r a b
لؤلؤ	l u ʔ l u ʔ
سعال	s u ʕ aː l
لاءم	l aː ʔ a m a
تكديس	t a k d iː s
اقتاد	i q t aː d a
رطوبة	r u tˤ uː b a
تذكرة	t a ð k i r a
جليد	d͡ʒ a l iː d
وجنة	w a d͡ʒ n a
أسمرة	ʔ a s m a r a
استمر	i s t a m a r r a
أسطرلاب	ʔ a s tˤ u r l aː b
مخالف	m u x aː l i f
منقرض	m u n q a r i dˤ
تمسيد	t a m s iː d
إداري	ʔ i d aː r i j j
بورسودان	b uː r s uː d aː n
ناي	n aː j
بعلبك	b a ʕ l a b a k k
بوصير	b uː sˤ iː r
لكنة	l u k n a
أشيب	ʔ a ʃ j a b
ماعون	m aː ʕ uː n
مراهق	m u r aː h i q
ثقة	θ i q a
تربية	t a r b i j a
قبو	q a b w
صهريج	sˤ a h r iː d͡ʒ
هندباء	h i n d i b aː ʔ
زبل	z a b b a l a
خنزير	x i n z iː r
عيادة	ʕ i j aː d a
حاسوب	ħ aː s uː b
سفير	s a f iː r
احتفل	i ħ t a f a l a
نائم	n aː ʔ i m
مجموع	m a d͡ʒ m uː ʕ
جدع	d͡ʒ a d a ʕ a
حذلقة	ħ a ð l a q a
محادثة	m u ħ aː d a θ a
سليلة	s a l iː l a
بنفسج	b a n a f s a d͡ʒ
انتفخ	i n t a f a x a
طلب	tˤ a l a b
خزز	x u z a z
دهس	d a h a s a
شرشيري	ʃ a r ʃ iː r i j j
أكشف	ʔ a k ʃ a f a
قنبيل	q a n b iː l
مازريون	m aː z a r i j uː n
عائشة	ʕ aː ʔ i ʃ a
خطيب	x a tˤ iː b
دفلى	d i f l aː
عصب	ʕ a sˤ a b a
كتان	k a t t aː n
خوذة	x uː ð a
عمى	ʕ a m m aː
رحيل	r a ħ iː l
مجرفة	m i d͡ʒ r a f a
قذال	q a ð aː l
عار	ʕ aː r
زينب	z a j n a b
عقلن	ʕ a q l a n a
أنسى	ʔ a n s aː
قابلة	q aː b i l a
زغرد	z a ɣ r a d a
دعا	d a ʕ aː
ضفة	dˤ a f f a
تلعثم	t a l a ʕ θ a m a
زوفرا	z a w f a r aː
برلمان	b a r l a m aː n
تنسيق	t a n s iː q
هذا	h aː ð a
اعوج	i ʕ w a d͡ʒ d͡ʒ a
حزمة	ħ u z m a
تصهين	t a sˤ a h j a n a
خلقي	x a l l i q iː
رداء	r i d aː ʔ
أرض	ʔ a r dˤ
جلاد	d͡ʒ a l l aː d
كاسيت	k aː s iː t
أدوية	ʔ a d w i j a
خفج	x a f a d͡ʒ
أوجس	ʔ a w d͡ʒ a s a
تدرج	t a d a r r a d͡ʒ a
عطاء	ʕ a tˤ aː ʔ
تباكى	t a b aː k aː
تجرد	t a d͡ʒ a r r a d a
قطران	q a tˤ a r aː n
زبرجد	z a b a r d͡ʒ a d
نرجيل	n a r d͡ʒ iː l
لأك	l a ʔ a k a
سريان	s a r a j aː n
بلادونا	b i l aː d uː n aː
لبان	l u b aː n
اليونان	a l j uː n aː n
إطراء	ʔ i tˤ r aː ʔ
براغ	b r aː ɣ
مشرك	m u ʃ r i k
إعلان	ʔ i ʕ l aː n
جبل	d͡ʒ a b a l
دولي	d a w l i j j
تاق	t aː q a
استقتل	i s t a q t a l a
لهى	l a h h aː
إقنيز	ʔ i q n iː z
صاج	sˤ aː d͡ʒ
ابتل	i b t a l l a
فاض	f aː dˤ a
متسول	m u t a s a w w i l
سلعة	s i l ʕ a
لعنة	l a ʕ n a
بطارخ	b a tˤ aː r i x
شمشم	ʃ a m ʃ a m a
أصفهان	ʔ a sˤ f a h aː n
انكمش	i n k a m a ʃ a
أخوية	ʔ a x a w i j j a
بكارة	b a k aː r a
أسري	ʔ u s r i j j
كزمازك	k a z m aː z a k
جيد	d͡ʒ a j j i d
ألاباما	ʔ a l aː b aː m aː
أحيلى	ʔ u ħ a j l aː
مفتعل	m u f t a ʕ a l
قديم	q a d iː m
حنفي	ħ a n a f i j j
راعدة	r aː ʕ i d a
استهجان	i s t i h d͡ʒ aː n
شلاق	ʃ a l l aː q
ازدان	i z d aː n a
ذنب	ð a n a b
الذي	a l l a ð iː
عراك	ʕ i r aː k
تلحين	t a l ħ iː n
سلام	s a l aː m
سليلى	s u l a j l aː
أحبك	ʔ u ħ i b b u k a
زاح	z aː ħ a
شلباية	ʃ i l b aː j a
غليون	ɣ a l j uː n
جذوع	d͡ʒ u ð uː ʕ
عظم	ʕ a ðˤ m
تيغار	t a j ɣ aː r
بكارج	b a k aː r i d͡ʒ
إهليلجي	ʔ i h l iː l a d͡ʒ i j j
قثاء	q i θ θ aː ʔ
إسماعيل	ʔ i s m aː ʕ iː l
مشرقان	m a ʃ r i q aː n
سنبل	s u n b u l
رتيلاء	r u t a j l aː ʔ
عريان	ʕ u r j aː n
تزحلق	t a z a ħ l a q a
ملح	m i l ħ
موسم	m a w s i m
عرين	ʕ a r iː n
قلقطار	q a l q a tˤ aː r
وزغة	w a z a ɣ a
أسف	ʔ a s a f f a
فوف	f uː f
ديناميكا	d iː n aː m iː k aː
صداقة	sˤ a d aː q a
وسع	w a s i ʕ a
قيمة	q iː m a
غرد	ɣ a r a d
قايين	q aː j iː n
بردي	b a r d i j j
بلوتو	b l uː t uː
ومض	w a m a dˤ a
أسرة	ʔ a s i r r a
دغفل	d a ɣ f a l
سرنديب	s a r a n d iː b
ائتمر	i ʔ t a m a r a
لله	l i l l aː h
اليسع	a l j a s a ʕ
قفير	q a f iː r
ممسحة	m i m s a ħ a
دجاجة	d a d͡ʒ aː d͡ʒ a
تحرش	t a ħ a r r a ʃ a
أصفاد	ʔ a sˤ f aː d
زئير	z a ʔ iː r
آذريون	ʔ aː ð a r j uː n
أصخر	ʔ a sˤ x a r a
تسلية	t a s l i j a
مقدر	m u q a d d a r
إشبينة	ʔ i ʃ b iː n a
معدة	m a ʕ d a
مقطع	m a q tˤ a ʕ
معارضة	m u ʕ aː r a dˤ a
غزاوة	ɣ a z aː w a
بضع	b i dˤ ʕ
هزر	h a z a r a
ثكل	θ a k i l a
كاعب	k aː ʕ i b
نظرية	n a ðˤ a r i j j a
عفوي	ʕ a f w i j j
جندبادستر	d͡ʒ u n d u b aː d a s t a r
مقطر	m u q a tˤ tˤ i r
سبلة	s a b l a
سوط	s a w tˤ
بيدر	b a j d a r
أرومة	ʔ a r uː m a
عاشر	ʕ aː ʃ i r
نهار	n a h aː r
ملكوت	m a l a k uː t
لولا	l a w l aː
أزب	ʔ a z a b b
كهنوت	k a h a n uː t
هنا	h u n aː
تيش	t iː ʃ
إجمالي	ʔ i d͡ʒ m aː l i j j
إيثار	ʔ iː θ aː r
نضوج	n u dˤ uː d͡ʒ
مخبأ	m a x b a ʔ
تخفيض	t a x f iː dˤ
مدغشقر	m a d a ɣ a ʃ q a r
حوب	ħ uː b
فاكهة	f aː k h a
كارة	k aː r a
نفض	n a f a dˤ a
تطبب	t a tˤ a b b a b a
طيفور	tˤ a j f uː r
نخالة	n u x aː l a
فكرة	f i k r a
فلفل	f i l f i l
ثمر	θ a m a r
راود	r aː w a d a
أسير	ʔ a s iː r
كرح	k i r ħ
أوحال	ʔ a w ħ aː l
رشفة	r a ʃ f a
آخر	ʔ aː x a r
بضعة	b i dˤ ʕ a
مشى	m a ʃ aː
مايو	m aː j uː
صابورة	sˤ aː b uː r a
خدش	x a d a ʃ a
تهالك	t a h aː l a k a
تعالى	t a ʕ aː l aː
خطف	x a tˤ a f a
قاسم	q aː s i m
قرنبيط	q a r n a b iː tˤ
دارفلفل	d aː r f i l f i l
سلسلة	s i l s i l a
وسد	w a s s a d a
انتظم	i n t a ðˤ a m a
نخروبي	n u x r uː b i j j
مفسر	m u f a s s i r
فقيه	f a q iː h
رادف	r aː d a f a
عواري	ʕ a w aː r i j j
زورق	z a w r a q
لذيذ	l a ð iː ð
مطراني	m u tˤ r aː n i j j
بلاذر	b a l aː ð i r
تفصيل	t a f sˤ iː l
وبخ	w a b b a x a
جواد	d͡ʒ a w aː d
أرنب	ʔ a r n a b
متواضع	m u t a w aː dˤ i ʕ
أعظ	ʔ a ʕ a ðˤ ðˤ a
القاهرة	a l q aː h i r a
شاع	ʃ aː ʕ a
سخل	s a x l
ارتياد	i r t i j aː d
معراض	m i ʕ r aː dˤ
استكرى	i s t a k r aː
أطباء	ʔ a tˤ i b b aː ʔ
إتاوة	ʔ i t aː w a
عطاس	ʕ u tˤ aː s
استمات	i s t a m aː t a
غزال	ɣ a z aː l
معقل	m a ʕ q i l
كنزة	k a n z a
إسماعيلي	ʔ i s m aː ʕ iː l i j j
تجاوزات	t a d͡ʒ aː w u z aː t
صغر	sˤ a ɣ a r a
متفرق	m u t a f a r r i q
ورطة	w a r tˤ a
عافية	ʕ aː f i j a
واطن	w aː tˤ a n a
مقشرة	m i q ʃ a r a
شراب	ʃ a r aː b
أغوى	ʔ a ɣ w aː
انزعاج	i n z i ʕ aː d͡ʒ
تراجيديا	t r aː d͡ʒ iː d j aː
هيبة	h a j b a
أريزونا	ʔ a r iː z uː n aː
كويكب	k u w a j k i b
كزمازج	k a z m aː z a d͡ʒ
نقحر	n a q ħ a r a
أنفق	ʔ a n f a q a
ميم	m iː m
عثور	ʕ u θ uː r
جريب	d͡ʒ a r iː b
وقود	w a q uː d
ويكاموس	w iː k aː m uː s
أشابة	ʔ u ʃ aː b a
هارون	h aː r uː n
باخوم	b aː x uː m
رزداق	r u z d aː q
حفة	ħ a f f a
وضاح	w a dˤ dˤ aː ħ
قلقديس	q a l q a d iː s
فرهود	f u r h uː d
ترميم	t a r m iː m
فتح	f a t a ħ a
شمام	ʃ a m m aː m
بهائي	b a h aː ʔ i j j
نزلة	n a z l a
مرجان	m a r d͡ʒ aː n
بيوت	b u j uː t
متوسط	m u t a w a s s i tˤ
مسمار	m i s m aː r
فسقية	f a s q i j j a
مصدق	m u sˤ a d d a q
نبيه	n a b iː h
كينيا	k iː n i j aː
أكسد	ʔ a k s a d a
طين	tˤ iː n
مفرش	m i f r a ʃ
تلقاء	t i l q aː ʔ a
ضرة	dˤ a r r a
عمرة	ʕ u m r a
الأردن	a l ʔ u r d u n
عليم	ʕ a l iː m
سرقين	s i r q iː n
بعثي	b a ʕ θ i j j
كراخة	k a r aː x a
تساءل	t a s aː ʔ a l a
شابانك	ʃ aː b aː n a k
موسيقى	m uː s iː q aː
خيزران	x a j z u r aː n
ليث	l a j θ
برعم	b a r ʕ a m a
مشاورة	m u ʃ aː w a r a
أسطرك	ʔ a s tˤ a r a k
سحلب	s a ħ l a b
حرقوص	ħ a r q uː sˤ
فنجنكشت	f a n d͡ʒ a n k u ʃ t
غريب	ɣ a r iː b
إشفى	ʔ i ʃ f aː
سفرجلة	s a f a r d͡ʒ a l a
محجوب	m a ħ d͡ʒ uː b
تنحى	t a n a ħ ħ aː
قاعة	q aː ʕ a
تنزانيا	t a n z aː n j aː
تفرغ	t a f a r r a ɣ a
يسوع	j a s uː ʕ
أدحوة	ʔ u d ħ u w w a
قشع	q a ʃ a ʕ a
قويعدة	q u w a j ʕ i d a
حامول	ħ aː m uː l
حدد	ħ a d d a d a
كأس	k a ʔ s
عميق	ʕ a m iː q
ختان	x i t aː n
رقيق	r a q iː q
أيل	ʔ a j j a l
صربيا	sˤ i r b i j aː
تصبصب	t a sˤ a b sˤ a b a
قارن	q aː r a n a
كنار	k a n aː r
أصحى	ʔ a sˤ ħ aː
غلاء	ɣ a l aː ʔ
ولى	w a l l aː
كوريا	k uː r i j aː
أشهب	ʔ a ʃ h a b
هجوم	h u d͡ʒ uː m
سمكة	s a m a k a
زحافة	z a ħ ħ aː f a
بخير	b i x a j r
توقف	t a w a q q a f a
محاكمة	m u ħ aː k a m a
بطريك	b a tˤ r iː k
تقزز	t a q a z z a z a
مغنيسيا	m a ɣ n iː s i j aː
تكية	t a k i j j a
نسيم	n a s iː m
بروناي	b r uː n aː j
افتقد	i f t a q a d a
مروض	m u r a w w a dˤ
لؤلؤة	l u ʔ l u ʔ a
رومانيا	r uː m aː n i j aː
مريمية	m a r j a m i j j a
كوبا	k uː b aː
تقوى	t a q w aː
عضلة	ʕ a dˤ a l a
وبيل	w a b iː l
أرز	ʔ a r a z z a
نادل	n aː d i l
ذمة	ð i m m a
تصفح	t a sˤ a f f a ħ a
متين	m a t iː n
خرنق	x i r n i q
أبش	ʔ a b a ʃ a
مسجد	m a s d͡ʒ i d
خيرات	x a j r aː t
المجر	a l m a d͡ʒ a r
زوجة	z a w d͡ʒ a
حبق	ħ a b a q
تحذير	t a ħ ð iː r
برذون	b i r ð a w n
قتلة	q a t l a h
حديقة	ħ a d iː q a
معاوية	m u ʕ aː w i j a
قرطم	q u r tˤ u m
شيح	ʃ iː ħ
أسس	ʔ a s s a s a
شامخ	ʃ aː m i x
جائحة	d͡ʒ aː ʔ i ħ a
إحصائي	ʔ i ħ sˤ aː ʔ i j j
اقتحم	i q t a ħ a m a
بدنة	b a d a n a
ذكرى	ð i k r aː
فتش	f a t t a ʃ a
علا	ʕ a l aː
ظفر	ðˤ a f a r
عرنسية	ʕ a r a n s i j j a
إبريز	ʔ i b r iː z
جبانات	d͡ʒ a b aː n aː t
توتيا	t uː t i j aː
كوسى	k uː s aː
إقامة	ʔ i q aː m a
بندق	b u n d u q
ضاجع	dˤ aː d͡ʒ a ʕ a
مخاض	m a x aː dˤ
ذكاء	ð a k aː ʔ
رياضي	r i j aː dˤ i j j
إيريناوس	ʔ iː r iː n aː w u s
فحص	f a ħ a sˤ a
جنازة	d͡ʒ a n aː z a
نسى	n a s s aː
اليرموك	a l j a r m uː k
وضح	w a dˤ a ħ
صأصأ	sˤ a ʔ sˤ a ʔ a
ضمران	dˤ a m r aː n
مشاوير	m a ʃ aː w iː r
جاء	d͡ʒ aː ʔ a
منشار	m a n ʃ aː r
صخيد	sˤ a x iː d
نكاح	n i k aː ħ
شاشية	ʃ aː ʃ i j j a
قرصان	q u r sˤ aː n
كبش	k a b ʃ
لماذا	l i m aː ð aː
مذهبي	m a ð h a b i j j
مغاث	m u ɣ aː θ
رتينج	r a t iː n a d͡ʒ
سرط	s a r a tˤ a
تعريف	t a ʕ r iː f
بينما	b a j n a m aː
المريخ	a l m i r r iː x
مضمار	m i dˤ m aː r
كأب	k a ʔ b
رعد	r a ʕ d
مدقة	m i d a q q a
سعي	s a ʕ j
مطرانية	m u tˤ r aː n i j j a
جلس	d͡ʒ a l a s a
مساومة	m u s aː w a m a
كلب	k a l b
معطس	m a ʕ tˤ i s
رائس	r aː ʔ i s
سرجين	s i r d͡ʒ iː n
قيصوم	q a j sˤ uː m
بستوقة	b u s t uː q a
حرباء	ħ i r b aː ʔ
جواهري	d͡ʒ a w aː h i r i j j
أول	ʔ a w w a l
أفطس	ʔ a f tˤ a s
براعة	b a r aː ʕ a
أخمص	ʔ a x m u sˤ
زردخانة	z a r a d x aː n a
كسوة	k i s w a
طالما	tˤ aː l a m aː
جزع	d͡ʒ a z a ʕ a
أغافث	ʔ a ɣ aː f i θ
قراسيا	q a r aː s i j aː
رحمن	r a ħ i m n a
ماحق	m aː ħ i q
أقرأ	ʔ a q r a ʔ a
مشرق	m a ʃ r i q
كميت	k u m a j t
مثل	m a θ a l
شيهم	ʃ a j h a m
محى	m a ħ aː
رفأ	r a f a ʔ a
دنو	d u n u w w
جيء	d͡ʒ a j ʔ
جحر	d͡ʒ u ħ r
شعبة	ʃ i ʕ b a
حينما	ħ iː n a m aː
عبيثران	ʕ a b a j θ a r aː n
انتظام	i n t i ðˤ aː m
زمجر	z a m d͡ʒ a r a
قاف	q aː f
علم	ʕ a l a m
خليفة	x a l iː f a
أصطرك	ʔ a sˤ tˤ a r a k
غيبة	ɣ a j b a
تقوض	t a q a w w a dˤ a
اختصر	i x t a sˤ a r a
أوراق	ʔ a w r aː q
مجازر	m a d͡ʒ aː z i r
قاد	q aː d a
هدد	h a d d a d a
باب	b aː b
مسطح	m u s a tˤ tˤ a ħ
مذيع	m u ð iː ʕ
واقعي	w aː q i ʕ i j j
عنكبوت	ʕ a n k a b uː t
شطر	ʃ a tˤ a r a
نساب	n a s s aː b
سفرة	s u f r a
نزعة	n a z ʕ a
تنظيم	t a n ðˤ iː m
فسيفساء	f u s a j f i s aː ʔ
شرد	ʃ a r a d a
الفلبين	a l f i l i b b iː n
قفاز	q u f aː z
محن	m i ħ a n
صيد	sˤ a j d
ارتباط	i r t i b aː tˤ
انتقم	i n t a q a m a
جابية	d͡ʒ aː b i j a
فيتامين	f iː t aː m iː n
رضى	r u dˤ aː
باطية	b aː tˤ i j a
اشتاق	i ʃ t aː q a
أصأب	ʔ a sˤ ʔ a b a
قطار	q i tˤ aː r
أوقف	ʔ a w q a f a
انخفض	i n x a f a dˤ a
إرتريا	ʔ i r i t r i j aː
هندسي	h a n d a s i j j
إنتاج	ʔ i n t aː d͡ʒ
تقرح	t a q a r r a ħ a
صحاف	sˤ a ħ ħ aː f
طبخة	tˤ a b x a
درياق	d i r j aː q
كنيسة	k a n iː s a
جحا	d͡ʒ u ħ aː
هنالك	h u n aː l i k a
رئوي	r i ʔ a w i j j
مشعر	m a ʃ ʕ a r
صخف	sˤ a x a f a
قسطاس	q i s tˤ aː s
تدلى	t a d a l l aː
نجدة	n a d͡ʒ d a
نار	n aː r
أوحد	ʔ a w ħ a d
شمالي	ʃ a m aː l i j j
ابتهاج	i b t i h aː d͡ʒ
خشاب	x a ʃ ʃ aː b
هدية	h a d i j j a
نياط	n i j aː tˤ
سمعي	s a m ʕ i j j
طبشورة	tˤ a b ʃ uː r a
احتاز	i ħ t aː z a
أعجم	ʔ a ʕ d͡ʒ a m a
دولاب	d a w l aː b
تذاكى	t a ð aː k aː
رمم	r a m m a m a
شاسع	ʃ aː s i ʕ
نعامة	n a ʕ aː m a
أغلب	ʔ a ɣ l a b
منافس	m u n aː f i s
فنطاس	f i n tˤ aː s
فيج	f a j d͡ʒ
عطب	ʕ a tˤ a b
مرآة	m i r ʔ aː h
ندبة	n a d b a
عيد	ʕ a j j a d a
فقاعة	f u q q aː ʕ a
مستطيلات	m u s t tˤ iː l aː t
إحارة	ʔ i ħ aː r a
ضاحية	dˤ aː ħ i j a
دمغة	d a m ɣ a
حقبة	ħ i q b a
شهق	ʃ a h a q a
حصاد	ħ a sˤ aː d
دواسة	d a w w aː s a
بصل	b a sˤ a l
كامخ	k aː m a x
شبشب	ʃ i b ʃ i b
قفة	q u f f a
شربوش	ʃ a r b uː ʃ
قسيس	q i s s iː s
فيروز	f a j r uː z
نهب	n a h a b a
إجاص	ʔ i d͡ʒ d͡ʒ aː sˤ
دهشة	d a h ʃ a
عليق	ʕ u l l a j q
تكشف	t a k a ʃ ʃ a f a
ليت	l a j t a
تقية	t a q i j j a
إنقاض	ʔ i n q aː dˤ
بسالة	b a s aː l a
صاخة	sˤ aː x x a
الزهرة	a z z u h a r a
عنقود	ʕ a n q uː d
جسور	d͡ʒ a s uː r
ياسين	j aː s iː n
سينمائي	s i j n a m aː ʔ i j j
البندقية	a l b u n d u q i j j a
قصيبة	q u sˤ a j b a
أشل	ʔ a ʃ a l l
جاورجيوس	d͡ʒ aː w u r d͡ʒ i j uː s
جحفل	d͡ʒ a ħ f a l
سادس	s aː d i s
أغرى	ʔ a ɣ r aː
القنيطرة	a l q u n a j tˤ i r a
بند	b a n d
تضمن	t a dˤ a m m a n a
مظلة	m a ðˤ a l l a
جورجيا	d͡ʒ uː r d͡ʒ i j aː
أعطى	ʔ a ʕ tˤ aː
نذير	n a ð iː r
أعصر	ʔ a ʕ sˤ a r a
توعوي	t a w ʕ a w i j j
فرن	f u r n
ناعم	n aː ʕ i m
قوس	q a w i s a
جزئي	d͡ʒ u z ʔ i j j
عاشق	ʕ aː ʃ i q
قيافة	q i j aː f a
تفاحة	t u f f aː ħ a
مشعاع	m i ʃ ʕ aː ʕ
داركيسة	d aː r k iː s a
زيارة	z i j aː r a
دثر	d a θ r
أعياد	ʔ a ʕ j aː d
وفاء	w a f aː ʔ
عجب	ʕ a d͡ʒ a b
إلكترونيات	ʔ i l i k t r uː n i j j aː t
رزتاق	r u z t aː q
مومياء	m uː m i j aː ʔ
نهض	n a h a dˤ a
أمهري	ʔ a m h a r i j j
افتخر	i f t a x a r a
اشتياق	i ʃ t i j aː q
دقع	d a q i ʕ a
جبيز	d͡ʒ a b iː z
ورق	w a r a q
يونيو	j uː n i j uː
قومية	q a w m i j j a
بخت	b a x t
النيجر	a n n iː d͡ʒ a r
خيزان	x iː z aː n
خفى	x a f aː
مرقشيتا	m a r q a ʃ iː t aː
مساحة	m a s s aː ħ a
تقرر	t a q a r r a r a
أضاع	ʔ a dˤ aː ʕ a
مفرد	m u f r a d
ظلف	ðˤ i l f
مطران	m a tˤ r aː n
غرلة	ɣ u r l a
دائخ	d aː ʔ i x
ديان	d a j j aː n
شنبر	ʃ a n b a r
غباء	ɣ a b aː ʔ
دودة	d uː d a
برشام	b i r ʃ aː m
خشي	x a ʃ i j a
مقاص	m a q aː sˤ sˤ
رجع	r a d͡ʒ a ʕ a
حتام	ħ a t t aː m a
فرجون	f i r d͡ʒ a w n
سيخية	s iː x i j j a
قنص	q a n a sˤ a
عشيرة	ʕ a ʃ iː r a
بهر	b a h a r a
قلم	q a l a m
محسن	m u ħ a s s a n
خيار	x i j aː r
بشرة	b a ʃ a r a
مشحذ	m i ʃ ħ a ð
تحاشى	t a ħ aː ʃ aː
تطاير	t a tˤ aː j a r a
كلخ	k a l x
أكمون	ʔ a k m uː n
ذرة	ð a r r a
بغل	b a ɣ l
شلكاية	ʃ a l a k aː j a
حوض	ħ a w dˤ
أولياء	ʔ a w l i j aː ʔ
انجراف	i n d͡ʒ i r aː f
فالودق	f aː l uː d a q
ارتدع	i r t a d a ʕ a
نخلة	n a x l a
ردم	r a d a m a
ضجيج	dˤ a d͡ʒ iː d͡ʒ
استفتى	i s t a f t aː
قيراط	q iː r aː tˤ
همزة	h a m z a
فتوى	f a t w aː
ليمي	l a j m i j j
بلغمي	b a l ɣ a m i j j
الهند	a l h i n d
أغماد	ʔ a ɣ m aː d
عدد	ʕ a d a d
باح	b aː ħ a
كوة	k a w w a
حزاق	ħ a z aː q
انقضاض	i n q i dˤ aː dˤ
بيداء	b a j d aː ʔ
صاحب	sˤ aː ħ i b
فرخ	f a r r a x a
اعتقاد	i ʕ t i q aː d
أجوف	ʔ a d͡ʒ w a f
خيمة	x a j m a
قشدي	q i ʃ d i j j
سندس	s u n d u s
رماد	r a m aː d
زرقطونا	z a r q a tˤ uː n aː
خرفة	x u r f a
فراولة	f a r aː w i l a
مقاعد	m a q aː ʕ i d
بغلة	b a ɣ l a
قتل	q a t a l a
ندى	n a d aː
صأل	sˤ a ʔ a l a
أطلع	ʔ a tˤ l a ʕ a
نجار	n a d͡ʒ d͡ʒ aː r
سعادة	s a ʕ aː d a
آفات	ʔ aː f aː t
دستة	d a s t a
تطوان	t a tˤ w aː n
استقل	i s t a q a l l a
مغرفة	m i ɣ r a f a
بقي	b a q i j a
بعثة	b a ʕ θ a
استفرغ	i s t a f r a ɣ a
ويكيبيديا	w iː k iː b iː d i j aː
مضمون	m a dˤ m uː n
إكتاب	ʔ i k t aː b
عربن	ʕ a r b a n a
دهنج	d a h n a d͡ʒ
موريتانيا	m uː r iː t aː n i j aː
سويداء	s u w a j d aː ʔ
ضوى	dˤ a w aː
زمزريق	z a m z a r iː q
لاتفي	l aː t f i j j
سنوت	s a n n uː t
جمعية	d͡ʒ a m ʕ i j j a
مأمأة	m a ʔ m a ʔ a
واعد	w aː ʕ a d a
حبة	ħ a b b a
طعام	tˤ a ʕ aː m
مرصبان	m a r sˤ a b aː n
لتوانيا	l i t u w aː n i j aː
بحار	b a ħ ħ aː r
حدق	ħ a d a q a
أنتن	ʔ a n t u n n a
فلت	f a l a t a
كوخ	k uː x
ستة	s i t t a
طابعة	tˤ aː b i ʕ a
مسلم	m u s a l l a m
جعفر	d͡ʒ a ʕ f a r
ترجى	t a r a d͡ʒ d͡ʒ aː
أبنوس	ʔ a b a n uː s
شاء	ʃ aː ʔ
مشقة	m a ʃ a q q a
شاكر	ʃ aː k i r
قاطعة	q aː tˤ i ʕ a
فوطة	f uː tˤ a
قبائلي	q a b aː ʔ i l i j j
الخميس	a l x a m iː s
هوة	h u w w a
غفر	ɣ a f a r a
شموخ	ʃ u m uː x
شجاع	ʃ u d͡ʒ aː ʕ
إناء	ʔ i n aː ʔ
زراعي	z i r aː ʕ i j j
تسعون	t a s ʕ a w n a
تفقد	t a f a q q a d a
مسد	m a s a d a
شبوطة	ʃ a b b uː tˤ a
مقطعية	m a q tˤ a ʕ i j j a
إرادي	ʔ i r aː d i j j
غرق	ɣ a r i q a
أمان	ʔ a m aː n
عصيب	ʕ a sˤ iː b
ساف	s aː f
عيش	ʕ a j ʃ
زمانذاك	z a m aː n a ð aː k a
سروال	s i r w aː l
وقاء	w i q aː ʔ
فاوض	f aː w a dˤ a
دمنة	d i m n a
تقضب	t a q a dˤ dˤ a b a
عمان	ʕ a m m aː n
خندريس	x a n d a r iː s
يعني	j a ʕ n iː
لغة	l u ɣ a
حطم	ħ a tˤ a m a
عنزروت	ʕ a n z a r uː t
خزان	x a z z aː n
كتابة	k i t aː b a
بوذي	b uː ð i j j
منفور	m a n f uː r
ارتباك	i r t i b aː k
رياسة	r i j aː s a
إبزيم	ʔ i b z iː m
يافع	j aː f i ʕ
أورانوس	ʔ uː r aː n uː s
خضخض	x a dˤ x a dˤ a
حبس	ħ a b b a s a
كوسوفو	k uː s uː f uː
اقتضى	i q t a dˤ aː
إحاطة	ʔ i ħ aː tˤ a
سلالة	s u l aː l a
عوارية	ʕ a w aː r i j j a
محب	m u ħ a b b
قراد	q u r aː d
جائز	d͡ʒ aː ʔ i z
مكة	m a k k a
محول	m u ħ a w w i l
حيثيات	ħ a j θ i j j aː t
نارجيل	n aː r a d͡ʒ iː l
مري	m u r iː
سوراني	s uː r aː n i j j
دورة	d a w r a
معجم	m u ʕ d͡ʒ a m
مضض	m a dˤ a dˤ
أسارون	ʔ a s aː r uː n
خلنجان	x a l a n d͡ʒ aː n
مباراة	m u b aː r aː h
إدارة	ʔ i d aː r a
صوب	sˤ a w b
إزعاج	ʔ i z ʕ aː d͡ʒ
مصاب	m a sˤ aː b b
تقرير	t a q r iː r
حورس	ħ uː r u s
استيقظ	i s t a j q a ðˤ a
هوتة	h a w t a
ارتياع	i r t i j aː ʕ
صحي	sˤ a ħ i j a
حامض	ħ aː m i dˤ
تعس	t a ʕ a s a
ترجمة	t a r d͡ʒ a m a
ذراع	ð i r aː ʕ
لينينية	l iː n iː n i j j a
جين	d͡ʒ iː n
رجرج	r a d͡ʒ r a d͡ʒ a
رونق	r a w n a q
نعل	n a ʕ a l
أبلس	ʔ a b l a s a
ناقل	n aː q i l
ثور	θ a w r
كذين	k u ð iː n
إعراب	ʔ i ʕ r aː b
مطفأة	m i tˤ f a ʔ a
وسق	w a s q
قلعي	q a l a ʕ i j j
توضح	t a w a dˤ dˤ a ħ a
فشقر	f a ʃ q a r
ساحة	s aː ħ a
تكويت	t a k w iː t
صحصح	sˤ a ħ sˤ a ħ
أبريل	ʔ a b r iː l
فؤاد	f u ʔ aː d
براين	b r aː j a n
سلح	s a l a ħ a
غراب	ɣ u r aː b
سلامتك	s a l aː m t a k
كوثل	k a w θ a l
ناخوذة	n aː x uː ð a
إباحية	ʔ i b aː ħ i j j a
وجدة	w a d͡ʒ d a
خزانة	x i z aː n a
أرهب	ʔ a r h a b a
مقلق	m u q l i q
فتاة	f a t aː h
شركة	ʃ a r i k a
تغمى	t a ɣ a m m aː
أذاع	ʔ a ð aː ʕ a
صندوق	sˤ a n d uː q
إشبين	ʔ i ʃ b iː n
كادس	k aː d i s
هايتي	h aː j i t iː
أجلح	ʔ a d͡ʒ l a ħ
مرقاق	m i r q aː q
تأميم	t a ʔ m iː m
مسافة	m a s aː f a
نقيض	n a q iː dˤ
بالوعات	b aː l uː ʕ aː t
هرنوة	h a r n u w a
ابتداء	i b t i d aː ʔ
درفيل	d a r f iː l
صنعاء	sˤ a n ʕ aː ʔ
استنتاج	i s t i n t aː d͡ʒ
زميلات	z a m iː l aː t
باص	b aː sˤ
سنان	s i n aː n
نشد	n a ʃ a d a
دركي	d a r a k i j j
حفيدة	ħ a f iː d a
أعرن	ʔ a ʕ r a n a
نبيل	n a b iː l
دستور	d u s t uː r
سطع	s a tˤ a ʕ a
غبار	ɣ u b aː r
سطوة	s a tˤ w a
حاء	ħ aː ʔ
أنكر	ʔ a n k a r a
طاجن	tˤ aː d͡ʒ i n
فاشرا	f aː ʃ i r aː
عران	ʕ i r aː n
تخضخض	t a x a dˤ x a dˤ a
منفي	m a n f i j j
سائح	s aː ʔ i ħ
استعارة	i s t i ʕ aː r a
دراماتيكي	d i r aː m aː t iː k i j j
فناء	f a n aː ʔ
عنيف	ʕ a n iː f
معركة	m a ʕ r a k a
استخرج	i s t a x r a d͡ʒ a
بندقاني	b u n d u q aː n iː
زنباعة	z a n b aː ʕ a
مرطبان	m a r tˤ a b aː n
استضاف	i s t a dˤ aː f a
مناخي	m a n aː x i j j
شبكة	ʃ a b a k a
بلعوم	b u l ʕ uː m
فأس	f a ʔ s
سفود	s a f f uː d
خرطال	x a r tˤ aː l
قاعدة	q aː ʕ i d a
تشيلي	t ʃ iː l i j j
قرصن	q a r sˤ a n a
ركف	r a k a f
تدثر	t a d a θ θ a r a
اشترى	i ʃ t a r aː
دربوكة	d a r b uː k a
ليرة	l a j r a
برقية	b a r q i j j a
فرفحين	f a r f a ħ iː n
جذام	d͡ʒ u ð aː m
بحري	b a ħ r i j j
كثير	k a θ iː r
واجهة	w aː d͡ʒ i h a
ملاك	m u l l aː k
تفاجأ	t a f aː d͡ʒ a ʔ a
طاح	tˤ aː ħ a
ثدييات	θ a d j i j j aː t
محطة	m a ħ a tˤ tˤ a
صخد	sˤ a x a d a
صنبور	sˤ u n b uː r
سكن	s a k a n
شابانج	ʃ aː b aː n a d͡ʒ
انجذاب	i n d͡ʒ i ð aː b
بلغاري	b u l ɣ aː r i j j
باكستاني	b aː k i s t aː n i j j
جنسية	d͡ʒ i n s i j j a
فلسفة	f a l s a f a
إندونيسي	ʔ i n d uː n iː s i j j
الجمعة	a l d͡ʒ u m a ʕ a
حيوان	ħ a j a w aː n
سابيائي	s aː b i j aː ʔ i j j
زوقال	z uː q aː l
قرفصاء	q u r f u sˤ aː ʔ
وعليكم	w a ʕ a l a j k u m
نهائي	n i h aː ʔ i j j
لهذا	l i h aː ð aː
صلعة	sˤ a l ʕ a
بورصة	b uː r sˤ a
مشجب	m i ʃ d͡ʒ a b
استدل	i s t a d a l l a
استقلال	i s t i q l aː l
تبرع	t a b a r r a ʕ a
مكالمة	m u k aː l a m a
مشنة	m i ʃ a n n a
برهة	b u r h a
كون	k a w n
غريبة	ɣ a r iː b a
مجري	m a d͡ʒ a r i j j
هول	h a w l
متماد	m u t a m aː d d
اختل	i x t a l l a
شعيب	ʃ u ʕ a j b
ارتفع	i r t a f a ʕ a
زعزع	z a ʕ z a ʕ a
اعتزام	i ʕ t i z aː m
رغيفة	r a ɣ iː f a
هرة	h i r r a h
تصادأ	t a sˤ aː d a ʔ a
شليل	ʃ a l iː l
تصميم	t a sˤ m iː m
بهيمة	b a h iː m a
حلال	ħ a l aː l
تبحر	t a b a ħ ħ a r a
مهذار	m i h ð aː r
أغيد	ʔ a ɣ j a d
عربية	ʕ a r a b i j j a
أخثاث	ʔ a x θ aː θ
شبيه	ʃ a b iː h
قطارة	q a tˤ tˤ aː r a
سقطرة	s u q u tˤ r a
أمازيغي	ʔ a m aː z iː ɣ i j j
بسباس	b a s b aː s
متفجرات	m u t a f a d͡ʒ d͡ʒ i r aː t
نيجيريا	n iː d͡ʒ iː r i j aː
شاي	ʃ aː j
تمساح	t i m s aː ħ
ظاهري	ðˤ aː h i r i j j
طمي	tˤ a m j
زميل	z a m iː l
اسكتلندي	i s k u t l a n d i j j
برشيد	b a r ʃ iː d
قائمة	q aː ʔ i m a
راقص	r aː q a sˤ a
مشعل	m a ʃ ʕ a l
تشكيك	t a ʃ k iː k
هذيان	h a ð a j aː n
تعويذة	t a ʕ w iː ð a
اكتسب	i k t a s a b a
بعلة	b a ʕ l a
نوراني	n uː r aː n i j j
سراق	s a r r aː q
تخدر	t a x a d d a r a
زرنب	z a r n a b
كمأ	k a m a ʔ
عباية	ʕ a b aː j a
مسلسل	m u s a l s a l
كافتيريا	k aː f i t iː r i j aː
معاداة	m u ʕ aː d aː h
عاصف	ʕ aː sˤ i f
ضمور	dˤ u m uː r
سقلاطون	s i q i l l aː tˤ uː n
رصاص	r a sˤ aː sˤ
ميتوكندريا	m iː t uː k u n d r i j aː
أسياخ	ʔ a s j aː x
شبع	ʃ a b i ʕ a
مدرك	m u d r a k
عربيزي	ʕ a r a b iː z i j j
ناضج	n aː dˤ i d͡ʒ
نقض	n a q a dˤ a
حائض	ħ aː ʔ i dˤ
استجاب	i s t a d͡ʒ aː b a
دائرة	d aː ʔ i r a h
توفيق	t a w f iː q
عاين	ʕ aː j a n a
إحسان	ʔ i ħ s aː n
مغناطيسية	m a ɣ n aː tˤ iː s i j j a
يرقة	j a r a q a
إنهاء	ʔ i n h aː ʔ
دند	d a n d
قاء	q aː ʔ a
صعوبة	sˤ u ʕ uː b a
أزأم	ʔ a z ʔ a m a
إصقنقور	ʔ i sˤ q a n q uː r
تكعيب	t a k ʕ iː b
قارورة	q aː r uː r a
تحسس	t a ħ a s s a s a
جولق	d͡ʒ a w l a q
فصيل	f a sˤ iː l
إبعاد	ʔ i b ʕ aː d
توصية	t a w sˤ i j a
ثانية	θ aː n i j a
سهول	s u h uː l
بيد	b a j d a
نتف	n a t a f
نفاخة	n u f f aː x a
فرصاد	f i r sˤ aː d
تلغراف	t a l i ɣ r aː f
رواقي	r i w aː q i j j
بزاق	b u z aː q
تجربة	t a d͡ʒ r i b a
حنبلي	ħ a n b a l i j j
مرفوع	m a r f uː ʕ
سامور	s aː m uː r
مرحلة	m a r ħ a l a
مذاق	m a ð aː q
نبهاء	n u b a h aː ʔ
لاث	l aː θ a
نافورة	n aː f uː r a
راء	r aː ʔ
أباجور	ʔ a b aː d͡ʒ uː r
تضرر	t a dˤ a r r a r a
وأد	w a ʔ a d a
إجباري	ʔ i d͡ʒ b aː r i j j
دكتور	d u k t uː r
علني	ʕ a l a n i j j
كراويا	k a r aː w i j aː
مالك	m aː l i k
أندراوس	ʔ a n d a r aː w u s
مومس	m uː m i s
الأحد	a l ʔ a ħ a d
لومي	l uː m i j j
فركس	f i r k i s
إمهال	ʔ i m h aː l
اتعاظ	i t t i ʕ aː ðˤ
أضر	ʔ a dˤ a r r a
مرقص	m a r q a sˤ
مستشرق	m u s t a ʃ r i q
توجه	t a w a d͡ʒ d͡ʒ a h a
نزهة	n u z h a
قنديد	q i n d iː d
قداحة	q a d d aː ħ a
فاتر	f aː t i r
قابل	q aː b a l a
غواصة	ɣ a w w aː sˤ a
معبد	m a ʕ b a d
جعضيض	d͡ʒ a ʕ dˤ iː dˤ
ثقافة	θ a q aː f a
أيون	ʔ a j uː n
قراص	q u r r aː sˤ
مناعة	m a n aː ʕ a
رستاق	r u s t aː q
إسرائيل	ʔ i s r aː ʔ iː l
منون	m a n uː n
يقظة	j a q a ðˤ a
كتلة	k u t l a
ناسور	n aː s uː r
أشهد	ʔ a ʃ h a d a
قسوة	q a s w a
هانم	h aː n i m
جنب	d͡ʒ a n a b
مطب	m a tˤ a b b
ملف	m i l a f f
فاتية	f aː t i j a
تأنق	t a ʔ a n n a q a
تنبول	t u m b uː l
وارث	w aː r i θ
موحش	m uː ħ i ʃ
إياك	ʔ i j j aː k a
مويزج	m a w iː z a d͡ʒ
اتهم	i t t a h a m a
مفروشات	m a f r uː ʃ aː t
العرائش	a l ʕ a r aː ʔ i ʃ
هيول	h a j uː l
مقصف	m a q sˤ a f
مصب	m a sˤ a b b
جسر	d͡ʒ i s r
باغت	b aː ɣ a t a
دبيل	d a b iː l
درقة	d a r a q a
كرك	k u r k
اعتاض	i ʕ t aː dˤ a
محادث	m u ħ aː d a θ
صفيراء	sˤ u f a j r aː ʔ
نموذجي	n a m uː ð a d͡ʒ i j j
هجرة	h i d͡ʒ r a
عاشب	ʕ aː ʃ i b
شخشيخة	ʃ u x ʃ iː x a
أبرز	ʔ a b r a z
أغلف	ʔ a ɣ l a f
رحى	r a ħ aː
تطفل	t a tˤ a f f a l a
انتماء	i n t i m aː ʔ
فسافس	f a s aː f i s
ذهن	ð i h n
مراكش	m u r r aː k u ʃ
بقدونس	b a q d uː n a s
ابتسامة	i b t i s aː m a
تعرض	t a ʕ a r r a dˤ a
جميزة	d͡ʒ u m m a j z
مرش	m a r a ʃ a
احترف	i ħ t a r a f a
قدوم	q a d d uː m
عطاط	ʕ a tˤ aː tˤ
اتفاق	i t t i f aː q
أسمرا	ʔ a s m a r aː
سبج	s a b a d͡ʒ
آتون	ʔ aː t uː n
سؤدد	s u ʔ d a d
نظير	n a ðˤ iː r
حفيد	ħ a f iː d
مؤسس	m u ʔ a s s a s
شبهة	ʃ u b h a
إلحاق	ʔ i l ħ aː q
ياء	j aː ʔ
تزعزع	t a z a ʕ z a ʕ a
فحم	f a ħ m
نسيئة	n a s iː ʔ a
بحر	b a ħ a r
أغار	ʔ a ɣ aː r a
دمية	d u m j a
جدار	d͡ʒ i d aː r
قطيع	q a tˤ iː ʕ
قنبلة	q u n b u l a
اختنق	i x t a n a q a
قوض	q a w w a dˤ a
صعيد	sˤ a ʕ iː d
أراد	ʔ a r aː d a
استفزاز	i s t i f z aː z
زنزانة	z i n z aː n a
واثق	w aː θ i q
استغفر	i s t a ɣ f a r a
قولنج	q a w l a n d͡ʒ
عوج	ʕ i w a d͡ʒ
خيوط	x u j uː tˤ
رواصيل	r a w aː sˤ iː l
باطس	b aː tˤ u s
أصدأ	ʔ a sˤ d a ʔ
احترق	i ħ t a r a q a
ينسون	j a n s uː n
طبقة	tˤ a b a q a
عرزال	ʕ i r z aː l
مصبنة	m a sˤ b a n a
سفوف	s a f uː f
طائفة	tˤ aː ʔ i f a
ذبول	ð u b uː l
صرافة	sˤ a r r aː f a
أثث	ʔ a θ θ a θ a
أبث	ʔ a b a θ a
قبطان	q u b tˤ aː n
فجائي	f u d͡ʒ aː ʔ i j j
خارصين	x aː r a sˤ iː n
أعجوبة	ʔ u ʕ d͡ʒ uː b a
عصف	ʕ a sˤ a f a
أيوب	ʔ a j j uː b
تراب	t u r aː b
مارس	m aː r a s a
قداد	q a d aː d
فؤول	f u ʔ uː l
توتياء	t uː t i j aː ʔ
كلك	k a l a k
قعد	q a ʕ a d a
قمح	q a m ħ
رفس	r a f a s a
عجرفة	ʕ a d͡ʒ r a f a
ارتخى	i r t a x aː
معجزات	m u ʕ d͡ʒ i z aː t
رتيلة	r u t a j l a
بثور	b u θ uː r
تعليق	t a ʕ l iː q
عمل	ʕ a m a l
قوش	q uː ʃ
سقم	s a q a m
اقترح	i q t a r a ħ a
ثمانون	θ a m aː n uː n
مرسم	m a r s a m
ذوق	ð a w q
هابيل	h aː b iː l
مسطار	m i s tˤ aː r
شنجار	ʃ a n d͡ʒ aː r
صغير	sˤ a ɣ iː r
أكب	ʔ a k a b b a
بلاعة	b a l l aː ʕ a
أعيا	ʔ a ʕ j aː
أمستردام	ʔ a m s t i r d aː m
وثيق	w a θ iː q
مشواة	m i ʃ w aː h
قارة	q aː r a
قورح	q uː r a ħ
عقل	ʕ a q l
قيشور	q a j ʃ uː r
خوارزم	x a w aː r i z m
استلزم	i s t a l z a m a
فئران	f i ʔ r aː n
شراء	ʃ i r aː ʔ
مرماخور	m a r m aː x uː r
تبشير	t a b ʃ iː r
أولى	ʔ a w l aː
رائع	r aː ʔ i ʕ
معماري	m i ʕ m aː r i j j
وجيز	w a d͡ʒ iː z
اتصل	i t t a sˤ a l a
صحح	sˤ a ħ ħ a ħ a
مبارز	m u b aː r a z
أليس	ʔ a l iː s
تدليل	t a d l iː l
رصفان	r u sˤ f aː n
لمح	l a m a ħ a
هعخع	h u ʕ x u ʕ
يانسون	j aː n a s uː n
مشتاق	m u ʃ t aː q
غذى	ɣ a ð ð aː
سيماء	s iː m aː ʔ
راحل	r aː ħ i l
تمادى	t a m aː d aː
تناقض	t a n aː q a dˤ a
قطيفة	q a tˤ iː f a
إسناد	ʔ i s n aː d
رجينة	r a d͡ʒ iː n a
بهلول	b u h l uː l
ألغى	ʔ a l ɣ aː
فضح	f a dˤ a ħ a
انشق	i n ʃ a q q a
عاب	ʕ aː b a
سبعة	s a b ʕ a
مكحلة	m u k a ħ l a
أنزل	ʔ a n z a l a
طاقية	tˤ aː q i j j a
مركب	m a r k a b
طول	tˤ a w l
سكران	s a k r aː n
جاف	d͡ʒ aː f a
غزير	ɣ a z iː r
دراسي	d i r aː s i j j
عقيدة	ʕ a q iː d a
إقناع	ʔ i q n aː ʕ
ساء	s aː ʔ a
أنبوب	ʔ u n b uː b
بحاح	b u ħ aː ħ
مشترك	m u ʃ t a r a k
ظرفية	ðˤ a r f i j j a
إبراهيم	ʔ i b r aː h iː m
قريدس	q u r a j d i s
عطارد	ʕ u tˤ aː r i d
عبوثران	ʕ a b a w θ a r aː n
بنفسجي	b a n a f s a d͡ʒ i j j
زفزف	z i f z i f
أنس	ʔ a n a s a
محارب	m u ħ aː r i b
قائف	q aː ʔ i f
قشر	q a ʃ a r a
زغلول	z u ɣ l uː l
خصص	x a sˤ sˤ a sˤ a
جمع	d͡ʒ a m a ʕ a
ثمن	t u m u n
مغسلة	m a ɣ s a l a
جربوع	d͡ʒ a r b uː ʕ
اكترى	i k t a r aː
مداخلة	m u d aː x a l a
أفريقيا	ʔ a f r iː q j aː
أوضح	ʔ a w dˤ a ħ a
بطروخ	b a tˤ r uː x
رياضة	r i j aː dˤ a
إسطبل	ʔ i s tˤ a b l
قصاج	q u sˤ aː d͡ʒ
راع	r aː ʕ a
سليقة	s a l iː q a
حشيش	ħ a ʃ iː ʃ
فقس	f a q a s a
مخصصات	m u x a sˤ sˤ a sˤ aː t
تشويق	t a ʃ w iː q
رقيب	r a q iː b
مورد	m a w r i d
قوق	q uː q
أعقد	ʔ a ʕ q a d
هواء	h a w aː ʔ
صتع	sˤ a t a ʕ a
هزج	h a z i d͡ʒ a
مسابقة	m u s aː b a q a
اختلال	i x t i l aː l
علامة	ʕ a l aː m a
ثابت	θ aː b i t
افترى	i f t a r aː
نموذج	n a m uː ð a d͡ʒ
طربوش	tˤ a r b uː ʃ
استئمارة	i s t i ʔ m aː r a
رمادي	r a m aː d i j j
استفراغ	i s t i f r aː ɣ
زحل	z u ħ a l
رأسي	r a ʔ s i j j
اقتصاد	i q t i sˤ aː d
رضوخ	r u dˤ uː x
ارتاع	i r t aː ʕ a
صدق	sˤ a d a q a
خباز	x a b b aː z
تركمانستان	t u r k u m aː n i s t aː n
أكثرية	ʔ a k θ a r i j j a
حالة	ħ aː l a
رطب	r a tˤ b
حجرة	ħ u d͡ʒ r a
أسطوري	ʔ u s tˤ uː r i j j
تسلق	t a s a l l a q a
مقداد	m i q d aː d
غمامة	ɣ a m aː m a
أنهى	ʔ a n h aː
انفتح	i n f a t a ħ a
توسع	t a w a s s a ʕ a
بقر	b a q a r
قطة	q i tˤ tˤ a
مجرب	m u d͡ʒ a r r i b
ابتنى	i b t a n aː
خفق	x a f a q a
أشترغار	ʔ u ʃ t u r ɣ aː r
الأرض	a l ʔ a r dˤ
فطيسة	f a tˤ iː s a
معدن	m a ʕ d i n
مغفرة	m a ɣ f i r a
أدبة	ʔ a d a b a
خاطئ	x aː tˤ i ʔ
حربث	ħ u r b u θ
روض	r a w w a dˤ a
قرد	q a r d
مبارزة	m u b aː r a z a
انتقال	i n t i q aː l
بنجنكشت	b a n d͡ʒ a n k u ʃ t
اصطخم	i sˤ tˤ a x a m a
تفادى	t a f aː d aː
زانية	z aː n i j a
جندية	d͡ʒ u n d i j j a
صؤول	sˤ a ʔ uː l
صفد	sˤ a f a d
سورة	s a w r a
هجران	h i d͡ʒ r aː n
كزبرة	k u z b a r a
مستقبل	m u s t a q b a l
جارة	d͡ʒ aː r a
أشوس	ʔ a ʃ w a s
ميمون	m a j m uː n
راءى	r aː ʔ aː
نحاس	n u ħ aː s
انتبه	i n t a b a h a
تهجى	t a h a d͡ʒ d͡ʒ aː
مشرب	m a ʃ r a b
مخمل	m u x m a l
ناطف	n aː tˤ i f
ذهب	ð a h a b
صراط	sˤ i r aː tˤ
دغدغ	d a ɣ d a ɣ a
شلغم	ʃ a l ɣ a m
شعر	ʃ a ʕ a r
بساطة	b a s aː tˤ a
تلفاف	t i l f aː f
لاسلطوية	l aː s u l tˤ a w i j j a
ممتلكات	m u m t a l a k aː t
تنرفز	t a n a r f a z a
نبأ	n a b a ʔ
أعلى	ʔ a ʕ l aː
مخافة	m a x aː f a
عيدية	ʕ iː d i j j a
اجتذب	i d͡ʒ t a ð a b a
استصح	i s t a sˤ a ħ ħ a
يعقوب	j a ʕ q uː b
إسرنج	ʔ i s r i n d͡ʒ
رضائع	r a dˤ aː ʔ i ʕ
مرتعب	m u r t a ʕ i b
ألمانيا	ʔ a l m aː n i j aː
قهوة	q a h w a
فيل	f iː l
سمار	s a m aː r
مضيرة	m a dˤ iː r a
مطار	m a tˤ aː r
غار	ɣ aː r a
كان	k aː n a
طومار	tˤ uː m aː r
أحسن	ʔ a ħ s a n
ناردين	n aː r a d iː n
قرقس	q i r q i s
مضاربة	m u dˤ aː r a b a
رابع	r aː b i ʕ
عرناس	ʕ a r n aː s
عالي	ʕ aː l iː
غائر	ɣ aː ʔ i r
لهيب	l a h iː b
استطار	i s t a tˤ aː r a
فني	f a n i j a
صنان	sˤ u n aː n
فرغ	f a r a ɣ a
بيلادونا	b iː l aː d uː n aː
انتهى	i n t a h aː
زحزح	z a ħ z a ħ a
إمامة	ʔ i m aː m a
مرحاض	m i r ħ aː dˤ
شيطاني	ʃ a j tˤ aː n i j j
نشيدة	n a ʃ iː d a
سركنجبين	s i r k a n d͡ʒ a b iː n
أتوم	ʔ a t uː m
غلقة	ɣ a l q a
همجي	h a m a d͡ʒ i j j
أسلوب	ʔ u s l uː b
لبلاب	l a b l aː b
أمسوخ	ʔ u m s uː x
خلافة	x i l aː f a
جدوى	d͡ʒ a d w aː
قائد	q aː ʔ i d
أتى	ʔ a t aː
إدريس	ʔ i d r iː s
فعل	f a ʕ a l a
خلاعي	x a l aː ʕ i j j
البهاما	a l b a h aː m aː
أبهج	ʔ a b h a d͡ʒ a
نظامي	n a ðˤ ðˤ aː m i j j
سلطانية	s u l tˤ aː n i j j a
سكرتير	s i k r i t iː r
نفث	n a f a θ a
رهبانية	r a h b aː n i j j a
مغيم	m u ɣ a j j i m
ذاق	ð aː q a
تاجر	t aː d͡ʒ i r
نيابة	n i j aː b a
ضالين	dˤ aː l l iː n
مقعدة	m a q ʕ a d a
جسم	d͡ʒ a s s a m a
فضائي	f a dˤ aː ʔ i j j
جار	d͡ʒ aː r
قوم	q a w m
شيء	ʃ a j ʔ
زريبة	z a r iː b a
مصنع	m a sˤ n a ʕ
سوريا	s uː r i j aː
ضحية	dˤ a ħ i j j a
لبأ	l i b a ʔ
معقود	m a ʕ q uː d
ساعد	s aː ʕ a d a
طمأن	tˤ a m ʔ a n a
غين	ɣ a j n
إستار	ʔ i s t aː r
وابور	w aː b uː r
سواكن	s a w aː k i n
استحضر	i s t a ħ dˤ a r a
ضخم	dˤ a x m
فرمل	f a r m a l a
عصيان	ʕ i sˤ j aː n
لمى	l a m aː
بطانة	b i tˤ aː n a
غبط	ɣ a b a tˤ a
ممحوق	m a m ħ uː q
ازدهر	i z d a h a r a
غارة	ɣ aː r a
تمنى	t a m a n n aː
الكاميرون	a l k aː m iː r uː n
تورم	t a w a r r a m a
بركة	b a r a k a
فضي	f i dˤ dˤ i j j
فوتنج	f uː t a n a d͡ʒ
اخترق	i x t a r a q a
حيطة	ħ a j tˤ a
بتاتا	b a t aː t aː
غيرة	ɣ a j r a
حبالة	ħ i b aː l a
وطني	w a tˤ a n i j j
مجمد	m u d͡ʒ a m m a d
طحين	tˤ a ħ iː n
هاتف	h aː t i f
معبر	m a ʕ b a r
مضيق	m a dˤ iː q
كركند	k a r k a n d
سفارة	s i f aː r a
شراع	ʃ i r aː ʕ
أعتاب	ʔ a ʕ t aː b
مسيحي	m a s iː ħ i j j
اكتسى	i k t a s aː
بعيد	b a ʕ iː d
خرج	x a r a d͡ʒ a
حمص	ħ a m m a sˤ a
زقوم	z a q q uː m
لبى	l a b b aː
خزف	x a z a f
جثجاث	d͡ʒ a θ d͡ʒ aː θ
أرسطو	ʔ a r i s tˤ uː
شحاذ	ʃ a ħ ħ aː ð
معانقة	m u ʕ aː n a q a
الجديدة	a l d͡ʒ a d iː d a
طيارة	tˤ a j j aː r a
مغناطيس	m a ɣ n aː tˤ iː s
فلس	f a l a s a
كوز	k uː z
خصوص	x u sˤ uː sˤ
شحاذة	ʃ i ħ aː ð a
شفاف	ʃ a f f aː f
حساسي	ħ a s s aː s i j j
ضواحك	dˤ a w aː ħ i k
حاسم	ħ aː s i m
إبل	ʔ i b i l
حسل	ħ i s l
ممرض	m u m a r r i dˤ
يافوخ	j aː f uː x
مائدة	m aː ʔ i d a
صالح	sˤ aː l i ħ
أرجان	ʔ a r d͡ʒ aː n
تأرجح	t a ʔ a r d͡ʒ a ħ a
فأل	f a ʔ l
سوس	s a w i s a
ريال	r i j aː l
وتيرة	w a t iː r a
ضيق	dˤ a j j a q a
صنارة	sˤ i n aː r a
خادم	x aː d i m
قاووش	q aː w uː ʃ
فقاقيع	f a q aː q iː ʕ
جنينة	d͡ʒ u n a j n a
أدحية	ʔ u d ħ i j a
مثلجات	m u θ a l l a d͡ʒ aː t
مطحنة	m a tˤ ħ a n a
مصحنة	m i sˤ ħ a n a
ملحن	m u l a ħ ħ i n
حلتيث	ħ i l t iː θ
موسكو	m uː s k uː
إمضاء	ʔ i m dˤ aː ʔ
قشعريرة	q u ʃ a ʕ r iː r a
جعل	d͡ʒ a ʕ a l a
سلاف	s u l aː f
ديك	d iː k
صحراوي	sˤ a ħ r aː w i j j
شجا	ʃ a d͡ʒ aː
اكتئاب	i k t i ʔ aː b
رغيفات	r a ɣ iː f aː t
قاض	q aː dˤ a
أتقن	ʔ a t q a n a
مبرهنة	m u b a r h a n a
رائب	r aː ʔ i b
وقت	w a q a t
رقف	r a q a f
غانا	ɣ aː n aː
رجب	r a d͡ʒ a b
رمس	r a m a s
بربخ	b a r b a x
مسعور	m a s ʕ uː r
بطرخ	b a tˤ r a x
مثابة	m a θ aː b a
عدالة	ʕ a d aː l a
بريد	b a r iː d
سحلية	s i ħ l i j j a
مغطس	m a ɣ tˤ i s
صدغ	sˤ a d ɣ
ممسح	m i m s a ħ
يسار	j a s aː r
خطئ	x a tˤ i ʔ a
آنك	ʔ aː n u k
أتون	ʔ a t t uː n
ندم	n a d a m
قابلية	q aː b i l i j j a
كرى	k a r aː
مسيح	m a s iː ħ
ركلات	r a k a l aː t
بحران	b u ħ r aː n
فكر	f a k a r a
صاءك	sˤ aː ʔ a k a
علقم	ʕ a l q a m
ذرية	ð u r r i j j a
معنى	m a ʕ n aː
مطواة	m i tˤ w aː h
لهاث	l u h aː θ
بناية	b i n aː j a
شهلة	ʃ a h l a
حبن	ħ a b a n
مرجع	m a r d͡ʒ i ʕ
صبحة	sˤ a b ħ a
فهرس	f i h r i s
كودن	k a w d a n
مخلوقات	m a x l uː q aː t
يشوع	j a ʃ uː ʕ
تدريس	t a d r iː s
بطالة	b a tˤ aː l a
يوم	j a w m
شلال	ʃ a l l aː l
شبوط	ʃ a b b uː tˤ
أناغاليس	ʔ a n aː ɣ aː l iː s
مثال	m i θ aː l
شاور	ʃ aː w a r a
أنهك	ʔ a n h a k a
حرقدة	ħ a r q a d a
تعصب	t a ʕ a sˤ sˤ a b a
ناهز	n aː h a z a
احتقر	i ħ t a q a r a
قميحة	q a m iː ħ a
أمريكي	ʔ a m r iː k i j j
مستدير	m u s t a d iː r
خداج	x i d aː d͡ʒ
حملة	ħ a m l a
إدحية	ʔ i d ħ i j a
ميمنة	m a j m a n a
نورج	n a w r a d͡ʒ
رافعة	r aː f i ʕ a
عازب	ʕ aː z i b
حمصيص	ħ a m a sˤ iː sˤ
جربوز	d͡ʒ a r b uː z
نهق	n a h a q a
هريرة	h u r a j r a h
بساط	b i s aː tˤ
سنط	s a n tˤ
بشنونة	b a ʃ n uː n a
ندوات	n a d a w aː t
كمء	k a m ʔ
فصد	f a sˤ a d a
فيما	f iː m aː
معادلة	m u ʕ aː d a l a
إبريق	ʔ i b r iː q
طرابلس	tˤ a r aː b l u s
موقع	m a w q i ʕ
ودامون	w a d aː m uː n
آمين	ʔ aː m iː n a
سين	s iː n
كانون	k aː n uː n
جاب	d͡ʒ aː b a
وبل	w a b a l a
ظليم	ðˤ a l iː m
تقدد	t a q a d d a d a
أعور	ʔ a ʕ w a r
شوحة	ʃ uː ħ a
تومان	t uː m aː n
مهم	m u h i m m
طلح	tˤ a l ħ
إسكتلندي	ʔ i s k u t l a n d i j j
أنثوي	ʔ u n θ a w i j j
إسلام	ʔ i s l aː m
مغلاق	m i ɣ l aː q
أخضر	ʔ a x dˤ a r
تصالح	t a sˤ aː l a ħ a
صمغ	sˤ a m ɣ
صبرة	sˤ a b a r a
إشبيلية	ʔ i ʃ b iː l i j a
صبابة	sˤ a b aː b a
مؤسسة	m u ʔ a s s a s a
سوسة	s uː s a
ورن	w a r a n
فسح	f a s a ħ a
مميثا	m a m m iː θ aː
مغنم	m a ɣ n a m
ترنح	t a r a n n a ħ a
قفازات	q u f f aː z aː t
تعطى	t a ʕ a tˤ tˤ aː
فراطة	f u r aː tˤ a
أخيرى	ʔ u x a j r aː
تعلة	t a ʕ i l l a
فالودج	f aː l uː d a d͡ʒ
مسرحي	m a s r a ħ i j j
ثلاثة	θ a l aː θ a
ماسورة	m aː s uː r a
العراق	a l ʕ i r aː q
مفاجأة	m u f aː d͡ʒ a ʔ a
كوالا	k u w aː l aː
راجل	r aː d͡ʒ i l
سقلطوني	s i q i l l a tˤ uː n i j j
فرع	f a r a ʕ
إبيقوري	ʔ i b iː q uː r i j j
ثيوقراطي	θ i j uː q r aː tˤ i j j
توزيع	t a w z iː ʕ
بابل	b aː b i l
درزن	d a r z a n
مصباح	m i sˤ b aː ħ
لأن	l i ʔ a n n a
إجازة	ʔ i d͡ʒ aː z a
كهرومائي	k a h r uː m aː ʔ i j j
متحد	m u t t a ħ i d
قشف	q a ʃ i f a
كراج	k a r aː d͡ʒ
معاصر	m u ʕ aː sˤ i r
آخن	ʔ aː x a n
لبلبي	l a b l a b i j j
قونية	q uː n i j a
عفيف	ʕ a f iː f
بركري	b a r k a r i j j
فشقار	f a ʃ q aː r
خراء	x i r aː ʔ
أصيص	ʔ a sˤ iː sˤ
شعلة	ʃ u ʕ l a
قتبان	q a t a b aː n
حنان	ħ a n aː n
جادل	d͡ʒ aː d a l a
العاصي	a l ʕ aː sˤ iː
الصربية	a sˤ sˤ i r b i j j a
أنف	ʔ a n f
لصف	l a sˤ a f
أطفال	ʔ a tˤ f aː l
ميويزج	m a j w iː z a d͡ʒ
ستارة	s i t aː r a
جلب	d͡ʒ a l a b
مقاس	m a q aː s
لحظتذاك	l a ħ ðˤ a t a ð aː k a
مشروع	m a ʃ r uː ʕ
المنامة	a l m a n aː m a
مكون	m u k a w w i n
أندر	ʔ a n d a r
زعتر	z a ʕ t a r
قبرة	q u b b a r a
إسكندراني	ʔ i s k a n d a r aː n i j j
أطنب	ʔ a tˤ n a b a
قاوق	q aː w u q
أطرش	ʔ a tˤ r a ʃ
طلاق	tˤ a l aː q
أنواع	ʔ a n w aː ʕ
عشرات	ʕ a ʃ a r aː t
تودريج	t uː d a r iː d͡ʒ
إيا	ʔ i j j aː
إعلامي	ʔ i ʕ l aː m i j j
زايلفون	z aː j l u f uː n
مكسور	m a k s uː r
قرطاس	q i r tˤ aː s
نطل	n a tˤ a l a
دعموص	d u ʕ m uː sˤ
سعيد	s a ʕ iː d
كهف	k a h f
نشرة	n a ʃ r a
استغرق	i s t a ɣ r a q a
أتاح	ʔ a t aː ħ a
قذارة	q a ð aː r a
باضع	b aː dˤ i ʕ
برقوق	b a r q uː q
تشخيصي	t a ʃ x iː sˤ i j j
مضرب	m i dˤ r a b
خربز	x i r b i z
صاع	sˤ aː ʕ
سطم	s a tˤ a m a
فاء	f aː ʔ
بزم	b a z a m a
فوض	f a w w a dˤ a
زرجون	z a r d͡ʒ uː n
تصغير	t a sˤ ɣ iː r
لازوردي	l aː z u w a r d i j j
دعاء	d u ʕ aː ʔ
اتضح	i t t a dˤ a ħ a
محيط	m u ħ iː tˤ
وصيف	w a sˤ iː f
دوغ	d uː ɣ
أزرع	ʔ a z r a ʕ a
سمو	s u m u w w
فدائي	f i d aː ʔ i j j
لاوس	l aː w s
هطلس	h a tˤ a l l a s
حنطبة	ħ a n tˤ a b a
نافذة	n aː f i ð a
طحال	tˤ i ħ aː l
الرياض	a r r i j aː dˤ
حنظلة	ħ a n ðˤ a l a
جنسي	d͡ʒ a n n i s iː
تفاف	t i f aː f
إبرة	ʔ i b r a
ترسانة	t a r s aː n a
أشنان	ʔ u ʃ n aː n
نبذة	n u b ð a
انطلق	i n tˤ a l a q a
خلية	x a l i j j a
صخدان	sˤ a x a d aː n
طنجيرة	tˤ a n d͡ʒ iː r a
خامر	x aː m a r a
نعمة	n i ʕ m a
استثنائي	i s t i θ n aː ʔ i j j
أخصائي	ʔ a x i sˤ sˤ aː ʔ i j j
أصم	ʔ a sˤ a m m
تكلم	t a k a l l a m a
أساس	ʔ a s aː s
نفخ	n a f a x a
قندهار	q u n d u h aː r
سكرجة	s u k r u d͡ʒ a
تباطأ	t a b aː tˤ a ʔ a
تفاح	t u f f aː ħ
خيالي	x a j aː l i j j
تخطى	t a x a tˤ tˤ aː
يراع	j a r aː ʕ
تلم	t a l a m
زواج	z a w aː d͡ʒ
واحدة	w aː ħ i d a
فالود	f aː l uː d
فنجان	f i n d͡ʒ aː n
تمرين	t a m r iː n
حوافل	ħ a w aː f i l
زكريا	z a k a r i j j aː
حكومة	ħ u k uː m a
ضجر	dˤ a d͡ʒ i r
يتيم	j a t iː m
شجو	ʃ a d͡ʒ w
هراوة	h i r aː w a
تنزل	t a n a z z a l a
ياسمين	j aː s a m iː n
ينع	j a n a ʕ a
طفيف	tˤ a f iː f
كودين	k uː d iː n
طيفورية	tˤ a j f uː r i j j a
بسبايج	b a s b aː j a d͡ʒ
كشتبان	k u ʃ t u b aː n
زفن	z a f a n a
مثار	m u θ aː r
طائر	tˤ aː ʔ i r
سنت	s a n n a t
غصة	ɣ u sˤ sˤ a
عود	ʕ a w d
دزينة	d a z z iː n a
الصومال	a sˤ sˤ uː m aː l
أبيدجان	ʔ a b iː d d͡ʒ aː n
جني	d͡ʒ i n n i j j
دفاع	d i f aː ʕ
فيتق	f a j t a q
تعافى	t a ʕ aː f aː
رأي	r a ʔ j
تصوير	t a sˤ w iː r
ماجور	m aː d͡ʒ uː r
زائر	z aː ʔ i r
تحكيم	t a ħ k iː m
أنتيكخانة	ʔ a n t iː k x aː n a
وقع	w a q a ʕ a
لوياثان	l a w i j aː θ aː n
كبكب	k a b k a b a
اشتق	i ʃ t a q q a
مماس	m u m aː s s
انخرط	i n x a r a tˤ a
مالق	m aː l a q
مقولة	m a q uː l a
ماجد	m aː d͡ʒ i d
قنديل	q a n d iː l
سقراط	s u q r aː tˤ
سخد	s u x d
جمهورية	d͡ʒ u m h uː r i j j a
اكتتاب	i k t i t aː b
أزاح	ʔ a z aː ħ a
هود	h a w d
أموي	ʔ u m a w i j j
بلل	b a l a l
كفالة	k a f aː l a
خشخاش	x a ʃ x aː ʃ
عين	ʕ a j j a n a
شرق	ʃ a r q
ازديان	i z d i j aː n
قبر	q a b a r a
ابتلال	i b t i l aː l
ورس	w a r a s
غطس	ɣ a tˤ a s a
غيظ	ɣ a j ðˤ
شفنين	ʃ i f n iː n
ضاع	dˤ aː ʕ a
ساحل	s aː ħ i l
باقة	b aː q a
قرآني	q u r ʔ aː n i j j
غمى	ɣ a m m aː
صتم	sˤ a t a m
شعبية	ʃ a ʕ b i j j a
تعفج	t a ʕ a f f a d͡ʒ a
ميدان	m a j d aː n
وهلة	w a h l a
كمان	k a m aː n
أردمون	ʔ a r d a m uː n
ثاودسيوس	θ aː w u d u s i j uː s
آني	ʔ aː n i j j
ركبة	r a k a b a
غلا	ɣ a l aː
أركنساس	ʔ a r k a n s aː s
سقيم	s a q iː m
مدبر	m u d a b b i r
فلسطين	f i l a s tˤ iː n
فاجأ	f aː d͡ʒ a ʔ a
مستعرب	m u s t a ʕ r i b
بهمن	b a h m a n
أغلفة	ʔ a ɣ l i f a
تعزل	t a ʕ a z z a l a
تصادف	t a sˤ aː d a f a
بلغم	b a l ɣ a m
سكون	s u k uː n
قابيل	q aː b iː l
كراني	k a r r aː n i j j
داخل	d aː x a l a
سحور	s a ħ uː r
رطانة	r a tˤ aː n a
رسول	r a s uː l
سلافي	s l aː f i j j
افتراع	i f t i r aː ʕ
رجلة	r u d͡ʒ l a
ذئب	ð i ʔ b
ردد	r a d d a d a
وجهة	w i d͡ʒ h a
ترنج	t r i n d͡ʒ
مقالة	m a q aː l a
شكري	ʃ u k r i j j
ابنة	i b n a
أخت	ʔ u x t
تأوه	t a ʔ a w w a h a
بولاد	b uː l aː d
غمود	ɣ u m uː d
مقايسة	m u q aː j a s a
طمى	tˤ a m aː
بعيثران	b a ʕ a j θ a r aː n
قروش	q u r uː ʃ
صيخود	sˤ a j x uː d
رمل	r a m l
انشقاق	i n ʃ i q aː q
زوم	z uː m
انقلاب	i n q i l aː b
اليمن	a l j a m a n
دردي	d i r d iː
بابونج	b aː b uː n a d͡ʒ
نبوغ	n u b uː ɣ
مساواة	m u s aː w aː h
وزنة	w a z n a
شتاء	ʃ i t aː ʔ
نير	n a j j i r
شبح	ʃ a b a ħ
وتدي	w a t a d i j j
آسيوي	ʔ aː s i j a w i j j
لطم	l a tˤ a m a
مليء	m a l iː ʔ
إتلاف	ʔ i t l aː f
منقار	m a n q aː r
رمش	r a m a ʃ a
سماء	s a m aː ʔ
نبات	n a b aː t
ابرغش	i b r a ɣ a ʃ ʃ a
المغرب	a l m a ɣ r i b
أوحل	ʔ a w ħ a l a
قافلة	q aː f i l a
مكن	m a k k a n a
أثجل	ʔ a θ d͡ʒ a l
عفونة	ʕ u f uː n a
طبقات	tˤ a b a q aː t
فوار	f a w w aː r
بتليس	b i t l iː s
اختلاس	i x t i l aː s
مسقط	m a s q a tˤ
مخبول	m a x b uː l
اصهب	i sˤ h a b b a
جذاب	d͡ʒ a ð ð aː b
صولجان	sˤ a w l a d͡ʒ aː n
باستا	b aː s t aː
عبق	ʕ a b b a q a
فتخاء	f a t x aː ʔ
ظربان	ðˤ a r i b aː n
المكسيك	a l m a k s iː k
أوعية	ʔ a w ʕ i j a
ملعقة	m i l ʕ a q a
سلطوي	s u l tˤ a w i j j
هيئة	h a j ʔ a
غرور	ɣ u r uː r
إبداعي	ʔ i b d aː ʕ i j j
دافئ	d aː f i ʔ
لثغة	l u θ ɣ a
خصوصي	x u sˤ uː sˤ i j j
جرو	d͡ʒ a r w
متسامح	m u t a s aː m i ħ
سهوة	s a h w a
صهيونية	sˤ a h j uː n i j j a
أنبذ	ʔ a n b a ð a
قاليقلا	q aː l iː q a l aː
إسوة	ʔ i s w a
جرؤ	d͡ʒ a r u ʔ a
سقمونيا	s a q a m uː n i j aː
فوضوي	f a w dˤ a w i j j
ضائنة	dˤ aː ʔ i n a
فاسد	f aː s i d
مداومة	m u d aː w a m a
صقيع	sˤ a q iː ʕ
أهر	ʔ a h a r r a
حجة	ħ i d͡ʒ d͡ʒ a
سفيه	s a f iː h
برجار	b i r d͡ʒ aː r
نعوظ	n u ʕ uː ðˤ
لوز	l a w z
فواق	f u w aː q
باذنجان	b aː ð i n d͡ʒ aː n
السعودية	a s s a ʕ uː d i j j a
اتبع	i t t a b a ʕ a
جلباب	d͡ʒ i l b aː b
بسبب	b i s a b a b i
مختبر	m u x t a b a r
جنائي	d͡ʒ i n aː ʔ i j j
إهليلج	ʔ i h l iː l a d͡ʒ
معلم	m a ʕ l a m
قيصر	q a j sˤ a r
ملاحظة	m u l aː ħ a ðˤ a
مقاولة	m u q aː w a l a
تخم	t a x m
سلاح	s i l aː ħ
زاغ	z aː ɣ a
زوج	z a w d͡ʒ
غاشم	ɣ aː ʃ i m
شلح	ʃ a l a ħ a
غطى	ɣ a tˤ tˤ aː
باحث	b aː ħ a θ a
عبو	ʕ a b w
رأسمال	r a ʔ s m aː l
لام	l aː m
مزر	m i z r
شرقي	ʃ a r q i j j
روسيا	r uː s i j aː
بيرق	b a j r a q
مهندس	m u h a n d i s
رادود	r aː d uː d
مثانة	m a θ aː n a
قطعة	q a tˤ a ʕ a
ثانوي	θ aː n a w i
واقعة	w aː q i ʕ a
استخدم	i s t a x d a m a
كمثراة	k u m m a θ r aː h
درباس	d i r b aː s
دون	d a w w a n a
رائعة	r aː ʔ i ʕ a
ذمم	ð i m a m
كاذب	k aː ð i b
سقيفة	s a q iː f a
زاي	z aː j
حكة	ħ i k k a
ثريد	θ a r iː d
شيلم	ʃ a j l a m
جزء	d͡ʒ u z ʔ
سعة	s a ʕ a
حلكة	ħ u l k a
سئم	s a ʔ i m a
زوفا	z uː f aː
أباس	ʔ u b aː s
ديانات	d i j aː n aː t
خطيئة	x a tˤ iː ʔ a
مشتريات	m u ʃ t a r a j aː t
عسكر	ʕ a s k a r
صؤل	sˤ a ʔ u l a
بصير	b a sˤ iː r
اندفاع	i n d i f aː ʕ
اصطك	i sˤ tˤ a k k a
نعجة	n a ʕ d͡ʒ a
اغرورق	i ɣ r a w r a q a
اقتصر	i q t a sˤ a r a
حماض	ħ a m m aː dˤ
غالبية	ɣ aː l i b i j j a
مفك	m i f a k k
شنع	ʃ a n n a ʕ a
ماه	m aː h a
أرضة	ʔ a r a dˤ a
وصفة	w a sˤ f a
تصادم	t a sˤ aː d a m a
جليس	d͡ʒ a l iː s
صبان	sˤ a b b aː n
استمارة	i s t i m aː r a
سورينام	s uː r iː n aː m
زرع	z a r a ʕ a
جريدة	d͡ʒ a r iː d a
ذئبة	ð i ʔ b a
واحة	w aː ħ a
رقابة	r a q aː b a
جدد	d͡ʒ a d a d
بديهي	b a d iː h i j j
بوذا	b uː ð aː
شرسوف	ʃ u r s uː f
للأسف	l i l ʔ a s a f
أخطبوط	ʔ u x tˤ u b uː tˤ
شمال	ʃ a m aː l
عباء	ʕ a b aː ʔ
الإسلام	a l ʔ i s l aː m
آذى	ʔ aː ð aː
أسماء	ʔ a s m aː ʔ
سطات	s i tˤ aː t
مرقشيثا	m a r q a ʃ iː θ aː
عائلة	ʕ aː ʔ i l a
رعرع	r a ʕ r a ʕ a
حبرج	ħ u b r u d͡ʒ
مخرفة	m a x r a f a
أسفنيك	ʔ a s f a n iː k
شقواص	ʃ a q w aː sˤ
طيرة	tˤ a j r a
حصل	ħ a sˤ a l
تمهل	t a m a h h a l a
مربوط	m a r b uː tˤ
رومانسي	r uː m aː n s i j j
دوافع	d a w aː f i ʕ
امرأ	i m r a ʔ
كاحل	k aː ħ i l
سطح	s a tˤ ħ
عام	ʕ aː m
سيكران	s a j k a r aː n
ضفدع	dˤ a f d a ʕ
خمسة	x a m s a
شريعة	ʃ a r iː ʕ a
صربي	sˤ i r b i j j
أمدمي	ʔ u m d a m i j j
رحمة	r a ħ m a
استنشق	i s t a n ʃ a q a
نبرة	n a b r a
هدار	h a d d aː r
ناميبيا	n aː m iː b j aː
أبوت	ʔ u b uː t
ممن	m i m m a n
آبيس	ʔ aː b iː s
ليبيا	l iː b i j aː
طأطأ	tˤ a ʔ tˤ a ʔ a
نهز	n a h a z a
ساءل	s aː ʔ a l a
منفاخ	m i n f aː x
صرب	sˤ a r a b a
تسريب	t a s r iː b
إنجليزي	ʔ i n d͡ʒ i l iː z i j j
سفر	s a f a r
غرس	ɣ a r a s a
صقنقور	sˤ a q a n q uː r
أيقظ	ʔ a j q a ðˤ a
وجد	w a d͡ʒ a d a
أفريقانية	ʔ a f r iː q aː n i j j a
صدفة	sˤ a d a f a
تقليدي	t a q l iː d i j j
أكل	ʔ a k a l a
العبرية	a l ʕ i b r i j j a
مرارة	m a r aː r a
إيجار	ʔ iː d͡ʒ aː r
شاف	ʃ aː f a
كافور	k aː f uː r
أنثى	ʔ u n θ aː
مثلجة	m a θ l a d͡ʒ a
نحن	n a ħ n i
مهراس	m a h r aː s
مغبن	m a ɣ b a n
ريباس	r iː b aː s
مسؤولية	m a s ʔ uː l i j j a
زخات	z a x x aː t
عريش	ʕ a r iː ʃ
مثلي	m i θ l i j j
ثآليل	θ a ʔ aː l iː l
براشوت	b a r aː ʃ uː t
خنصور	x a n sˤ uː r
ساعة	s aː ʕ a
طخش	tˤ a x ʃ
حلتيت	ħ a l t iː t
ألا	ʔ a l aː
مصراع	m i sˤ r aː ʕ
فوذنج	f uː ð a n a d͡ʒ
إبليز	ʔ i b l iː z
متخلف	m i t x a l l a f
مهابة	m a h aː b a
قعاب	q i ʕ aː b
بغيض	b a ɣ iː dˤ
فاكرة	f aː k i r a
إفرند	ʔ i f r i n d
سبطانة	s a b a tˤ aː n a
سراح	s a r aː ħ
أجمة	ʔ a d͡ʒ a m a
برمج	b a r m a d͡ʒ a
مساعد	m u s aː ʕ i d
استعان	i s t a ʕ aː n a
سابع	s aː b i ʕ
برتقالي	b u r t u q aː l i j j
يبروح	j a b r uː ħ
مداولة	m u d aː w a l a
لكم	l a k a m a
تمتمة	t a m t a m a
متزاوج	m u t a z aː w i d͡ʒ
حسنا	ħ a s s a n n aː
رضعاء	r u dˤ a ʕ aː ʔ
شاقولي	ʃ aː q uː l i j j
شيرة	ʃ a j r a
عنصرية	ʕ u n sˤ u r i j j a
شقاء	ʃ a q aː ʔ
مالطا	m aː l tˤ aː
أبد	ʔ a b a d
كبير	k a b iː r
طاف	tˤ aː f a
أصفر	ʔ a sˤ f a r
ذيل	ð a j l
بؤرة	b u ʔ r a
اتحد	i t t a ħ a d a
ردة	r i d d a
ألهى	ʔ a l h aː
كرواتي	k u r u w aː t i j j
بيعة	b a j ʕ a
ديباج	d iː b aː d͡ʒ
بريطاني	b a r iː tˤ aː n i j j
داعب	d aː ʕ a b a
قبيح	q a b iː ħ
حصن	ħ i sˤ n
متناول	m u t a n aː w i l
شره	ʃ a r i h a
عجورة	ʕ a d͡ʒ d͡ʒ uː r a
حقيقة	ħ a q iː q a
أساسي	ʔ a s aː s i j j
غاب	ɣ aː b a
بارزد	b aː r z a d
مئذنة	m i ʔ ð a n a
ميز	m a j j a z a
يناير	j a n aː j i r
استقبال	i s t i q b aː l
مكث	m a k a θ a
مقذاف	m i q ð aː f
بازنقر	b aː z i n q i r
عقال	ʕ i q aː l
طنجرة	tˤ a n d͡ʒ a r a
تماشى	t a m aː ʃ aː
غريغوريوس	ɣ i r iː ɣ uː r i j uː s
لبن	l a b a n
انطبق	i n tˤ a b a q a
ضوأ	dˤ a w w a ʔ a
تصتم	t a sˤ a t t a m a
اتسم	i t t a s a m a
حواء	ħ a w w aː ʔ
حجاب	ħ i d͡ʒ aː b
أكمة	ʔ a k a m a h
بينيت	b a j n iː t
غرمول	ɣ u r m uː l
اتسع	i t t a s a ʕ a
انتخب	i n t a x a b a
وصية	w a sˤ i j j a
مال	m aː l
معمودية	m a ʕ m uː d i j j a
تشهل	t a ʃ a h h a l a
أمريكا	ʔ a m r iː k aː
حوالي	ħ a w aː l a j
دلق	d a l a q a
خصفة	x a sˤ a f a
نرويجية	n u r w iː d͡ʒ i j j a
حماق	ħ a m aː q
رفاهة	r a f aː h a
طنبور	tˤ u n b uː r
فرعون	f i r ʕ a w n
فلك	f a l a k
حرامي	ħ a r aː m i j j
نانخواة	n aː n a x w aː h
ينبوع	j a n b uː ʕ
جعفيل	d͡ʒ a ʕ f iː l
بكرج	b a k r a d͡ʒ
مهدد	m u h a d d a d
لألأ	l a ʔ l a ʔ a
سافانا	s aː f aː n aː
قبيلة	q a b iː l a
خلق	x a l a q a
دوش	d uː ʃ
غلاية	ɣ a l l aː j a
وحمة	w a ħ m a
محموم	m a ħ m uː m
سنبلة	s u n b u l a
جزمازك	d͡ʒ a z m aː z a k
تزويد	t a z w iː d
ميثاق	m iː θ aː q
ألاسكا	ʔ a l aː s k aː
أنجى	ʔ a n d͡ʒ aː
سلامة	s a l aː m a
زربية	z a r b i j j a
صحرة	sˤ u ħ r a
ملكة	m a l i k a
عنوان	ʕ u n w aː n
بعثران	b a ʕ θ a r aː n
لوطي	l uː tˤ i j j
طبخ	tˤ a b a x a
أسفلت	ʔ a s f a l t
ميعاد	m iː ʕ aː d
ملعون	m a l ʕ uː n
راقب	r aː q a b a
فالودة	f aː l uː d a
حرمان	ħ i r m aː n
عزا	ʕ a z aː
وجب	w a d͡ʒ a b a
أنباض	ʔ a n b aː dˤ
محافظ	m a ħ aː f i ðˤ
تبغ	t a b ɣ
حلف	ħ a l a f a
بوري	b uː r iː
هازباء	h aː z i b aː ʔ
رهينة	r a h iː n a
نخاع	n u x aː ʕ
محجمة	m i ħ d͡ʒ a m a
استل	i s t a l l a
وقية	w i q i j j a
تعليم	t a ʕ l iː m
خنجر	x a n d͡ʒ a r
حنون	ħ a n uː n
معتل	m u ʕ t a l l
قصار	q i sˤ aː r
الله	a ɫ ɫ aː h
أزرق	ʔ a z r a q
مفلس	m u f l i s
تغيير	t a ɣ j iː r
المرء	a l m a r ʔ
كذاب	k a z z aː b
آيسلندا	ʔ aː j i s l a n d aː
روسي	r uː s i j j
قاموس	q aː m uː s
محرك	m u ħ a r r i k
أشخص	ʔ a ʃ x a sˤ a
ثرب	θ a r b
نتوء	n u t uː ʔ
تبارى	t a b aː r aː
مفرغ	m u f a r r a ɣ
إمالة	ʔ i m aː l a
هذب	h a ð ð a b a
جربندية	d͡ʒ a r a b a n d i j j a
فتاحة	f a t t aː ħ a
بوسة	b a w s a
جلنار	d͡ʒ u l l a n aː r
فاصوليا	f aː sˤ uː l i j aː
سميذ	s a m iː ð
صقر	sˤ a q r
خنق	x a n a q a
نخاس	n a x x aː s
بكة	b a k k a
حضرموت	ħ a dˤ r a m a w t
لحلاح	l a ħ l aː ħ
يونس	j uː n u s
حذو	ħ a ð w a
فرحة	f a r ħ a
إسرائيلي	ʔ i s r aː ʔ iː l i j j
تعشق	t a ʕ a ʃ ʃ a q a
أجرد	ʔ a d͡ʒ r a d
برن	b i r n
غاضب	ɣ aː dˤ i b
نوع	n a w w a ʕ a
بشندي	b a ʃ a n d iː
مدة	m a d d a
أنضب	ʔ a n dˤ a b a
وصاية	w i sˤ aː j a
حمل	ħ a m a l
زنخ	z a n i x a
محيص	m a ħ iː sˤ
أحول	ʔ a ħ w a l
أفل	ʔ a f a l a
شهترج	ʃ a h t a r a d͡ʒ
يربوع	j a r b uː ʕ
انهمك	i n h a m a k a
ليس	l a j i s a
ناشف	n aː ʃ i f
مسكان	m u s k aː n
أفقي	ʔ u f u q i j j
افترق	i f t a r a q a
دقيق	d a q iː q
دستج	d a s t a d͡ʒ
وظف	w a ðˤ ðˤ a f a
بلاهة	b a l aː h a
ابتلاش	i b t i l aː ʃ
ظيان	ðˤ a j j aː n
عتبة	ʕ a t a b a
بنطال	b a n tˤ aː l
سكسكة	s a k s a k a
مقلياثا	m a q l i j aː θ aː
مصدوم	m a sˤ d uː m
جاهز	d͡ʒ aː h i z
تصدير	t a sˤ d iː r
دفء	d i f ʔ
بائن	b aː ʔ i n
حوول	ħ uː w i l a
كرنيب	k a r n iː b
بالة	b aː l a
مسود	m u s w a d d
أنبج	ʔ a m b i d͡ʒ
فداحة	f a d aː ħ a
خرزة	x u r z a
غيبوبة	ɣ a j b uː b a
تين	t iː n
ارتبط	i r t a b a tˤ a
تواصى	t a w aː sˤ aː
معصم	m i ʕ sˤ a m
خفر	x a f a r a
ضغبوس	dˤ u ɣ b uː s
زمزم	z a m z a m
زهو	z a h w
أقرع	ʔ a q r a ʕ
وهمي	w a h m i j j
محترف	m u ħ t a r i f
اجتماعي	i d͡ʒ t i m aː ʕ i j j
الكنية	a l k u n j a
تسويق	t a s w iː q
فيروزي	f a j r uː z i j j
طنطور	tˤ a n tˤ uː r
نفط	n a f tˤ
دراجة	d a r r aː d͡ʒ a
حيث	ħ a j θ u
مثقب	m i θ q a b
حيهل	ħ a j j a h a l
غسالة	ɣ a s s aː l a
قراءة	q i r aː ʔ a
ناقوس	n aː q uː s
ردع	r a d a ʕ a
وراط	w i r aː tˤ
كسرة	k a s r a
صوف	sˤ a w i f a
مظهر	m a ðˤ h a r
سنبك	s u m b u k
لاهور	l aː h uː r
دغبوس	d u ɣ b uː s
مصطكى	m u sˤ tˤ a k aː
جندب	d͡ʒ u n d u b
أرسل	ʔ a r s a l a
أرغان	ʔ a r ɣ aː n
ظبي	ðˤ a b j
أسطورة	ʔ u s tˤ uː r a
بهيجة	b a h iː d͡ʒ a
لاذ	l aː ð a
باسل	b aː s i l
أرثوذكسي	ʔ u r θ uː ð u k s i j j
أباريق	ʔ a b aː r iː q
حمزة	ħ a m z a
درع	d a r r a ʕ a
منطقي	m a n tˤ i q i j j
تدريجي	t a d r iː d͡ʒ i j j
خرت	x a r a t a
أور	ʔ uː r
نعيم	n a ʕ iː m
ناسك	n aː s i k
أوقد	ʔ a w q a d a
حرق	ħ a r a q a
استحال	i s t a ħ aː l a
استكشاف	i s t i k ʃ aː f
متنوع	m u t a n a w w i ʕ
عاهل	ʕ aː h i l
دهليز	d i h l iː z
مسدس	m u s a d d a s
بقص	b a q sˤ
ذعن	ð a ʕ i n a
انتظر	i n t a ðˤ a r a
غضة	ɣ a dˤ dˤ a
شوفان	ʃ uː f aː n
تيقظ	t a j a q q a ðˤ a
مفصل	m u f a sˤ sˤ a l
حقد	ħ a q a d a
دفيء	d a f iː ʔ
حاول	ħ aː w a l a
أعف	ʔ a ʕ a f f a
ألقى	ʔ a l q aː
تضاد	t a dˤ aː d d a
وفق	w a f f a q a
رسالة	r i s aː l a
فقير	f a q iː r
عوائد	ʕ a w aː ʔ i d
أشرفي	ʔ a ʃ r a f i j j
عنقاد	ʕ i n q aː d
حمار	ħ a m m aː r
بقية	b a q i j j a
ترنيم	t a r n iː m
فتوش	f a t t uː ʃ
عجاوة	ʕ u d͡ʒ aː w a
سلباح	s i l b aː ħ
عجيب	ʕ a d͡ʒ iː b
شقف	ʃ a q a f
مسكوكة	m a s k uː k a
دستوري	d u s t uː r i j j
مروحة	m i r w a ħ a
انتقض	i n t a q a dˤ a
لامبالاة	l aː m u b aː l aː h
بدهي	b a d a h i j j
بينيث	b a j n iː θ
محل	m a ħ a l l
انهمر	i n h a m a r a
فولاذ	f uː l aː ð
طلع	tˤ a l a ʕ a
زحمة	z a ħ m a
لاعية	l aː ʕ i j a
بليلة	b a l iː l a
ناحية	n aː ħ i j a
حبلى	ħ u b l aː
احتج	i ħ t a d͡ʒ d͡ʒ a
اعتل	i ʕ t a l l a
باقلاء	b aː q i l aː ʔ
أنتما	ʔ a n t u m aː
مكدس	m u k a d d a s
حميم	ħ a m iː m
ائتلاف	i ʔ t i l aː f
ورشنوفة	w a r ʃ a n uː f a
ملا	m u l l aː
حراري	ħ a r aː r i j j
سطام	s i tˤ aː m
فريق	f a r iː q
ميناء	m iː n aː ʔ
مرددوش	m a r d a d uː ʃ
ببر	b a b r
مخلص	m a x l a sˤ
مدهش	m u d h a ʃ
تقدر	t a q a d d a r a
محرقة	m a ħ r a q a
مبشرة	m i b ʃ a r a
اعتصم	i ʕ t a sˤ a m a
عريض	ʕ a r iː dˤ
ورقة	w a r a q a
أولمبي	ʔ uː l i m b i j j
نضيج	n a dˤ iː d͡ʒ
احتضن	i ħ t a dˤ a n a
استعمل	i s t a ʕ m a l a
أعزل	ʔ a ʕ z a l
احتلال	i ħ t i l aː l
فصح	f a sˤ u ħ a
معزف	m i ʕ z a f
اختط	i x t a tˤ tˤ a
اندمل	i n d a m a l a
جسارة	d͡ʒ a s aː r a
كرز	k a r a z
مشيمة	m a ʃ iː m a
الألى	a l ʔ u l aː
فكاهي	f u k aː h i j j
مداد	m i d aː d
لجوء	l u d͡ʒ uː ʔ
معكرونة	m a ʕ k a r uː n a
تصعيد	t a sˤ ʕ iː d
موسيقا	m uː s iː q aː
استمد	i s t a m a d d a
لقاح	l a q aː ħ
بواليع	b a w aː l iː ʕ
قاوونة	q aː w uː n a
بيسوس	b a j s uː s
مقاطعة	m u q aː tˤ a ʕ a
فوارة	f a w w aː r a
شاذ	ʃ aː ð ð
هتك	h a t a k a
فرسخ	f a r s a x
قاجوج	q aː d͡ʒ uː d͡ʒ
ترقوة	t a r q u w a
قال	q aː l
نفاذ	n a f aː ð
كبل	k a b l
مضايف	m a dˤ aː j i f
أفغانستان	ʔ a f ɣ aː n i s t aː n
تعشن	t a ʕ a ʃ ʃ a n a
خسوف	x u s uː f
بشري	b a ʃ a r i j j
تقيؤ	t a q a j j u ʔ
عبقري	ʕ a b q a r i j j
هرولة	h a r w a l a
مشط	m a ʃ a tˤ a
ساخن	s aː x i n
كرسوع	k u r s uː ʕ
شوبك	ʃ a w b a k
أعجمي	ʔ a ʕ d͡ʒ a m i j j
خليجي	x a l iː d͡ʒ i j j
تكميلي	t a k m iː l i j j
عابس	ʕ aː b i s
أبها	ʔ a b h aː
نزية	n a z i j j a
حظيرة	ħ a ðˤ iː r a
جنس	d͡ʒ i n s
شكارة	ʃ i k aː r a
غيور	ɣ a j uː r
قلية	q i l l i j j a
شحيح	ʃ a ħ iː ħ
طمأنينة	tˤ u m a ʔ n iː n a
اتصاف	i t t i sˤ aː f
ملامح	m a l aː m i ħ
سار	s aː r r
هندس	h a n d a s a
سويسرا	s u w iː s r aː
فاجعة	f aː d͡ʒ i ʕ a
وسمة	w a s m a
مخاطر	m a x aː tˤ i r
محاور	m a ħ aː w i r
فراسيون	f a r aː s i j uː n
دماغ	d i m aː ɣ
كيرلس	k iː r u l u s
شاهلوج	ʃ aː h a l uː d͡ʒ
أجذاع	ʔ a d͡ʒ ð aː ʕ
باراغواي	b aː r aː ɣ u w aː j
علقة	ʕ a l a q a
تريث	t a r a j j a θ a
فرضية	f a r a dˤ i j j a
صحى	sˤ a ħ ħ aː
مسلة	m i s a l l a
استحصل	i s t a ħ sˤ a l a
أصبح	ʔ a sˤ b a ħ
شامة	ʃ aː m a
كلح	k a l a ħ a
جمجمة	d͡ʒ u m d͡ʒ u m a
قاع	q aː ʕ
غوشنة	ɣ a w ʃ a n a
الخرطوم	a l x u r tˤ uː m
مدام	m u d aː m
مرند	m a r a n d
صيدلاني	sˤ a j d a l aː n i j j
حافلة	ħ aː f i l a
زؤام	z u ʔ aː m
لفافة	l i f aː f a
قرميدة	q i r m iː d a
ترمس	t i r m i s
بليز	b a l iː z
سدل	s a d a l a
كمام	k i m aː m
ملاقاة	m u l aː q aː h
موز	m a w z
محراث	m i ħ r aː θ
طاعم	tˤ aː ʕ a m a
مكياج	m a k i j aː d͡ʒ
سباك	s a b b aː k
بقرة	b a q a r a
صدر	sˤ a d a r a
مملوك	m a m l uː k
موحد	m u w a ħ ħ a d
حسناء	ħ a s n aː ʔ
تحرير	t a ħ r iː r
اضطهاد	i dˤ tˤ i h aː d
معتزلة	m u ʕ t a z i l a
شماتة	ʃ a m aː t a
تكدس	t a k a d d a s a
سيبويه	s iː b a w a j h
بلور	b i l l a w r
عري	ʕ a r i j a
مخلة	m i x l a
كابل	k aː b u l
مشاعر	m a ʃ aː ʕ i r
إزاء	ʔ i z aː ʔ a
فراء	f a r aː ʔ
بيروقراطي	b iː r uː q r aː tˤ i j j
كستبان	k u s t u b aː n
أجرب	ʔ a d͡ʒ r a b
شوكران	ʃ a w k a r aː n
استعصم	i s t a ʕ sˤ a m a
استحم	i s t a ħ a m m a
طرشي	tˤ u r ʃ i j j
ترك	t a r a k a
غفلة	ɣ a f l a
شعير	ʃ a ʕ iː r
إكليل	ʔ i k l iː l
جوزل	d͡ʒ a w z a l
اعتدى	i ʕ t a d aː
محمر	m u ħ a m m a r
غرامة	ɣ a r aː m a
توازى	t a w aː z aː
فأر	f a ʔ r
إيدز	ʔ iː d z
كورة	k uː r a
همس	h a m a s a
صواع	sˤ i w aː ʕ
بورتسودان	b uː r t s uː d aː n
غاسول	ɣ aː s uː l
قرر	q a r r a r
شمس	ʃ a m a s
زوان	z a w aː n
نمط	n a m a tˤ
داذي	d aː ð i j j
كلبة	k a l b a
خبيئة	x a b iː ʔ a
تسكع	t a s a k k a ʕ a
طهران	tˤ a h r aː n
شمندورة	ʃ a m a n d uː r a
صراخة	sˤ a r r aː x a
ناسفة	n aː s i f a
انصرف	i n sˤ a r a f a
رئاسة	r i ʔ aː s a
قريدسة	q u r a j d i s a
صرج	sˤ a r r a d͡ʒ a
تنور	t a n a w w a r a
مسن	m i s a n n
تذكر	t a ð a k k a r a
فانوس	f aː n uː s
بطريركية	b a tˤ r i j a r k i j j a
طابور	tˤ aː b uː r
نادى	n aː d aː
خولنجان	x a w l a n d͡ʒ aː n
ظهر	ðˤ a h a r a
مكسرات	m u k a s s a r aː t
بوذية	b uː ð i j j a
لوط	l uː tˤ
خبا	x a b aː
فنار	f a n aː r
عندما	ʕ i n d a m aː
طير	tˤ a j j a r a
عزيز	ʕ a z iː z
قرص	q a r a sˤ a
اجتاز	i d͡ʒ t aː z a
طرز	tˤ a r r a z a
ألية	ʔ a l j a
غباوة	ɣ a b aː w a
لحق	l a ħ i q a
وقار	w a q aː r
أركن	ʔ a r k u n
خارج	x aː r i d͡ʒ
تنقض	t a n a q q a dˤ a
تناسى	t a n aː s aː
بلاغة	b a l aː ɣ a
رحيق	r a ħ iː q
رغف	r u ɣ u f
اكتتب	i k t a t a b a
تلك	t i l k a
ملبس	m a l b a s
استشرق	i s t a ʃ r a q a
اشتباك	i ʃ t i b aː k
ألم	ʔ a l a m
هتف	h a t a f a
استأنف	i s t a ʔ n a f a
تماسك	t a m aː s a k a
كاتدرائية	k aː t i d r aː ʔ i j j a
واشنطن	w aː ʃ i n tˤ u n
مقبرة	m a q b a r a
مالقة	m aː l a q a
عمامة	ʕ i m aː m a
شحرور	ʃ u ħ r uː r
داعش	d aː ʕ i ʃ
عيان	ʕ a j j aː n
مهنة	m i h n a
إربيان	ʔ i r b i j aː n
تمركز	t a m a r k a z a
صابح	sˤ aː b a ħ a
مفتاح	m i f t aː ħ
مذكرة	m u ð a k k a r a
حلقة	ħ a l a q a
خطمي	x a tˤ m i j j
هلاك	h a l aː k
أجار	ʔ a d͡ʒ aː r a
مرصد	m a r sˤ a d
نملة	n a m l a
متانة	m a t aː n a
شموئيل	ʃ a m a w ʔ iː l
صوم	sˤ a w m
سيء	s iː ʔ a
نوه	n a w w a h a
تأخير	t a ʔ x iː r
ققنس	q u q n u s
فالوذق	f aː l uː ð a q
جبان	d͡ʒ a b aː n
جوهر	d͡ʒ a w h a r
تغذية	t a ɣ ð i j a
دبقي	d i b q i j j
طقم	tˤ a q m
لاسلطوي	l aː s u l tˤ a w i j j
انتشار	i n t i ʃ aː r
هلسنكي	h i l s i n k iː
صلابة	sˤ a l aː b a
أشعل	ʔ a ʃ ʕ a l
أفسنتين	ʔ a f s i n t iː n
حافة	ħ aː f a
رساطون	r a s aː tˤ uː n
جبناء	d͡ʒ u b a n aː ʔ
زيتي	z a j t i j j
سربام	s a r a b aː m
ماهاراجا	m aː h aː r aː d͡ʒ aː
ملوخيا	m u l uː x i j j aː
قربان	q i r b aː n
قلما	q a l l a m aː
ماسح	m aː s i ħ
فيروس	f a j r uː s
قرمزي	q i r m i z i j j
مقشدة	m i q ʃ a d a
ماذا	m aː ð aː
هزيمة	h a z iː m a
أحد	ʔ a ħ a d
فلز	f i l a z z
غرفة	ɣ u r f a
مرة	m a r r a
قفص	q a f a sˤ
صنع	sˤ a n a ʕ a
قلقاسة	q u l q aː s a
رصاصة	r a sˤ aː sˤ a
عناية	ʕ a n aː j a
خرقة	x i r q a
جمهور	d͡ʒ u m h uː r
ربت	r a b b a t a
طيلسان	tˤ a j l a s aː n
أقحوان	ʔ u q ħ u w aː n
يعضيض	j a ʕ dˤ iː dˤ
الأشهل	a l ʔ a ʃ h a l
فجور	f u d͡ʒ uː r
تشالة	t a ʃ ʃ aː l a
برق	b a r a q a
تتلى	t u t l aː
ثاء	θ aː ʔ
زأر	z a ʔ a r a
راسخت	r aː s u x t
مهماز	m i h m aː z
مخرج	m a x r a d͡ʒ
فوز	f a w z
ذروة	ð u r w a
موت	m a w t
يأجوج	j a ʔ d͡ʒ uː d͡ʒ
قريب	q a r iː b
أربعون	ʔ a r b a ʕ uː n a
استخبار	i s t i x b aː r
تقيأ	t a q a j j a ʔ a
توكيد	t a w k iː d
أفاد	ʔ a f aː d a
ضبط	dˤ a b a tˤ a
كثيراء	k a θ iː r aː ʔ
شيطان	ʃ a j tˤ aː n
صأكة	sˤ a ʔ k a
استشراق	i s t i ʃ r aː q
قلقاس	q u l q aː s
فراشة	f a r aː ʃ a
قوقعة	q a w q a ʕ a
تذكار	t a ð k aː r
خزامى	x u z aː m aː
سيخي	s iː x i j j
ولاية	w a l aː j a
طاجيكستان	tˤ aː d͡ʒ iː k i s t aː n
مرشد	m u r ʃ i d
لاذن	l aː ð a n
شخص	ʃ a x a sˤ a
تخدير	t a x d iː r
آسفي	ʔ aː s a f iː
التحق	i l t a ħ a q a
إبليس	ʔ i b l iː s
مجسم	m u d͡ʒ a s s a m
سجين	s a d͡ʒ iː n
منية	m a n i j j a
حاك	ħ aː k a
برنامج	b a r n aː m a d͡ʒ
طيهوج	tˤ a j h uː d͡ʒ
إذخر	ʔ i ð x i r
منافاة	m u n aː f aː h
أبتر	ʔ a b t a r
إسفيدباج	ʔ i s f iː d a b aː d͡ʒ
غناء	ɣ i n aː ʔ
غرر	ɣ a r a r
استمرار	i s t i m r aː r
عامل	ʕ aː m a l a
لجين	l u d͡ʒ a j n
سقرلاط	s i q i r l aː tˤ
منشأة	m u n ʃ a ʔ a
بلطي	b u l tˤ i j j
قيثارة	q iː θ aː r a
رقصة	r a q sˤ a
ندوة	n a d w a
سرو	s a r w
خرمال	x u r m aː l
عسبق	ʕ a s b a q
إزار	ʔ i z aː r
محيل	m u ħ iː l
أغرم	ʔ a ɣ r a m a
سعى	s a ʕ aː
أغسطس	ʔ a ɣ u s tˤ u s
الآخرة	a l ʔ aː x i r a
زغاية	z a ɣ aː j a
نيكاراغوا	n iː k aː r aː ɣ u w aː
مستنقع	m u s t a n q a ʕ
دوخة	d a w x a
مخطوب	m a x tˤ uː b
تهدد	t a h a d d a d a
دلل	d a l l a l a
استرخاء	i s t i r x aː ʔ
خسارة	x a s aː r a
كحلاء	k a ħ l aː ʔ
كاغد	k aː ɣ a d
منظمة	m u n a ðˤ ðˤ a m a
ألوهية	ʔ u l uː h i j j a
أبكم	ʔ a b k a m
عرقوب	ʕ u r q uː b
لادن	l aː d a n
سخاء	s a x aː ʔ
أبطل	ʔ a b tˤ a l a
فرغة	f a r i ɣ a
عانس	ʕ aː n i s
استصبر	i s t a sˤ b a r a
أفرع	ʔ a f r a ʕ
صراع	sˤ i r aː ʕ
حجم	ħ a d͡ʒ a m a
فوفل	f a w f a l
بنت	b a n a t
ترفع	t a r a f f a ʕ a
تقديم	t a q d iː m
المحمدية	a l m u ħ a m m a d i j j a
بستان	b u s t aː n
ملوكية	m u l uː k i j j a
زرشك	z a r r a ʃ k
الآن	a l ʔ aː n a
زبيل	z a b b iː l
وغد	w a ɣ d
هيف	h a j f
حبارى	ħ u b aː r aː
منسأة	m a n s a ʔ a
اجتلى	i d͡ʒ t a l aː
شام	ʃ aː m a
ثلة	θ u l l a
أخدر	ʔ a x d a r
جارية	d͡ʒ aː r i j a
تضامني	t a dˤ aː m u n i j j
بطاطس	b a tˤ aː tˤ i s
شلنبر	ʃ u l u n b a r
اقتصد	i q t a sˤ a d a
وريد	w a r iː d
وضع	w a dˤ a ʕ a
غردق	ɣ a r d a q
بأس	b a ʔ s
غرة	ɣ u r r a
ثلج	θ a l d͡ʒ
بارزذ	b aː r z a ð
تتويج	t a t w iː d͡ʒ
زعط	z a ʕ a tˤ a
عضوية	ʕ u dˤ w i j j a
مكتب	m a k t a b
سرادق	s u r aː d i q
باكستان	b aː k i s t aː n
سيكولوجي	s a j k uː l uː d͡ʒ i j j
النمسا	a n n a m s aː
محاصرة	m u ħ aː sˤ a r a
ضرب	dˤ a r a b
ضيون	dˤ a j w a n
ثنوية	θ a n a w i j j a
ذلك	ð aː l i k a
أين	ʔ a j j a n a
تحت	t a ħ t a
ارتاح	i r t aː ħ a
إذا	ʔ i ð aː
نضار	n u dˤ aː r
مريض	m a r iː dˤ
صوت	sˤ a w t
سابق	s aː b i q
خرافي	x u r aː f i j j
أحمق	ʔ a ħ m a q
إشهار	ʔ i ʃ h aː r
قدم	q a d a m
تحمس	t a ħ a m m a s a
جهة	d͡ʒ i h a
ليلك	l a j l a k
قهقه	q a h q a h a
حضرمي	ħ a dˤ r a m i j j
أنا	ʔ a n aː
فضة	f i dˤ dˤ a
مسى	m a s aː
طريخ	tˤ a r r iː x
ريش	r iː ʃ
أفيون	ʔ a f j uː n
دونم	d uː n u m
المشتري	a l m u ʃ t a r iː
شونيز	ʃ uː n iː z
باصور	b aː sˤ uː r
مرو	m a r w
نظام	n i ðˤ aː m
تمهيد	t a m h iː d
امتعض	i m t a ʕ a dˤ a
الحبشة	a l ħ a b a ʃ a
عيني	ʕ a j n i j j
أثينا	ʔ a θ iː n aː
ديسمبر	d iː s a m b a r
تعزب	t a ʕ a z z a b a
عقدة	ʕ u q d a
كهروتقني	k a h r uː t i q n i j j
أنما	ʔ a n n a m aː
سنجاب	s i n d͡ʒ aː b
شوب	ʃ a w b
صرق	sˤ a r a q
بركار	b i r k aː r
سيف	s a j f
أعيان	ʔ a ʕ j aː n
دمدم	d a m d a m a
جفنة	d͡ʒ a f n a
حنظل	ħ a n ðˤ a l
قبج	q a b a d͡ʒ
نانخاة	n aː n a x aː h
توظيف	t a w ðˤ iː f
ممثل	m u m a θ θ i l
معطف	m i ʕ tˤ a f
جهادي	d͡ʒ i h aː d i j j
انتقل	i n t a q a l a
معجون	m a ʕ d͡ʒ uː n
مراسل	m u r aː s i l
ادعى	i d d a ʕ aː
زميلة	z a m iː l a
اتصال	i t t i sˤ aː l
عجور	ʕ a d͡ʒ d͡ʒ uː r
كنز	k a n a z a
مناظرة	m u n aː ðˤ a r a
استحوذ	i s t a ħ w a ð a
ركنية	r u k n i j j a
كراميل	k a r aː m iː l
حجامة	ħ a d͡ʒ aː m a
أترج	ʔ u t r u d͡ʒ d͡ʒ
ضال	dˤ aː l l
كرفس	k a r a f s
دجن	d a d͡ʒ a n a
أكاف	ʔ u k aː f
ناعورة	n aː ʕ uː r a
شقي	ʃ a q i j j
فراغ	f a r aː ɣ
التهاب	i l t i h aː b
خبر	x a b a r
سلم	s u l l a m
زبدة	z a b d a
حليب	ħ a l iː b
ثورة	θ a w r a
جبس	d͡ʒ i b s
زملاء	z u m a l aː ʔ
تطبيق	t a tˤ b iː q
مرفأ	m a r f a ʔ
صيدلة	sˤ a j d a l a
خالد	x aː l i d
بلس	b a l a s
خابور	x aː b uː r
مجاور	m u d͡ʒ aː w i r
ملاتيوس	m i l aː t i j uː s
رفيق	r a f iː q
صاد	sˤ aː d
مثنان	m a θ n aː n
امرأة	i m r a ʔ a
عناب	ʕ u n n aː b
بشملة	b a ʃ m a l a
الإسكندرية	a l ʔ i s k a n d a r i j j a
عتب	ʕ a t a b
هدف	h a d a f
إزالة	ʔ i z aː l a
سعد	s u ʕ d
عروس	ʕ a r uː s
لعل	l a ʕ a l l a
انعدى	i n ʕ a d aː
سرقسطة	s a r a q u s tˤ a
منغوليا	m u n ɣ uː l i j aː
شيرج	ʃ a j r a d͡ʒ
أسرب	ʔ u s r u b
ندد	n a d d a d a
حافلات	ħ aː f i l aː t
ليلة	l a j l a
مجرد	m u d͡ʒ a r r a d
سرخس	s a r x a s
زنوبة	z a n n uː b a
شاهدانج	ʃ aː h d aː n a d͡ʒ
شهدانج	ʃ a h d aː n a d͡ʒ
لجام	l i d͡ʒ aː m
ممكن	m u m k i n
ازدحم	i z d a ħ a m a
متكبر	m u t a k a b b i r
كبد	k a b b a d a
وعاء	w i ʕ aː ʔ
عجاب	ʕ u d͡ʒ aː b
بلجيكي	b i l d͡ʒ iː k i j j
قلب	q a l a b a
كمون	k a m m uː n
سلوى	s a l w aː
خطة	x u tˤ tˤ a
دمقس	d i m a q s
بوط	b uː tˤ
السفن	a s s u f u n
رخخة	r i x a x a
فانيد	f aː n iː d
زأم	z a ʔ a m a
مجلخة	m i d͡ʒ l a x a
يحيى	j a ħ j aː
أخبر	ʔ a x b a r a
جرادة	d͡ʒ a r aː d a
زيار	z i j aː r
قسطران	q a s tˤ a r aː n
أصف	ʔ a sˤ a f
موظف	m u w a ðˤ ðˤ a f
طموح	tˤ u m uː ħ
أفك	ʔ a f a k a
نادلة	n aː d i l a
طليعة	tˤ a l iː ʕ a
أخلاقية	ʔ a x l aː q i j j a
تلا	t a l aː
وسط	w a s a tˤ
لئلا	l i ʔ a l l aː
مرحبا	m a r ħ a b aː
فوج	f a w d͡ʒ
إسبانية	ʔ i s b aː n i j a
وجبة	w a d͡ʒ b a
ديسق	d a j s a q
البحرين	a l b a ħ r a j n
الغابون	a l ɣ aː b uː n
سبأ	s a b a ʔ
مات	m aː t a
رفائيل	r u f aː ʔ iː l
أكسح	ʔ a k s a ħ
ديمومة	d a j m uː m a
مريلة	m i r j a l a
سني	s a n i j j
أزلي	ʔ a z a l i j j
ملجأ	m a l d͡ʒ a ʔ
مرادف	m u r aː d i f
قام	q aː m a
تألق	t a ʔ a l l a q a
استيعاب	i s t iː ʕ aː b
