сексуалан	s ê k s u aː l a n
uspavati	u s p ǎː ʋ a t i
vječan	ʋ j ê t͡ʃ a n
була	b û l a
литоралан	l î t o r aː l a n
silaziti	s ǐ l a z i t i
одмалена	o d m a l ě n a
бугарштица	b u ɡ ǎ r ʃ t i t͡s a
plavičast	p l ǎ ʋ i t͡ʃ a s t
anarhistički	a n a r x ǐ s t i t ʃ k iː
ramazan	r a m ǎ z aː n
karmelićanin	k a r m e l ǐː t͡ɕ a n i n
veroispoved	ʋ e r o ǐ s p o ʋ eː d
премијер	p r e m ǐ j eː r
солидаран	s ô l i d aː r a n
več	ˈʋ ɛ t ʃ
момче	m ǒ m t͡ʃ e
снисходљив	s n i s x ǒ d ʎ i ʋ
neopoziv	n e o p ǒ z i ʋ
osmica	ǒ s m i t͡s a
астматичар	a s t m ǎ t i t͡ʃ aː r
nadimati	n ǎ d i m a t i
скровиште	s k r ô ʋ iː ʃ t e
češati	t͡ʃ ě ʃ a t i
improvizator	i m p r o ʋ ǐ z aː t o r
redovit	r e d ǒ ʋ i t
нисмо	n ǐː s m o
Кошчанин	k ǒ ʃ t͡ʃ a n i n
прерачунавати	p r e r a t͡ʃ u n ǎː ʋ a t i
sitničav	s ǐ t n i t͡ʃ a ʋ
криводолски	k r i ʋ ǒ d o l s k iː
sastaviti	s ǎ s t a ʋ i t i
ловоров	l ô ʋ o r o ʋ
glibovit	ɡ l i b ǒ ʋ i t
тромесечје	t r ǒ m e s eː t͡ʃ j e
привид	p r ǐː ʋ i d
одштета	ô d ʃ t e t a
šmugler	ʃ m û ɡ l e r
smotriti	s m ǒ t r i t i
tabela	t a b ě l a
дознати	d ǒ z n a t i
presvući	p r ě s ʋ uː t͡ɕ i
hram	x r âː m
продаја	p r ô d a j a
garant	ɡ ǎ r a n t
tutorstvo	t ûː t oː r s t ʋ o
богорадити	b o ɡ o r ǎː d i t i
ihtiologija	i x t i o l ǒ ɡ i j a
treba	t r ěː b a
nesit	n ê s i t
bajoneta	b a j o n ěː t a
довести	d ǒ ʋ e s t i
vjeroispovijest	ʋ j e r o ǐ s p o ʋ j eː s t
analfabetizam	a n a l f a b e t ǐ z a m
шлагворт	ʃ l ǎ ɡ ʋ o r t
katoličanstvo	k a t o l i t͡ʃ ǎː n s t ʋ o
č	t͡ʃ
importirati	i m p o r t ǐː r a t i
недра	n ê d r a
финџан	f ǐ n d͡ʒ aː n
bajramovati	b ǎ j r a m o ʋ a t i
smisao	s m îː s a o
čednost	t͡ʃ ê d n oː s t
petao	p ěː t a o
f	f
štrajfati	ʃ t r â j f a t i
повремено	p ǒ ʋ r e m e n o
ćup	t͡ɕ û p
golišavost	ɡ o l ǐ ʃ a ʋ oː s t
здравље	z d r âː ʋ ʎ e
implikacija	i m p l i k ǎː t͡s i j a
истакнути	i s t ǎ k n u t i
paša	p â ʃ a
поставити	p ǒ s t a ʋ i t i
tehničar	t ě x n i t͡ʃ aː r
plitko	p l îː t k o
knjižnica	k ɲ ǐː ʒ n i t͡s a
хигијеничарка	x i ɡ i j ě n i t͡ʃ aː r k a
оживјети	o ʒ ǐː ʋ j e t i
интуиција	i n t u ǐː t͡s i j a
sažeti	s ǎ ʒ eː t i
metafora	m e t ǎ f o r a
začetak	z a t͡ʃ ěː t a k
ludača	l ǔ d a t͡ʃ a
кратковидност	k r a t k o ʋ ǐː d n oː s t
агресорски	ǎ ɡ r e s o r s k iː
naići	n ǎ iː t͡ɕ i
sujeveran	s û j e ʋ eː r a n
kriška	k r î ʃ k a
средњи	s r ê d ɲ iː
десетогодишњак	d e s e t o ɡ ǒ d i ʃ ɲ aː k
малочас	m â l o t͡ʃ a s
дуњалук	d u ɲ ǎː l u k
инвалидски	i n ʋ ǎ l iː d s k iː
važan	ʋ ǎː ʒ a n
дажбина	d â ʒ b i n a
nadopunjavati	n a d o p u ɲ ǎː ʋ a t i
čitljiv	t͡ʃ ǐ t ʎ i ʋ
pretraživati	p r e t r a ʒ ǐː ʋ a t i
šeflja	ʃ ê f ʎ a
пачавра	p ǎ t͡ʃ aː ʋ r a
шлафцимер	ʃ l âː f t͡s i m e r
semantički	s e m ǎ n t i t ʃ k iː
намакнути	n a m ǎ k n u t i
лоптаст	l ô p t a s t
увидјети	ǔ ʋ i d j e t i
slučajno	s l û t͡ʃ aː j n o
шпера	ʃ p ěː r a
neveran	n ê ʋ e r a n
nadzemaljski	n a d z e m ǎ ʎ s k iː
љубавница	ʎ ǔː b aː ʋ n i t͡s a
potegnuti	p o t ěː ɡ n u t i
zavodljiv	z a ʋ ǒ d ʎ i ʋ
забрујати	z a b r ǔː j a t i
отимати	ǒ t i m a t i
семиотика	s e m i ǒ t i k a
mlezivo	m l ê z iː ʋ o
кобасица	k o b ǎ s i t͡s a
безумност	b ě z uː m n oː s t
Balkanac	b a l k ǎː n a t͡s
šaptati	ʃ ǎ p t a t i
drzak	d r̂ z a k
zerzevat	z e r z ě ʋ aː t
jezgrovit	j e z ɡ r ǒ ʋ i t
srpskohrvatski	s r̩ p s k o x ř̩ ʋ aː t s k iː
Србин	s r̂ b i n
latinizacija	l a t i n i z ǎː t͡s i j a
ментални	m ě n t aː l n iː
zablješćivati	z a b ʎ e ʃ t͡ɕ ǐː ʋ a t i
сенка	s êː n k a
прорадити	p r o r ǎː d i t i
tragati	t r ǎ ɡ a t i
poći	p ôː t͡ɕ i
temperamentnost	t e m p e r ǎ m e n t n oː s t
курцшлус	k û r t͡s ʃ l u s
расправити	r ǎ s p r a ʋ i t i
веселост	ʋ ê s e l oː s t
заслужено	z ǎ s l uː ʒ e n o
štampati	ʃ t âː m p a t i
biskupija	b i s k ǔ p i j a
кружок	k r ǔ ʒ o k
луталица	l ǔː t a l i t͡s a
авионски	a ʋ ǐ o n s k iː
vera	ʋ ê r a
inteligencija	i n t e l i ɡ ě n t͡s i j a
енергичан	e n ě r ɡ i t͡ʃ a n
bojevati	b o j ě ʋ a t i
глицерин	ɡ l i t͡s ě r iː n
геј	ɡ êː j
рационалисткиња	r a t͡s i o n ǎ l i s t k i ɲ a
voćnjak	ʋ ô t͡ɕ ɲ aː k
Palestina	p a l e s t ǐː n a
Olib	ǒ l i b
козметички	k o z m ě t i t ʃ k iː
пека	p ê k a
летак	l ê t a k
licemjerka	l î t͡s e m j eː r k a
ošamariti	o ʃ ǎ m a r i t i
подмитљивост	p o d m ǐ t ʎ i ʋ oː s t
razmicati	r ǎ z m i t͡s a t i
сажаљевати	s a ʒ a ʎ ěː ʋ a t i
ауторски	ǎ u t o r s k iː
potpredsjednik	p o t p r ěː d s j e d n iː k
пргав	p r̂ ɡ a ʋ
разбијач	r a z b ǐ j aː t͡ʃ
jezer	j ê z eː r
brčkati	b r̂ t͡ʃ k a t i
девет	d ê ʋ e t
neobranjivo	n e o b r ǎ ɲ i ʋ o
пехливан	p e x l ǐ ʋ aː n
буба	b û b a
сталешки	s t ǎː l e ʃ k iː
жељети	ʒ ě ʎ e t i
изгред	î z ɡ r eː d
трпеза	t ř p e z a
фркати	f řː k a t i
шраф	ʃ r â f
vid	ʋ îː d
верс	ʋ ê r s
разлаз	r ǎː z l a z
аденски	ǎː d e n s k iː
родбински	r ô d b iː n s k iː
плућни	p l ûː t͡ɕ n iː
арбитар	ǎ r b i t a r
поносити	p o n ǒ s i t i
хорна	x ôː r̩ n a
прилазак	p r ǐ l a z a k
саоне	s â o n e
seliti	s ě l i t i
gospođica	ɡ ô s p o d͡ʑ i t͡s a
jedro	j ê d r o
умакнути	u m ǎ k n u t i
basnoslovan	b â s n o s l oː ʋ a n
Олибљанин	ǒ l i b ʎ a n i n
furundžija	f u r ǔ n d͡ʒ i j a
слово	s l ô ʋ o
просвјед	p r ǒ s ʋ j e d
šupljikav	ʃ u p ʎ ǐ k a ʋ
sjemenka	s j ě m eː n k a
виспрен	ʋ î s p r e n
антик	ǎ n t i k
zloradost	z l ǒ r a d oː s t
terminološki	t e r m i n ǒ l o ʃ k iː
gol	ɡ ôː l
vidljiv	ʋ ǐ d ʎ i ʋ
barbadoski	b a r b ǎː d o s k iː
tane	t â n e
izreći	ǐ z r e t͡ɕ i
замамити	z a m ǎː m i t i
kana	k â n a
ispitni	ǐ s p i t n iː
свагдањи	s ʋ ǎ ɡ d a ɲ iː
Африканка	a f r ǐ k aː n k a
разоружати	r a z o r ǔ ʒ a t i
uputstvo	u p ǔ t s t ʋ o
светски	s ʋ ě t s k iː
tvrdokoran	t ʋ r̂ d o k oː r a n
накалемити	n a k ǎ l e m i t i
омот	ǒ m o t
опорављати	o p ǒ r a ʋ ʎ a t i
skaut	s k ǎ u t
изум	ǐ z u m
олуја	o l ǔː j a
носталгичар	n o s t ǎ l ɡ i t͡ʃ aː r
agogičan	a ɡ ǒ ɡ i t͡ʃ a n
štaubzauger	ʃ t ǎ u b z a u ɡ e r
prevashodan	p r e v ǎ s x o d a n
bizon	b ǐ z oː n
skučiti	s k ǔː t͡ʃ i t i
Etiopija	e t i ǒ p i j a
monah	m ǒ n a x
pregalac	p r ě ɡ a l a t͡s
razilazak	r a z ǐ l a z a k
visiti	ʋ î s i t i
osećajno	ô s e t͡ɕ aː j n o
голишавост	ɡ o l ǐ ʃ a ʋ oː s t
папирничар	p a p ǐː r n i t͡ʃ aː r
superioran	s û p e r i oː r a n
Мезопотамија	m e z o p o t âː m i j a
stečaj	s t ê t͡ʃ aː j
спона	s p ô n a
проучити	p r o ǔ t͡ʃ i t i
snabdeti	s n ǎ b d e t i
штрајк	ʃ t r â j k
пробирати	p r o b ǐː r a t i
судбоносно	s u d b ǒ n o s n o
беланчевина	b e l ǎː n t͡ʃ e ʋ i n a
kaiš	k ǎ i ʃ
потом	p ǒ t oː m
коначно	k ǒ n a t͡ʃ n o
пакосник	p â k o s n iː k
недељни	n ě d eː ʎ n iː
неразговијетан	n ê r a z ɡ o ʋ i j eː t a n
телеграфски	t e l ě ɡ r a f s k iː
бјекство	b j ě k s t ʋ o
zastajati	z ǎ s t a j a t i
узалудно	û z a l uː d n o
достава	d ô s t a ʋ a
звиждачица	z ʋ i ʒ d ǎ t͡ʃ i t͡s a
шелман	ʃ ê l m a n
smenjivati	s m e ɲ ǐː ʋ a t i
protivno	p r ô t iː ʋ n o
Titograd	t î t o ɡ r aː d
дисјункција	d i s j ǔ n k t͡s i j a
nepristojan	n ê p r i s t oː j a n
paranoik	p a r a n ǒ i k
гостољубив	ɡ o s t o ʎ ǔ b i ʋ
пролом	p r ǒ l o m
психолошки	p s i x ǒ l o ʃ k iː
odmeriti	ǒ d m e r i t i
приљубљивати	p r i ʎ u b ʎ ǐː ʋ a t i
konferencija	k o n f e r ě n t͡s i j a
rusofil	r u s ǒ f iː l
затишје	z ǎː t iː ʃ j e
materijalistički	m a t e r i j a l ǐ s t i t ʃ k iː
založiti	z a l ǒ ʒ i t i
импутирати	i m p u t ǐː r a t i
крепко	k r ê p k o
ткати	t k â t i
Пристег	p r ǐ s t e ɡ
kozar	k ǒ z aː r
профитер	p r o f ǐ t eː r
omesti	ǒ m eː s t i
ljuvezan	ʎ u v e z a n
несаломљив	n e s a l ǒ m ʎ i ʋ
agnostičarka	a ɡ n ǒ s t i t͡ʃ aː r k a
издисати	ǐ z d i s a t i
skloniti	s k l ǒ n i t i
клише	k l ǐ ʃ eː
оџачки	ǒ d͡ʒ a t͡ʃ k iː
nevjesta	n ě ʋ j e s t a
безбојан	b ê z b oː j a n
атом	ǎ t oː m
kanap	k ǎ n aː p
sinteriranje	s i n t e r ǐː r aː ɲ e
коментирати	k o m e n t ǐː r a t i
звездица	z ʋ ě z d i t͡s a
бајка	b âː j k a
прихватити	p r ǐ x ʋ a t i t i
bezvremenost	b ě z ʋ r e m e n oː s t
Арменац	a r m ěː n a t͡s
gladijator	ɡ l a d ǐ j aː t o r
висак	ʋ ǐː s a k
обијест	ô b i j eː s t
zastor	z ǎː s t o r
капица	k â p i t͡s a
uredan	û r e d a n
кретенски	k r ě t eː n s k iː
stradalac	s t r ǎː d a l a t͡s
мужеван	m û ʒ eː ʋ a n
дијаметрално	d î j a m e t r aː l n o
izazivati	i z a z ǐː ʋ a t i
jeziv	j ě z i ʋ
štampa	ʃ t âː m p a
превоз	p r ěː ʋ o z
pripovijetka	p r î p o ʋ i j eː t k a
четворица	t͡ʃ e t ʋ ǒ r i t͡s a
podmornički	p ǒ d m oː r n i t͡ʃ k iː
становати	s t a n ǒ ʋ a t i
врачати	ʋ r ǎː t͡ʃ a t i
комбајн	k ǒ m b a j n
изгнаница	ǐ z ɡ n a n i t͡s a
рукометаш	r u k o m ě t aː ʃ
demagogija	d e m a ɡ ǒ ɡ i j a
примирје	p r ǐː m iː r j e
сардела	s ǎ r d e l a
poliandrija	p o l i ǎ n d r i j a
њок	ɲ ô k
mučitelj	m ǔ t͡ʃ i t e ʎ
љубљени	ʎ ûː b ʎ e n iː
истраживач	i s t r a ʒ ǐ ʋ aː t͡ʃ
pobornik	p ǒ b oː r n iː k
zavladavati	z a ʋ l a d ǎː ʋ a t i
консекутивно	k ô n s e k u t iː ʋ n o
picajzla	p i t͡s ǎ j z l a
компарација	k o m p a r ǎː t͡s i j a
криминолог	k r i m i n ǒ l o ɡ
до	d ô
блокирати	b l o k ǐː r a t i
Dalibor	d ǎ l i b o r
неријетко	n ê r i j eː t k o
блатњав	b l â t ɲ a ʋ
kroatizam	k r o a t ǐ z a m
гласити	ɡ l ǎː s i t i
prikladan	p r ǐ k l a d a n
ludeti	l ǔː d e t i
antikomunistički	a n t i k o m u n ǐ s t i t͡ʃ k iː
двица	d ʋ î t͡s a
флуктуирати	f l u k t u ǐː r a t i
predstavljati	p r ě d s t a ʋ ʎ a t i
lijeha	l i j ě x a
срамити	s r ǎː m i t i
štitast	ʃ t î t a s t
vodeći	ʋ ǒ d eː t͡ɕ iː
фењер	f ě ɲ e r
iznad	î z n a d
kaftan	k ǎ f t a n
истребљивати	i s t r e b ʎ ǐː ʋ a t i
radovati	r â d o ʋ a t i
vukojebina	ʋ u k o j ě b i n a
џепар	d͡ʒ ê p aː r
трнина	t ř̩ n i n a
izdah	î z d aː x
naučan	n ǎː u t͡ʃ a n
pomicati	p ǒ m i t͡s a t i
таутологија	t a u t o l ǒ ɡ i j a
avanzirati	a ʋ a n z ǐː r a t i
шестосједалница	ʃ e s t o s j ě d aː l n i t͡s a
блебетати	b l e b ě t a t i
soliti	s ǒ l i t i
proteravati	p r o t e r ǎː ʋ a t i
magnetski	m ǎ ɡ n eː t s k i
izliječiti	i z l i j ěː t͡ʃ i t i
snalaziti	s n ǎ l a z i t i
preletjeti	p r e l ě t j e t i
vani	ʋ ǎ n i
сумпор	s ûː m p o r
izdahnuti	i z d ǎ x n u t i
žerav	ʒ ě r aː ʋ
шопати	ʃ ô p a t i
каолин	k a ǒ l iː n
pomagač	p o m ǎ ɡ aː t͡ʃ
zakonit	z ǎː k o n i t
rukovoditi	r u k o ʋ ǒ d i t i
fanatičan	f a n ǎ t i t͡ʃ a n
објесити	ǒ b j e s i t i
матријархални	m â t r i j a r x aː l n iː
aktualizirati	a k t u a l i z ǐː r a t i
баршунаст	b ǎ r ʃ u n a s t
заклонити	z a k l ǒ n i t i
oksid	ǒ k s iː d
lakovjerno	l â k o ʋ j eː r n o
tijekom	t i j e k o m
промишљати	p r o m ǐː ʃ ʎ a t i
подржати	p o d ř ʒ a t i
филогенија	f i l o ɡ ěː n i j a
punktualan	p û n k t u aː l a n
исправан	î s p r aː ʋ a n
шумно	ʃ ûː m n o
верити	ʋ ê r i t i
мултипликатор	m u l t i p l ǐ k aː t o r
загосподарити	z a ɡ o s p o d ǎː r i t i
ugasiti	u ɡ ǎː s i t i
ustrajati	ǔ s t r a j a t i
dijabetičar	d i j a b ě t i t͡ʃ aː r
отпочивати	o t p o t͡ʃ ǐː ʋ a t i
бацач	b ǎ t͡s aː t͡ʃ
панамски	p ǎ n a m s k iː
хазардни	x ǎ z a r d n iː
nezaboravljiv	n e z a b o r ǎ ʋ ʎ i ʋ
вјеверица	ʋ j ê ʋ e r i t͡s a
lateralno	l â t e r aː l n o
oduprijeti	o d ǔ p r j eː t i
trgovati	t r ɡ ǒ ʋ a t i
zablistati	z a b l ǐ s t a t i
хвалиша	x ʋ ǎ l i ʃ a
композитор	k o m p ǒ z iː t o r
veslački	ʋ ě s l aː t ʃ k iː
канаринац	k a n a r ǐː n a t͡s
хотелски	x ǒ t e l s k iː
весело	ʋ ê s e l o
uočljiv	u ǒ t͡ʃ ʎ i ʋ
državnički	d ř ʒ aː ʋ n i t ʃ k iː
želudac	ʒ ě l u d a t͡s
гас	ɡ âː s
опасач	o p ǎ s aː t͡ʃ
špur	ʃ p ûː r
sažeto	s â ʒ eː t o
извршни	ǐ z ʋ r ʃ n iː
prelazan	p r ěː l a z a n
стидјети	s t ǐː d j e t i
чагаљ	t͡ʃ ǎ ɡ a ʎ
кролавати	k r o l ǎː ʋ a t i
гмизати	ɡ m î z a t i
сјетва	s j ê t ʋ a
штамлокал	ʃ t â m l o k aː l
kišovit	k i ʃ ǒ ʋ i t
амфибија	ǎ m f iː b i j a
sabljica	s â b ʎ i t͡s a
vrtoglavo	ʋ r t ǒ ɡ l a ʋ o
новчаница	n o ʋ t͡ʃ ǎ n i t͡s a
истраживати	i s t r a ʒ ǐː ʋ a t i
либерализам	l i b e r a l ǐ z a m
rosa	r ǒ s a
ауторитет	a u t o r ǐ t eː t
prevremen	p r e ʋ r e m e n
vjetrobran	ʋ j ê t r o b r aː n
цокл	t͡s ǒ k l
intelektualan	î n t e l e k t u aː l a n
veterinarski	ʋ e t e r ǐ n aː r s k iː
pauk	p â uː k
џигерица	d͡ʒ ǐ ɡ e r i t͡s a
самаритански	s a m a r ǐ t aː n s k i
pomilovati	p ǒ m i l o ʋ a t i
mrva	m r̂ ʋ a
primjećivati	p r i m j e t͡ɕ ǐː ʋ a t i
dohvatiti	d ǒ x ʋ a t i t i
nem	n êː m
posvemašnji	p ǒ s ʋ e m a ʃ ɲ iː
doktorirati	d o k t o r ǐː r a t i
aperitiv	a p e r ǐ t iː ʋ
двориште	d ʋ ǒ r iː ʃ t e
кркан	k ř k a n
насљедница	n ǎː s ʎ e d n i t͡s a
нежност	n ê ʒ n oː s t
kič	k î t͡ʃ
podbosti	p ǒ d b o s t i
stočarski	s t ô t͡ʃ a r s k iː
rugoba	r u ɡ ǒ b a
прибости	p r ǐ b o s t i
краљевски	k r ǎː ʎ e ʋ s k iː
naroditi	n a r ǒ d i t i
премијера	p r e m i j ěː r a
прамен	p r â m eː n
агресија	a ɡ r ě s i j a
Paragvaj	p â r a ɡ ʋ aː j
škrgutati	ʃ k r ɡ ǔ t a t i
јудејски	j ǔ d eː j s k iː
исцурити	i s t͡s ǔː r i t i
лук	l û k
непотпун	n ê p o t p u n
упасти	ǔ p a s t i
anomalija	a n o m ǎ l i j a
спрдати	s p řː d a t i
побољшати	p o b ǒ ʎ ʃ a t i
svjetlo	s ʋ j ê t l o
колосалан	k ô l o s aː l a n
pobuna	p ô b u n a
bojazan	b ô j aː z a n
povraćati	p ǒ ʋ r a t͡ɕ a t i
кратковрат	k r a t k ǒ ʋ r a t
наилазити	n a ǐ l a z i t i
симпатично	s i m p ǎ t i t͡ʃ n o
ручни	r û t͡ʃ n iː
крпа	k r̂ p a
australijski	a ǔ s t r aː l iː j s k iː
krepao	k r ê p a o
nalik	n ǎː l i k
koaksijalan	k ô a k s i j aː l a n
обрнути	o b řː n u t i
шетач	ʃ ě t aː t͡ʃ
kroničar	k r ǒ n i t͡ʃ aː r
смрзавати	s m r z ǎː ʋ a t i
buhica	b ǔ x i t͡s a
Берн	b êː r n
подучити	p o d ǔ t͡ʃ i t i
доктрина	d o k t r ǐː n a
зачудо	z ǎ t͡ʃ u d o
жиголо	ʒ î ɡ o l o
tržnica	t ř̩ ʒ n i t͡s a
јењати	j ě ɲ a t i
inače	î n aː t͡ʃ e
žedno	ʒ êː d n o
jutarnji	j û t aː r ɲ iː
сентименталност	s e n t i m e n t ǎː l n oː s t
часно	t͡ʃ â s n o
наглашавати	n a ɡ l a ʃ ǎː ʋ a t i
nihče	ˈn i x t ʃ ɛ
njim	ɲ îː m
šina	ʃ î n a
главоломка	ɡ l a ʋ ǒ l o m k a
preda	p r ê d a
primjesa	p r îː m j e s a
придјевски	p r ǐː d j e ʋ s k iː
стаклар	s t ǎ k l aː r
galski	ɡ âː l s k iː
фриволно	f r î ʋ oː l n o
џевајир	d͡ʒ e ʋ ǎː j i r
rodni	r ô d n iː
aktivan	â k t iː ʋ a n
budala	b u d ǎ l a
jugo	j û ɡ o
двојбен	d ʋ ǒ j b e n
podnevnik	p ǒː d n eː ʋ n iː k
vinograd	ʋ ǐ n o ɡ r aː d
онтолошки	o n t ǒ l o ʃ k iː
триангулирати	t r i a n ɡ u l ǐː r a t i
aktuelan	â k t u eː l a n
успевати	u s p ěː ʋ a t i
postidjeti	p o s t ǐː d j e t i
odazvati	o d ǎ z ʋ a t i
снежан	s n ê ʒ a n
нејасно	n ě j a s n o
Sumatra	s ǔ m a t r a
секира	s ě k i r a
trebiti	t r ěː b i t i
podgristi	p ǒ d ɡ r i s t i
nerazuman	n ê r a z uː m a n
отклањати	ǒ t k l a ɲ a t i
ткање	t k ǎː ɲ e
јединцат	j e d ǐ n t͡s a t
пажљив	p ǎ ʒ ʎ i ʋ
prekretnica	p r ě k r e t n i t͡s a
надлактица	n ǎ d l a k t i t͡s a
англицизам	a n ɡ l i t͡s ǐ z a m
љестве	ʎ ê s t ʋ e
који	k ǒ j iː
veseo	ʋ ê s e o
uporaba	û p o r a b a
Buzet	b ǔ z e t
smotak	s m ô t a k
sakrament	s a k r ǎ m e n t
kvota	k ʋ ǒː t a
мјешовит	m j e ʃ ǒ ʋ i t
promišljeno	p r ǒ m i ʃ ʎ e n o
индискреција	i n d i s k r ěː t͡s i j a
đerdek	d͡ʑ ě r d e k
nešto	n ê ʃ t o
учесник	ǔ t͡ʃ e s n iː k
казаљка	k ǎ z aː ʎ k a
зачаривати	z a t͡ʃ a r ǐː ʋ a t i
stvor	s t ʋ ô r
radio	r âː d i o
лепеза	l e p ěː z a
робиња	r ǒ b i ɲ a
mješovit	m j e ʃ ǒ ʋ i t
mletački	m l ê t a t͡ʃ k iː
sveznajuć	s ʋ ě z n a j uː t͡ɕ
trema	t r ěː m a
кривица	k r i ʋ ǐ t͡s a
makro	m â k r o
послушати	p ǒ s l u ʃ a t i
oživiti	o ʒ ǐː ʋ i t i
publikacija	p u b l i k ǎː t͡s i j a
opeka	ô p e k a
необјективно	n ê o b j e k t i ʋ n o
odmjeriti	ǒ d m j e r i t i
црквенословенски	t͡s r̩ k ʋ e n o s l ǒ ʋ e n s k iː
svetioničar	s ʋ e t i ǒ n i t͡ʃ aː r
кћи	k t͡ɕ îː
јесетра	j ě s e t r a
znoj	z n ôː j
мода	m ǒː d a
trovač	t r ǒ ʋ aː t͡ʃ
бањ	b â ɲ
гланц	ɡ l â n t͡s
socijalizam	s o t͡s i j a l ǐ z a m
pijandura	p i j ǎ n d u r a
злоба	z l ǒ b a
trajan	t r âː j a n
vučica	ʋ ǔ t͡ʃ i t͡s a
кружић	k r ǔː ʒ i t͡ɕ
srednjovekovni	s r e d ɲ o ʋ ě k oː ʋ n iː
стварно	s t ʋ âː r n o
надбискуп	n ǎ d b i s k u p
naseobina	n ǎː s e o b i n a
одмерити	ǒ d m e r i t i
гавран	ɡ â ʋ r aː n
slasno	s l â s n o
амелиорација	a m e l i o r ǎː t͡s i j a
nadoknada	n â d o k n a d a
Криводол	k r i ʋ ǒ d o l
просац	p r ǒ s a t͡s
predsjednik	p r ěː d s j e d n iː k
zemljotres	z ê m ʎ o t r eː s
demonski	d ě m oː n s k iː
наум	n ǎ u m
nakositi	n a k ǒ s i t i
prolamati	p r o l ǎː m a t i
suparnik	s ǔ p aː r n iː k
сродност	s r ô d n oː s t
јурта	j ûː r t a
ciganski	t s î ɡ a n s k iː
храпав	x r â p a ʋ
kompetencija	k o m p e t ě n t͡s i j a
самопоштовање	s a m o p o ʃ t o ʋ ǎː ɲ e
dramaturgija	d r a m a t ǔ r ɡ i j a
обавјештавати	o b a ʋ j e ʃ t ǎː ʋ a t i
Kalifornija	k a l i f ǒ r n i j a
одмагати	o d m ǎː ɡ a t i
čvrstoća	t͡ʃ ʋ r̩ s t ǒ t͡ɕ a
сјеверноамерички	s j e ʋ e r n o a m ě r i t͡ʃ k iː
ideologija	i d e o l ǒ ɡ i j a
ploviti	p l ǒ ʋ i t i
umjeren	ǔ m j e r e n
nasuprot	n â s u p r o t
delegacija	d e l e ɡ ǎː t͡s i j a
болничар	b ǒː l n i t͡ʃ aː r
pozirati	p o z ǐː r a t i
подилазити	p o d ǐ l a z i t i
пресликати	p r ě s l i k a t i
štikati	ʃ t î k a t i
препирка	p r ě p iː r k a
сиједост	s i j ěː d oː s t
глодати	ɡ l ǒ d a t i
пренути	p r ê n u t i
tajanstven	t a j ǎ n s t ʋ e n
биљни	b îː ʎ n iː
врежа	ʋ r êː ʒ a
treptav	t r ê p t a ʋ
dočaravati	d o t͡ʃ a r ǎː ʋ a t i
чеони	t͡ʃ ê o n iː
nejasnost	n ě j a s n oː s t
odbrana	ô d b r a n a
референдум	r e f e r ě n d u m
preći	p r êː t͡ɕ i
kukavica	k û k a ʋ i t͡s a
žutokljunac	ʒ u t o k ʎ ǔː n a t͡s
импресиван	î m p r e s iː ʋ a n
трауматизирати	t r a u m a t i z ǐː r a t i
almaatski	a l m a â t s k iː
klizaljka	k l ǐː z aː ʎ k a
сетва	s ê t ʋ a
rekreacija	r e k r e ǎː t͡s i j a
prebacivati	p r e b a t͡s ǐː ʋ a t i
Трст	t r̩̂ s t
posljednji	p ǒ s ʎ e d ɲ iː
albanski	ǎ l b aː n s k iː
бушилица	b ǔ ʃ i l i t͡s a
умишљати	u m ǐː ʃ ʎ a t i
kisnuti	k î s n u t i
колонија	k ǒ l oː n i j a
Буда	b ǔː d a
lingvista	l ǐ n ɡ ʋ i s t a
алегорија	a l e ɡ ǒ r i j a
цистерна	t͡s ǐ s t eː r n a
ранити	r â n i t i
konac	k ǒ n a t͡s
pšenica	p ʃ ě n i t͡s a
наговест	n â ɡ o ʋ eː s t
slatkorječiv	s l a t k o r j ě t͡ʃ i ʋ
зујара	z ǔ j a r a
naočale	n â o t͡ʃ aː l e
boravak	b ǒ r a ʋ a k
речица	r ě t͡ʃ i t͡s a
сачињавати	s a t͡ʃ i ɲ ǎː ʋ a t i
seljački	s ě ʎ aː t ʃ k iː
поглавар	p o ɡ l ǎ ʋ aː r
pregledno	p r ěː ɡ l e d n o
прорачун	p r ô r a t͡ʃ uː n
slavić	s l ǎ ʋ iː t͡ɕ
frajer	f r â j e r
plaćati	p l ǎː t͡ɕ a t i
Келткиња	k ê l t k i ɲ a
vrištav	ʋ r ǐ ʃ t a ʋ
пријећи	p r i j êː t͡ɕ i
podmitljivost	p o d m ǐ t ʎ i ʋ oː s t
прештампати	p r ě ʃ t aː m p a t i
непровјерен	n e p r ǒ ʋ j e r e n
коаксијалан	k ô a k s i j aː l a n
antifašizam	a n t i f a ʃ ǐ z a m
higijeničar	x i ɡ i j ě n i t͡ʃ aː r
обмана	ô b m a n a
kolonijalan	k ô l o n i j aː l a n
отети	ǒ t eː t i
вагати	ʋ ǎː ɡ a t i
eholalija	e x o l ǎ l i j a
urotiti	u r ǒ t i t i
zaudarati	z a ǔ d a r a t i
узалуд	û z a l uː d
sablastan	s â b l aː s t a n
савјет	s ǎː ʋ j e t
лексикографски	l e k s i k ǒ ɡ r a f s k iː
аметист	a m ě t i s t
anđelčić	a n d͡ʑ ě l t͡ʃ i t͡ɕ
ustrajan	û s t r aː j a n
javljati	j ǎː ʋ ʎ a t i
stapati	s t ǎː p a t i
altimetar	ǎ l t i m e t a r
акупунктура	a k u p u n k t ǔː r a
individualno	î n d i ʋ i d u aː l n o
спецификација	s p e t͡s i f i k ǎː t͡s i j a
supstancija	s u p s t ǎ n t͡s i j a
црвенити	t͡s r ʋ ě n i t i
разњеживати	r a z ɲ e ʒ ǐː ʋ a t i
линеаран	l î n e aː r a n
Тунис	t ǔ n i s
bakteriološki	b a k t e r i ǒ l o ʃ k iː
ambrela	a m b r ěː l a
lopovština	l o p ǒː ʋ ʃ t i n a
халуцинирати	x a l u t͡s i n ǐː r a t i
cimerica	t͡s î m e r i t͡s a
банкрот	b ǎ n k r oː t
kriminalan	k r î m i n aː l a n
smešiti	s m ěː ʃ i t i
критичарка	k r ǐ t i t͡ʃ aː r k a
egzotičan	e ɡ z ǒ t i t͡ʃ a n
замотуљак	z a m o t ǔː ʎ a k
разломити	r a z l ǒ m i t i
oprati	ǒ p r a t i
biografski	b i ǒ ɡ r a f s k iː
zastupnica	z ǎː s t u p n i t͡s a
цвјетни	t͡s ʋ j ě t n iː
патика	p ǎ t i k a
преџивот	p r ě d͡ʒ i ʋ o t
kršiti	k ř ʃ i t i
fajda	f ǎ j d a
куца	k ǔː t͡s a
pandur	p ǎ n d uː r
прожети	p r ǒ ʒ eː t i
dohvatljiv	d o x ʋ ǎ t ʎ i ʋ
неописиво	n e o p ǐ s i ʋ o
шербет	ʃ ě r b e t
uman	ûː m a n
neizvestan	n ê i z ʋ e s t a n
razmjenjivati	r a z m j e ɲ ǐː ʋ a t i
трачати	t r â t͡ʃ a t i
историја	ǐ s t oː r i j a
indijanski	i n d ǐ j aː n s k iː
примјер	p r ǐː m j e r
размјеран	r ǎː z m j eː r a n
stranica	s t r ǎ n i t͡s a
бирач	b ǐ r aː t͡ʃ
тематски	t ě m a t s k iː
zločinstvo	z l ǒ t͡ʃ iː n s t ʋ o
fragmentaran	f r â ɡ m e n t aː r a n
sušiti	s ǔː ʃ i t i
krkan	k ř k a n
удавача	u d ǎ ʋ a t͡ʃ a
nekonvencionalan	n ê k o n ʋ e n t͡s i o n aː l a n
ponovno	p ô n oː ʋ n o
graditeljski	ɡ r ǎ d i t e ʎ s k iː
poletjeti	p o l ě t j e t i
oploditi	o p l ǒ d i t i
upropašćivati	u p r o p a ʃ t͡ɕ ǐː ʋ a t i
булевар	b u l ě v aː r
dravski	d r âː ʋ s k iː
управљати	ǔ p r a ʋ ʎ a t i
difuzivnost	d i f u z ǐː ʋ n oː s t
корити	k ǒ r i t i
пацифизам	p a t͡s i f ǐ z a m
zvaničan	z ʋ ǎ n i t͡ʃ a n
umetnica	ǔ m e t n i t͡s a
sužavati	s u ʒ ǎː ʋ a t i
крволиптање	k r ʋ o l ǐ p t aː ɲ e
фармакологија	f a r m a k o l ǒ ɡ i j a
manipulacija	m a n i p u l ǎː t͡s i j a
непрокушан	n e p r ǒ k u ʃ aː n
transakcija	t r a n s ǎ k t͡s i j a
sjedati	s j ê d a t i
перфект	p ě r f e k t
čovječan	t͡ʃ ô ʋ j e t͡ʃ a n
Аустрија	ǎ u s t r i j a
идеалист	i d e ǎ l i s t
ljepojka	ʎ ě p oː j k a
zloćudan	z l ǒ t͡ɕ u d a n
пркосан	p ř k o s a n
čiji	t͡ʃ ǐ j iː
безосећајно	b ê z o s e t͡ɕ aː j n o
глибовит	ɡ l i b ǒ ʋ i t
uzbunjivati	u z b u ɲ ǐː ʋ a t i
proricati	p r o r ǐː t͡s a t i
излаз	î z l aː z
izbirljiv	i z b ǐ r ʎ i ʋ
def	d ê f
бескаматни	b ě s k a m a t n iː
pojedinac	p o j e d ǐː n a t͡s
kongresmen	k ǒ n ɡ r e s m e n
papak	p ǎː p a k
puštati	p ǔː ʃ t a t i
ijekavski	i j ěː k a ʋ s k iː
cevčica	t͡s ě ʋ t͡ʃ i t͡s a
blagoslov	b l â ɡ o s l oː ʋ
filc	f î l t͡s
đihad	d͡ʑ ǐ x aː d
називати	n a z ǐː ʋ a t i
бензен	b ě n z eː n
podbel	p ǒ d b e l
трансцендентализам	t r a n s t͡s e n d e n t a l ǐ z a m
митолог	m i t ǒ l o ɡ
kauzativan	k â u z a t iː ʋ a n
stih	s t î x
toplice	t ǒ p l i t͡s e
преписати	p r e p ǐː s a t i
законит	z ǎː k o n i t
пустињачки	p ǔː s t i ɲ aː t͡ʃ k iː
прихваћати	p r ǐ x ʋ a t͡ɕ a t i
изопачен	i z ǒ p aː t͡ʃ e n
imputirati	i m p u t ǐː r a t i
Сарајка	s ǎ r aː j k a
razgovorljiv	r a z ɡ o ʋ ǒ r ʎ i ʋ
aktivist	a k t ǐ ʋ i s t
one	ǒ n e
ospice	ô̞ s̪ p i t̪͡s̪ e̞
мјесечарка	m j ê s e t͡ʃ aː r k a
slalom	s l ǎ l o m
toponimski	t o p ǒ n i m s k iː
рехабилитирати	r e x a b i l i t ǐː r a t i
turobno	t û r oː b n o
zavarati	z ǎ ʋ a r a t i
бајунет	b a j ǔ n eː t
boginja	b ǒ ɡ i ɲ a
чвор	t͡ʃ ʋ ôː r
tučak	t ǔː t͡ʃ a k
појављивати	p o j a ʋ ʎ ǐː ʋ a t i
cirkulacija	t͡s i r k u l ǎː t͡s i j a
izravnavati	i z r a ʋ n ǎː ʋ a t i
neustavan	n ê u s t aː ʋ a n
betonirati	b e t o n ǐː r a t i
omladina	ǒ m l a d i n a
тепсти	t ê p s t i
Bosna	b ô s n a
симболизирати	s i m b o l i z ǐː r a t i
Онтарио	o n t âː r i o
punoletan	p û n o l e t a n
kroasan	k r o ǎ s aː n
strategija	s t r ǎ t eː ɡ i j a
Kambodža	k a m b ǒ d͡ʒ a
utvrditi	u t ʋ řː d i t i
internacionalizam	i n t e r n a t͡s i o n a l ǐ z a m
лоптати	l ô p t a t i
seksi	s ê k s iː
гутање	ɡ ǔ t aː ɲ e
dućan	d ǔ t͡ɕ aː n
Библија	b ǐ b l i j a
шупчина	ʃ ǔ p t͡ʃ i n a
otpisivati	o t p i s ǐː ʋ a t i
taksimetar	t ǎ k s i m e t a r
mač	m â t͡ʃ
arheolog	a r x e ǒ l o ɡ
деветина	d e ʋ ě t i n a
ружно	r ûː ʒ n o
opozivati	o p o z ǐː ʋ a t i
potjernica	p ǒ t j eː r n i t͡s a
војсковођа	ʋ ô j s k o ʋ o d͡ʑ a
usisavati	u s i s ǎː ʋ a t i
протјерати	p r ǒ t j e r a t i
добитак	d o b ǐː t a k
Perun	p ê r u n
клети	k l êː t i
разорити	r a z ǒ r i t i
bigotan	b ǐ ɡ o t a n
окусити	ǒ k u s i t i
kozmopolitski	k o z m o p ǒ l iː t s k iː
bubrežast	b ǔ b r e ʒ a s t
хигрометар	x î ɡ r o m e t a r
tomahavk	t ǒ m a x a ʋ k
сакупљачки	s a k ǔ p ʎ aː t͡ʃ k iː
изазивач	i z a z ǐ ʋ aː t͡ʃ
barel	b ǎ r e l
pribrajati	p r i b r ǎː j a t i
брада	b r ǎː d a
подесити	p ǒ d e s i t i
изнијети	ǐ z n j eː t i
iber	ǐː b e r
божиј	b ô ʒ iː j
абдоменски	a b d ǒː m e n s k iː
четверокут	t͡ʃ ê t ʋ e r o k uː t
пресрести	p r ě s r e s t i
kuknjava	k ǔ k ɲ a ʋ a
japanski	j ǎ p aː n s k iː
Portugal	p ô r t u ɡ a l
судбина	s û d b i n a
kršćanstvo	k ř̩ ʃ t͡ɕ aː n s t ʋ o
нестручњак	n ě s t r u t͡ʃ ɲ aː k
strmo	s t r̂ m o
учвршћивати	u t͡ʃ ʋ r̩ ʃ t͡ɕ ǐː ʋ a t i
telefonist	t e l e f ǒ n i s t
надимак	n ǎː d i m a k
uricati	u r ǐː t s a t i
злоупотријебити	z l o u p o t r j ěː b i t i
љупкост	ʎ û p k oː s t
slabokrvnost	s l a b o k řː ʋ n oː s t
Индијанка	i n d ǐ j aː n k a
Antun	ǎ n t uː n
увредити	u ʋ r ěː d i t i
Шипан	ʃ ǐ p a n
amorfan	ǎ m o r f a n
најам	n ǎː j a m
сувислост	s ǔ ʋ i s l oː s t
filantropija	f i l a n t r ǒ p i j a
синов	s îː n o ʋ
препрати	p r ě p r a t i
ekonomičan	e k o n ǒ m i t͡ʃ a n
прћити	p r̩̂ t͡ɕ i t i
svanuti	s ʋ ǎ n u t i
legalno	l ě ɡ aː l n o
rapsodija	r ǎ p s oː d i j a
наследан	n ǎː s ʎ e d a n
Црногорац	t͡s r̩ n ǒ ɡ o r a t͡s
prepisivati	p r e p i s ǐː ʋ a t i
iskorak	î s k o r aː k
њургало	ɲ û r ɡ a l o
pazuh	p â z uː x
припадност	p r ǐ p a d n oː s t
злонамерно	z l o n ǎː m eː r n o
Paragvajac	p a r a ɡ ʋ ǎː j a t͡s
polubrat	p o l ǔ b r a t
slap	s l âː p
klizati	k l ǐː z a t i
pak	p â k
Kazahstan	k â z a x s t aː n
анархичан	a n ǎ r x i t͡ʃ a n
zdaj	ˈz d a j
злурадост	z l ǔ r a d oː s t
biseran	b ǐ s eː r a n
punoljetničin	p u n ô ʎ e t n i t͡ʃ i n
секретарски	s e k r ě t aː r s k iː
цинички	t s ǐ n i t ʃ k iː
reformizam	r e f o r m ǐ z a m
битер	b ǐ t e r
стражњица	s t r â ʒ ɲ i t͡s a
arhiv	ǎ r x iː ʋ
близак	b l î z a k
sinak	s î n a k
alofon	â l o f oː n
породити	p o r ǒ d i t i
pretinac	p r ě t i n a t͡s
урачунавати	u r a t͡ʃ u n ǎː ʋ a t i
испитни	ǐ s p i t n iː
igalo	ǐ ɡ a l o
raskošno	r ǎː s k o ʃ n o
rukopisni	r û k o p iː s n iː
процјена	p r ô t͡s j e n a
деизам	d e ǐ z a m
поново	p ô n o ʋ o
Југославија	j u ɡ ǒ s l aː ʋ i j a
чинилац	t͡ʃ ǐ n i l a t͡s
jeftinoća	j e f t i n ǒ t͡ɕ a
pokladnica	p ǒ k l a d n i t͡s a
Madrid	m ǎ d r iː d
разноситељ	r a z n ǒ s i t e ʎ
pluralizacija	p l u r a l i z ǎː t͡s i j a
infarkt	ǐ n f a r k t
automobilist	a u t o m o b ǐ l i s t
sabirač	s a b ǐ r aː t͡ʃ
nepismenost	n ě p i s m e n oː s t
bat	b â t
јачати	j ǎ t͡ʃ a t i
на	n a
pobeći	p ǒ b e t͡ɕ i
узнемирити	u z n e m ǐː r i t i
poraće	p ǒ r aː t͡ɕ e
уприличити	u p r ǐː l i t͡ʃ i t i
veselje	ʋ e s ěː ʎ e
dekret	d ě k r eː t
гротескан	ɡ r o t ě s k a n
нагао	n ǎː ɡ a o
kišobran	k î ʃ o b r aː n
вестерн	ʋ ě s t e r n
posmrče	p ǒ s m r̩ t͡ʃ e
равнодушност	r a ʋ n ǒ d u ʃ n oː s t
грдити	ɡ řː d i t i
kondenzator	k o n d ě n z aː t o r
ширење	ʃ ǐː r eː ɲ e
špric	ʃ p r î t͡s
praktično	p r ǎ k t i t͡ʃ n o
tukac	t ǔː k a t͡s
uzimati	ǔ z i m a t i
белетристика	b e l e t r ǐ s t i k a
regresivan	r ê ɡ r e s iː ʋ a n
beračica	b e r ǎ t͡ʃ i t͡s a
križalina	k r ǐ ʒ a l i n a
prdnuti	p r̂ d n u t i
sjedinjavati	s j e d i ɲ ǎː ʋ a t i
подробно	p ô d r o b n o
brodica	b r ǒ d i t͡s a
берилијум	b ě r iː l i j u m
набој	n ǎː b o j
Sarajlija	s a r ǎ j l i j a
vrzmati	ʋ r̂ z m a t i
šajba	ʃ âː j b a
безначајност	b e z n a t͡ʃ ǎː j n oː s t
самогласнички	s â m o ɡ l a s n i t͡ʃ k iː
албанолошки	a l b a n ǒ l o ʃ k iː
opkop	ǒ p k o p
џокеј	d͡ʒ ǒ k eː j
preduzeće	p r e d u z e t͡ɕ e
тропопауза	t r o p o p ǎ u z a
лијевати	l i j ěː ʋ a t i
топоним	t o p ǒ n iː m
исплетати	ǐ s p l e t a t i
rajčica	r ǎ j t͡ʃ i t͡s a
bekhend	b ê k x e n d
наочаре	n â o t͡ʃ aː r e
Ištvan	î ʃ t ʋ aː n
zagonetati	z a ɡ o n ěː t a t i
svježina	s ʋ j e ʒ ǐ n a
љубитељ	ʎ ǔ b i t e ʎ
смијешан	s m j ěː ʃ a n
srebren	s r ê b r e n
nastranost	n ǎ s t r a n oː s t
злоћудан	z l ǒ t͡ɕ u d a n
antropologija	a n t r o p o l ǒ ɡ i j a
аутаркија	a u t ǎ r k i j a
izroditi	i z r ǒ d i t i
омогућити	o m o ɡ ǔː t͡ɕ i t i
верификацијски	ʋ e r i f i k ǎː t͡s iː j s k iː
ишчупати	i ʃ t͡ʃ ǔ p a t i
hrestomatija	x r e s t o m ǎ t i j a
ljudožderstvo	ʎ u d ǒ ʒ d eː r s t ʋ o
приморавати	p r i m o r ǎː ʋ a t i
потрудити	p o t r ǔː d i t i
аукција	a ǔ k t͡s i j a
живописан	ʒ î ʋ o p iː s a n
ideološki	i d e ǒ l o ʃ k iː
juriš	j û r iː ʃ
izazovno	î z a z oː ʋ n o
ekonomski	e k ǒ n o m s k iː
непробојан	n ê p r o b oː j a n
pravoverje	p r â ʋ o ʋ eː r j e
вермут	ʋ ě r m u t
минут	m ǐ n uː t
maršal	m ǎ r ʃ aː l
примерен	p r ǐ m e r e n
смртоносно	s m r t ǒ n o s n o
оправдан	ǒ p r aː ʋ d aː n
atentat	a t ě n t aː t
naročito	n ǎː r o t͡ʃ i t o
гдекад	ɡ d ě k a d
ušiljiti	u ʃ ǐː ʎ i t i
олакотност	ô l a k o t n oː s t
salitreni	s ǎ l i t r e n iː
еон	ě oː n
prelijetati	p r e l i j ěː t a t i
блазиња	b l ǎ z i ɲ a
развезати	r a z ʋ ěː z a t i
лицемер	l î t͡s e m e r
vozarina	ʋ o z ǎ r i n a
astralan	ǎ s t r aː l a n
osifikacija	o s i f i k ǎː t͡s i j a
деликатан	d ê l i k aː t a n
skunjiti	s k ǔː ɲ i t i
Priština	p r ǐ ʃ t i n a
потплатити	p o t p l ǎː t i t i
strejtaš	ˈs t r ê j t aː ʃ
zatvor	z ǎː t ʋ o r
ратни	r â t n iː
заредити	z a r ěː d i t i
проучавати	p r o u t͡ʃ ǎː ʋ a t i
естетика	e s t ě t i k a
primedba	p r ǐː m e d b a
mati	m â t i
tajga	t âː j ɡ a
часослов	t͡ʃ â s o s l o ʋ
тетоважа	t e t o ʋ ǎː ʒ a
трампа	t r âː m p a
инвестирати	i n ʋ e s t ǐː r a t i
nahraniti	n a x r ǎː n i t i
kanadski	k ǎ n a d s k iː
биљежница	b ǐ ʎ e ʒ n i t͡s a
fonetički	f o n ě t i t͡ʃ k iː
клиторис	k l ǐ t oː r i s
кметство	k m ě t s t ʋ o
dominirati	d o m i n ǐː r a t i
незамисливо	n e z a m ǐ s l i ʋ o
rečnički	r êː t͡ʃ n iː t͡ʃ k iː
izgarati	i z ɡ ǎː r a t i
левица	l ě ʋ i t͡s a
svetionik	s ʋ e t i ǒ n iː k
страхота	s t r a x ǒ t a
Indonezija	i n d ǒ n eː z i j a
баљезгати	b a ʎ ě z ɡ a t i
badava	b a d ǎ ʋ a
usavršavati	u s a ʋ r ʃ ǎː ʋ a t i
cenzor	t͡s ê n z o r
džepar	d͡ʒ ê p aː r
унаказити	u n a k ǎː z i t i
putovnica	p u t ǒː ʋ n i t͡s a
лутати	l ǔː t a t i
ћурак	t͡ɕ ǔ r a k
уређај	û r e d͡ʑ aː j
плиновод	p l î n o ʋ oː d
sić	s î t͡ɕ
tužiteljstvo	t ǔ ʒ i t e ʎ s t ʋ o
topljiv	t ǒ p ʎ i ʋ
несебичан	n ê s e b i t͡ʃ a n
менаџер	m ě n a d͡ʒ e r
живети	ʒ ǐː ʋ e t i
јахање	j â x aː ɲ e
pripremiti	p r i p r ěː m i t i
испразан	î s p r aː z a n
Техеран	t ê x e r aː n
чланство	t͡ʃ l ǎ n s t ʋ o
trezvenjakinja	t r e z ʋ e ɲ ǎ k i ɲ a
tadž	t â d͡ʒ
схватити	s x ʋ â t i t i
rezistentan	r e z i s t ě n t a n
zarudeti	z a r ǔː d e t i
alternacija	a l t e r n ǎː t͡s i j a
оборив	o b ǒ r i ʋ
odrađivati	o d r a d͡ʑ ǐː ʋ a t i
šparhet	ʃ p ǎ r x e t
Fenicija	f e n ǐː t͡s i j a
успркос	û s p r k o s
osvit	ǒ s ʋ i t
Ahil	ǎ x i l
tradicijski	t r ǎ d iː t͡s i j s k i
танац	t â n a t͡s
одрађивати	o d r a d͡ʑ ǐː ʋ a t i
šparmajstor	ʃ p ǎː r m aː j s t o r
бећаруша	b e t͡ɕ ǎ r u ʃ a
bira	b î r a
preferirati	p r e f e r ǐː r a t i
кривоклетник	k r i ʋ ǒ k l e t n iː k
bjelance	b j e l ǎː n t͡s e
posrkati	p o s řː k a t i
podrugnuti	p ǒ d r u ɡ n u t i
сируп	s ǐ r u p
магичност	m ǎ ɡ i t͡ʃ n oː s t
rečit	r ě t͡ʃ i t
osiguranje	o s i ɡ u r ǎː ɲ e
деструкција	d e s t r ǔ k t͡s i j a
pijan	p ǐ j a n
ivica	î ʋ i t͡s a
lišaj	l î ʃ aː j
спријатељити	s p r i j a t ě ʎ i t i
ćurka	t͡ɕ ǔː r k a
амбивалентност	a m b i ʋ ǎ l e n t n oː s t
шраубнцијер	ʃ r ǎ u b n t͡s i j e r
специјалан	s p ê t͡s i j aː l a n
bankroter	b a n k r ǒ t eː r
ženidba	ʒ ě n i d b a
antropomorfizam	a n t r o p o m o r f ǐ z a m
Tibet	t ǐ b e t
отрцаност	ǒ t r̩ː t͡s aː n oː s t
notorno	n ǒ t oː r n o
izbadati	i z b ǎː d a t i
besa	b ěː s a
сванути	s ʋ ǎ n u t i
skela	s k ê l a
preotimati	p r e ǒ t i m a t i
sabor	s ǎː b o r
безизлазно	b ê z i z l a z n o
зажељети	z a ʒ ě ʎ e t i
кровар	k r ǒ ʋ aː r
зове	z ǒ ʋ e
temeljito	t e m ě ʎ i t o
превој	p r ěː ʋ o j
крстопуће	k r s t ǒ p uː t͡ɕ e
нишанџија	n i ʃ ǎ n d͡ʒ i j a
стрвинар	s t ř ʋ i n aː r
Burma	b ûː r m a
првијенац	p r ʋ i j ěː n a c
Nikaragvanac	n i k a r a ɡ ʋ ǎː n a t͡s
абнормалност	a b n o r m ǎː l n oː s t
kontaminacija	k o n t a m i n ǎː t͡s i j a
коса	k ǒ s a
пракрт	p r ǎ k r t
надати	n ǎː d a t i
podrezivati	p o d r e z ǐː ʋ a t i
već	ʋ ê t͡ɕ
утаначити	u t a n ǎː t͡ʃ i t i
zijevati	z j ěː ʋ a t i
zasluženo	z ǎ s l uː ʒ e n o
irha	ǐ r x a
козјак	k ô z j aː k
саопћивати	s a o p t͡ɕ ǐː ʋ a t i
спаваоница	s p a ʋ a ǒː n i t͡s a
сакупљач	s a k ǔ p ʎ aː t͡ʃ
чам	t͡ʃ â m
сицвана	s î t͡s ʋ a n a
истрошити	i s t r ǒ ʃ i t i
анголски	ǎ n ɡ o l s k iː
začuđivati	z a t͡ʃ u d͡ʑ ǐː ʋ a t i
vratiti	ʋ r ǎː t i t i
pastuh	p â s t uː x
koturina	k o t ǔ r i n a
трачница	t r â t͡ʃ n i t͡s a
Palestinac	p a l e s t ǐː n a t͡s
одрицати	o d r ǐː t͡s a t i
никада	n î k a d a
časovit	t͡ʃ a s ǒ ʋ i t
гордијски	ɡ ǒ r d iː j s k iː
змај	z m â j
архаичан	a r x ǎ i t͡ʃ a n
kaluđer	k ǎ l u d͡ʑ e r
окривити	o k r ǐː ʋ i t i
шизофренија	ʃ i z o f r ě n i j a
снажан	s n ǎː ʒ a n
јогунасто	j ǒ ɡ u n a s t o
цјелокупан	t͡s j e l ǒ k u p a n
насљеђе	n ǎː s ʎ eː d͡ʑ e
прћаст	p r̩̂ t͡ɕ a s t
антипод	a n t ǐ p oː d
druželjubivo	d r u ʒ e ʎ ǔ b i ʋ o
лом	l ôː m
ćuprija	t͡ɕ ǔ p r i j a
гутати	ɡ ǔ t a t i
езотеричан	e z o t ě r i t͡ʃ a n
срам	s r âː m
Pandora	p a n d ǒː r a
заварати	z ǎ ʋ a r a t i
obrazovni	ǒ b r a z oː ʋ n iː
razbjeći	r ǎ z b j e t͡ɕ i
stan	s t âː n
истоваривач	i s t o ʋ a r ǐ ʋ aː t͡ʃ
jednostavno	j ê d n o s t aː ʋ n o
штикла	ʃ t ǐ k l a
дефетистички	d e f e t ǐ s t i t͡ʃ k iː
тесан	t ěː s a n
плеоназам	p l e o n ǎ z a m
милосрдан	m î l o s rː d a n
smiono	s m ǐ o n o
завера	z âː ʋ e r a
temeljiti	t e m ě ʎ i t i
obrijati	ǒ b r i j a t i
kolektor	k ǒ l e k t o r
gospoda	ɡ o s p ǒ d a
besputan	b ě s p u t a n
средоземни	s r ê d o z eː m n iː
šovinizam	ʃ o ʋ i n ǐ z a m
хијерархијски	x i j e r ǎ r x iː j s k iː
doktorica	d ô k t o r i t͡s a
пластелин	p l a s t ě l iː n
istosmjeran	î s t o s m j eː r a n
primetljivo	p r i m ě t ʎ i ʋ o
naguravati	n a ɡ u r ǎː ʋ a t i
pristupačnost	p r î s t u p aː t͡ʃ n oː s t
несавршен	n e s ǎ ʋ r ʃ e n
izručiti	i z r ǔː t͡ʃ i t i
примерено	p r ǐ m e r e n o
истакнут	ǐ s t a k n uː t
јавански	j ǎ ʋ aː n s k iː
trkačica	t r̩ k ǎ t͡ʃ i t͡s a
танан	t ǎ n a n
шурак	ʃ u r a k
gundelj	ɡ ǔ n d e ʎ
štiga	ʃ t ǐː ɡ a
досезати	d o s ěː z a t i
заредавати	z a r e d ǎː ʋ a t i
uzleteti	u z l ě t e t i
баздјети	b ǎ z d j e t i
čitaonica	t͡ʃ i t a ǒː n i t͡s a
воњати	ʋ ǒ ɲ a t i
цер	t͡s ê r
pršut	p ř ʃ u t
калемити	k ǎ l e m i t i
oporavljati	o p ǒ r a ʋ ʎ a t i
prost	p r ô s t
освојив	o s ʋ ǒ j i ʋ
pozan	p ôː z a n
суџук	s ǔ d͡ʒ u k
izbliza	î z b l iː z a
попречно	p ô p r e t͡ʃ n o
trenje	t r ěː ɲ e
lukavac	l û k a ʋ a t͡s
upijati	u p ǐː j a t i
adventistkinja	a d ʋ ě n t i s t k i ɲ a
vojvodstvo	ʋ ǒ j ʋ o d s t ʋ o
prodaja	p r ô d a j a
bogatiti	b ǒ ɡ a t i t i
zakopati	z a k ǒ p a t i
дјелотворан	d j ê l o t ʋ oː r a n
камионџија	k a m i ǒ n d͡ʒ i j a
istosmerno	î s t o s m eː r n o
неостварив	n e o s t ʋ ǎ r i ʋ
bezimenost	b ě z i m e n oː s t
prihvatljivost	p r i x ʋ ǎ t ʎ i ʋ oː s t
шармер	ʃ ǎ r m eː r
зачарати	z a t͡ʃ ǎː r a t i
biljka	b îː ʎ k a
ćoza	t͡ɕ ô z a
propadati	p r ǒ p a d a t i
тесати	t ě s a t i
rodski	r ô d s k i
dostići	d ǒ s t i t͡ɕ i
абхаски	ǎ b x aː s k iː
фригидан	f r ǐ ɡ iː d a n
вањски	ʋ ǎ ɲ s k iː
tri	t r îː
мехурић	m e x ǔ r i t͡ɕ
samozadovoljavati	s a m o z a d o ʋ o ʎ ǎː ʋ a t i
oteti	ǒ t eː t i
скочити	s k ǒ t͡ʃ i t i
Apolon	a p ǒ l oː n
žohar	ʒ ô x aː r
ljubaznik	ʎ û b a z n iː k
ракета	r a k ě t a
имагинација	i m a ɡ i n ǎː t͡s i j a
јесенас	j e s ě n a s
neurastenija	n e u r a s t ě n i j a
list	l îː s t
Перун	p ê r u n
cvrkutati	t͡s ʋ r̩ k ǔ t a t i
kredo	k r êː d o
коптски	k ô p t s k iː
торњати	t ǒ r ɲ a t i
лучити	l ǔː t͡ʃ i t i
обзиран	ô b z iː r a n
ексцентричан	e k s t͡s ě n t r i t͡ʃ a n
шубара	ʃ ǔ b a r a
otpravljati	ǒ t p r a ʋ ʎ a t i
odijeliti	o d j ěː l i t i
uspjeti	ǔ s p j e t i
аналогијски	a n a l ǒ ɡ iː j s k iː
сељанин	s ě ʎ a n i n
zadrugarka	z âː d r u ɡ aː r k a
školjkast	ʃ k ô ʎ k a s t
poluga	p ǒ l u ɡ a
цемент	t͡s ě m e n t
željeznički	ʒ ě ʎ e z n i t͡ʃ k iː
kiptjeti	k ǐ p t j e t i
oposum	ô p o s u m
samotnik	s â m o t n iː k
kozičavost	k ǒ z i t͡ʃ a ʋ oː s t
razmijeniti	r a z m j ěː n i t i
obljetnica	ǒ b ʎ e t n i t͡s a
autokracija	a u t o k r ǎ t͡s i j a
ругалачки	r ǔː ɡ a l a t͡ʃ k iː
redukcija	r e d ǔ k t͡s i j a
с́утра	ɕ û t r a
ургентан	u r ɡ ě n t a n
Кадеш	k ǎ d e ʃ
рушеван	r û ʃ eː ʋ a n
бугарски	b û ɡ a r s k iː
постојање	p ǒː s t o j aː ɲ e
праживотиња	p r â ʒ i ʋ o t i ɲ a
рушевност	r û ʃ eː ʋ n oː s t
вражји	ʋ r ǎ ʒ j iː
федерализам	f e d e r a l ǐ z a m
датуља	d ǎ t u ʎ a
debilan	d ê b iː l a n
skoro	s k ǒ r o
bešavno	b ê ʃ aː ʋ n o
стакленик	s t a k l ě n iː k
берачица	b e r ǎ t͡ʃ i t͡s a
sekundaran	s ê k u n d aː r a n
pedesetoro	p e d ě s eː t o r o
антропологија	a n t r o p o l ǒ ɡ i j a
svizac	s ʋ ǐː z a t͡s
красноречје	k r a s n ǒ r eː t͡ʃ j e
otprilike	o t p r ǐː l i k eː
akvizicija	a k ʋ i z ǐː t͡s i j a
чегртуша	t͡ʂ e ɡ ř t u ʃ a
липсавати	l i p s ǎː ʋ a t i
кострешити	k o s t r ěː ʃ i t i
рукица	r ǔ k i t͡s a
хортикултура	x o r t i k u l t ǔː r a
бифе	b ǐ f eː
nevaljao	n e v ǎ ʎ a o
Kroacija	k r ǒ aː t͡s i j a
vojak	ʋ ǒ j aː k
црвењети	t͡s r ʋ ě ɲ e t i
pucanj	p ûː t͡s a ɲ
petorica	p e t ǒ r i t͡s a
меница	m ê n i t͡s a
склониште	s k l ô n iː ʃ t e
бајам	b ǎ j a m
pretopiti	p r e t ǒ p i t i
примједба	p r ǐː m j e d b a
гангстерски	ɡ ǎ n ɡ s t e r s k iː
listom	l îː s t o m
милостиво	m i l ǒ s t i ʋ o
rodoslovlje	r ô d o s l oː ʋ ʎ e
tretirati	t r e t ǐː r a t i
tužan	t ǔː ʒ a n
otrcanost	ǒ t r̩̄ t͡s aː n oː s t
nesposoban	n ê s p o s o b a n
izneti	ǐ z n eː t i
заједнички	z â j e d n i t ʃ k iː
propovjednik	p r o p o ʋ j ě d n iː k
смрдјети	s m ř d j e t i
сврачји	s ʋ r â t͡ʃ j iː
замена	z âː m e n a
солидарност	s o l i d ǎː r n oː s t
израђати	i z r ǎː d͡ʑ a t i
призивати	p r i z ǐː ʋ a t i
omaška	ǒ m a ʃ k a
vrt	ʋ r̩̂ t
uračunavati	u r a t͡ʃ u n ǎː ʋ a t i
Кенија	k êː n i j a
целивати	t͡s e l ǐː ʋ a t i
табља	t â b ʎ a
ljigavo	ʎ î ɡ a ʋ o
šljivovica	ʃ ʎ î ʋ o ʋ i t͡s a
штрик	ʃ t r î k
импозантно	i m p o z ǎ n t n o
porijeklo	p o r i j ěː k l o
анатомија	a n a t ǒ m i j a
ruralan	r ǔ r aː l a n
тржишни	t r̂ ʒ iː ʃ n iː
јануар	j â n u aː r
parazitologija	p a r a z i t o l ǒ ɡ i j a
вјечан	ʋ j ê t͡ʃ a n
pobaciti	p o b ǎː t͡s i t i
banka	b ǎ ŋ k a
опстанак	ǒ p s t a n a k
обавештајни	ô b a ʋ e ʃ t aː j n iː
случајно	s l û t͡ʃ aː j n o
животињски	ʒ i ʋ ǒ t iː ɲ s k iː
неопорезив	n e o p o r ě z i ʋ
bućnuti	b û t͡ɕ n u t i
вежбати	ʋ ê ʒ b a t i
присјетити	p r ǐ s j e t i t i
štit	ʃ t îː t
zaboravnost	z a b o r ǎː ʋ n oː s t
темпао	t e m p a o
nuzgred	n û z ɡ r eː d
bosanski	b ǒ s a n s k iː
дојка	d ôː j k a
некамо	n ê k a m o
уопште	ǔ o p ʃ t e
Месец	m ê s eː t͡s
nekada	n ê k a d a
alergologijski	a l e r ɡ o l ǒ ɡ iː j s k iː
крадљивац	k r ǎ d ʎ i ʋ a t͡s
znanost	z n â n oː s t
ви	ʋ îː
njegovatelj	ɲ e ɡ ǒ ʋ a t e ʎ
kovčežina	k ǒ ʋ t͡ʃ e ʒ i n a
nepripremljenost	n e p r ǐ p r eː m ʎ e n oː s t
sinčić	s ǐ n t͡ʃ i t͡ɕ
akuzativ	â k u z a t iː ʋ
ikoliko	î k o l i k o
napustiti	n a p ǔ s t i t i
пјенити	p j ê n i t i
дом	d ô m
podgrejati	p ǒ d ɡ r e j a t i
теоретик	t e o r ě t i k
splavar	s p l ǎ ʋ aː r
факат	f â k a t
đevojčica	d͡ʑ e ʋ ǒ j t͡ʃ i t͡s a
мијешалица	m i j ě ʃ a l i t͡s a
nejasan	n ě j a s a n
voćni	ʋ ô t͡ɕ n iː
kapura	k ǎ p u r a
refleksivno	r ê f l e k s iː ʋ n o
мекоћа	m e k ǒ t͡ɕ a
гојазност	ɡ ô j aː z n oː s t
функција	f ǔ n k t͡s i j a
руинирати	r u i n ǐː r a t i
страдати	s t r ǎː d a t i
нарцисизам	n a r t͡s i s ǐ z a m
sakagija	s a k ǎ ɡ i j a
neosnovan	n ê o s n o ʋ aː n
анексија	a n ě k s i j a
помислити	p ǒ m i s l i t i
odsustvo	ǒ d s u s t ʋ o
прилагођивати	p r i l a ɡ o d͡ʑ ǐː ʋ a t i
подморнички	p ǒ d m oː r n i t͡ʃ k iː
опаска	ǒ p a s k a
krvožedan	k r̂ ʋ o ʒ eː d a n
goreti	ɡ ǒ r e t i
fascinantan	f a s t͡s i n ǎ n t a n
нерешен	n ě r eː ʃ e n
уцена	û t͡s e n a
astrolog	a s t r ǒ l o ɡ
teutonski	t ě u t oː n s k iː
rabotnik	r ǎ b o t n iː k
nebrojeno	n ě b r o j e n o
дневни	d n êː ʋ n iː
куповати	k u p ǒ ʋ a t i
дјелати	d j ê l a t i
сувозач	s û ʋ o z aː t͡ʃ
prostreti	p r ǒ s t r eː t i
гиб	ɡ îː b
непостојан	n e p ǒː s t o j aː n
штрајх	ʃ t r â j x
ветеринарка	ʋ e t e r ǐ n aː r k a
ipokrit	ǐ p o k r i t
ugristi	ǔ ɡ r i s t i
lepak	l ěː p a k
posetilac	p o s ě t i l a t͡s
лоповски	l ǒ p o ʋ s k iː
егзорцизам	e ɡ z o r t͡s ǐ z a m
лимузина	l i m u z ǐː n a
редовно	r ê d oː ʋ n o
главнина	ɡ l a ʋ n ǐ n a
užurbanost	ǔ ʒ u r b aː n oː s t
jajolik	j a j ǒ l i k
једнодушан	j e d n ǒ d u ʃ a n
omladinac	o m l a d ǐː n a t͡s
убитачан	û b i t a t͡ʃ a n
потомство	p ǒ t oː m s t ʋ o
неимаштина	n e i m ǎː ʃ t i n a
поремећај	p ô r e m e t͡ɕ aː j
pretražiti	p r e t r ǎː ʒ i t i
gospoština	ɡ o s p ǒ ʃ t i n a
nikud	n î k u d
vuna	ʋ û n a
кшатрија	k ʃ ǎ t r i j a
аномалија	a n o m ǎ l i j a
bljutav	b ʎ û t a ʋ
попити	p ǒ p i t i
уверавати	u ʋ e r ǎː ʋ a t i
kovinotokar	k ô ʋ i n o t o k aː r
superlativan	s û p e r l a t iː ʋ a n
vidik	ʋ ǐ d iː k
umiti	ǔ m i t i
стишати	s t ǐ ʃ a t i
prosperirati	p r o s p e r ǐː r a t i
бродић	b r ǒ d iː t͡ɕ
rukavičarski	r u k ǎ ʋ i t͡ʃ aː r s k iː
Алабама	a l a b ǎ m a
strah	s t r âː x
tko	t k ô
Kain	k ǎ i n
atički	ǎ t i t͡ʃ k iː
козица	k ǒ z i t͡s a
ulog	ǔː l o ɡ
сувласница	s ǔ ʋ l aː s n i t͡s a
razumevati	r a z u m ěː ʋ a t i
лимунада	l i m u n ǎː d a
iguman	î ɡ u m aː n
проза	p r ǒː z a
prestup	p r ěː s t u p
акултурација	a k u l t u r ǎː t͡s i j a
иловача	ǐ l o ʋ a t͡ʃ a
bubanj	b ûː b a ɲ
Кинез	k ǐ n eː z
забуна	z âː b u n a
boljitak	b o ʎ ǐː t a k
обратити	o b r ǎː t i t i
svest	s ʋ êː s t
излизивати	i z l i z ǐː ʋ a t i
египтолог	e ɡ i p t ǒ l o ɡ
pustinjački	p ǔː s t i ɲ aː t͡ʃ k iː
вук	v ûː k
изравнавати	i z r a ʋ n ǎː ʋ a t i
rima	r ǐː m a
železnica	ʒ ě l e z n i t͡s a
violončelo	ʋ i o l ǒ n t͡ʃ e l o
мућкати	m û t͡ɕ k a t i
zlato	z l âː t o
пријатан	p r î j aː t a n
prijemnik	p r ǐ j eː m n iː k
бабарога	b a b a r ǒː ɡ a
iti	ˈiː t i
Sabah	s a b a x
trivijalan	t r î ʋ i j aː l a n
човјек	t͡ʃ ô ʋ j e k
častan	t͡ʃ â s t a n
рибарство	r i b ǎː r s t ʋ o
ниједанпут	n i j e d ǎ n p uː t
бициклистика	b i t͡s i k l ǐ s t i k a
шрафцигер	ʃ r ǎ f t͡s iː ɡ e r
откинути	ǒ t k i n u t i
kurvica	k ûː r ʋ i t͡s a
tekstualan	t ê k s t u aː l aː n
вриштав	ʋ r ǐ ʃ t a ʋ
kinin	k ǐ n iː n
tipično	t ǐ p i t͡ʃ n o
забункерирати	z a b u n k e r ǐː r a t i
мисионар	m i s i ǒ n aː r
квалификација	k ʋ a l i f i k ǎː t͡s i j a
нобеловац	n ǒ b e l o ʋ a t͡s
podržavati	p o d r ʒ ǎː ʋ a t i
бездушно	b ě z d u ʃ n o
умерен	ǔ m e r e n
бесповратно	b ê s p o ʋ r a t n o
kožuh	k ǒ ʒ u x
једро	j ê d r o
претеча	p r ê t e t͡ʃ a
generacija	ɡ e n e r ǎː t͡s i j a
одобрити	o d ǒ b r i t i
мало	m â l o
praznovernost	p r â z n o ʋ eː r n oː s t
opustiti	o p ǔ s t i t i
телад	t ê l aː d
Švicarska	ʃ ʋ î t͡s a r s k aː
žep	ʒ æ p
popravak	p ǒ p r a ʋ a k
impertinentan	i m p e r t i n ě n t a n
трпељив	t r p ě ʎ i ʋ
Пражанин	p r â ʒ a n i n
наплата	n âː p l a t a
исушивати	i s u ʃ ǐː ʋ a t i
materinski	m â t e r iː n s k iː
prsten	p r̂ s t eː n
теглити	t ê ɡ l i t i
mirovinski	m î r o ʋ iː n s k iː
orah	ǒ r a x
strizati	s t r ǐː z a t i
левичар	l ě ʋ i t͡ʃ aː r
izvlačiti	i z ʋ l ǎː t͡ʃ i t i
oduzimati	o d ǔ z i m a t i
improvizacija	i m p r o ʋ i z ǎː t͡s i j a
očito	ǒ t͡ʃ i t o
педантно	p ě d a n t n o
udžbenik	û d͡ʒ b e n iː k
допунити	d ǒ p u n i t i
налазити	n ǎ l a z i t i
lijepiti	l j ěː p i t i
хајдемо	x ǎ j d e m o
тропосфера	t r o p o s f ěː r a
melodrama	m ê l o d r aː m a
Квебек	k ʋ e b ê k
krajputašica	k r a j p u t ǎ ʃ i t͡s a
oštar	ô ʃ t a r
досадан	d ô s aː d a n
разложан	r ǎː z l o ʒ a n
нордијски	n ǒ r d iː j s k iː
тролејбус	t r o l ěː j b u s
натјерати	n ǎ t j e r a t i
bakšiš	b ǎ k ʃ i ʃ
uzburkati	ǔ z b u r k a t i
kormilo	k ǒ r m i l o
transverzala	t r a n s ʋ e r z ǎː l a
жучљив	ʒ ǔ t͡ʃ ʎ i ʋ
bijes	b i j êː s
Cejlon	t͡s ě j l oː n
допремити	d o p r ěː m i t i
rashlađivati	r a s x l a d͡ʑ ǐː ʋ a t i
mutiti	m ǔː t i t i
pantalone	p a n t a l ǒː n e
грлица	ɡ r̩̂ l i t͡s a
елоквентан	e l o k ʋ ě n t a n
лак	l â k
ravnomjerno	r â ʋ n o m j eː r n o
одобрење	o d o b r ěː ɲ e
накит	n ǎː k i t
iscediti	i s t͡s ěː d i t i
izravan	î z r aː ʋ a n
академија	a k a d ě m i j a
bezbojan	b ê z b oː j a n
potreban	p ô t r e b a n
istjeravati	i s t j e r ǎː ʋ a t i
čudan	t͡ʃ û d a n
барбарство	b ǎ r b aː r s t ʋ o
dubina	d u b ǐ n a
ukrcavati	u k r̩ t͡s ǎː ʋ a t i
galama	ɡ a l ǎː m a
prekaliti	p r e k ǎː l i t i
штокавштина	ʃ t ǒː k a ʋ ʃ t i n a
refrakcija	r e f r ǎ k t͡s i j a
pohlepnost	p ô x l eː p n oː s t
cviker	t͡s ʋ ǐ k e r
педагог	p e d ǎ ɡ o ɡ
залуд	z â l uː d
obračunavati	o b r a t͡ʃ u n ǎː ʋ a t i
beštija	b ě ʃ t i j a
upaliti	u p ǎː l i t i
слабокрвност	s l a b o k řː ʋ n oː s t
tek	t ê k
шелесхамер	ʃ ě l e s x a m e r
sliv	s l îː ʋ
tegljač	t ě ɡ ʎ aː t͡ʃ
sastavljač	s a s t ǎ ʋ ʎ aː t͡ʃ
гушчад	ɡ û ʃ t͡ʃ aː d
prijesan	p r i j ěː s a n
prijestolonasljednik	p r j e s t o l o n ǎː s ʎ e d n iː k
korozija	k ǒ r oː z i j a
уротник	ǔ r o t n iː k
lizalica	l ǐː z a l i t͡s a
посустати	p o s ǔ s t a t i
ловокрадица	l o ʋ o k r ǎ d i t͡s a
zloćudnost	z l ǒ t͡ɕ u d n oː s t
штихпроба	ʃ t î x p r oː b a
тополошки	t o p ǒ l o ʃ k iː
несхваћен	n ě s x ʋ a t͡ɕ e n
hipotetičnost	x i p o t ě t i t͡ʃ n oː s t
обзорје	ǒ b z oː r j e
водич	ʋ ǒ d iː t͡ʃ
hmelj	x m ê ʎ
žumance	ʒ u m ǎː n t͡s e
zloupotrebiti	z l o u p o t r ěː b i t i
čopor	t͡ʃ ô p o r
ћелија	t͡ɕ ě l i j a
љубица	ʎ û b i t͡s a
šmrkati	ʃ m řː k a t i
сурађивати	s u r a d͡ʑ ǐː ʋ a t i
мелодрама	m ê l o d r aː m a
посљедица	p ǒ s ʎ e d i t͡s a
ceremonijalan	t͡s ê r e m o n i j aː l a n
патос	p ǎ t o s
frontalan	f r ǒ n t aː l a n
упомоћ	û p o m oː t͡ɕ
одраз	ô d r aː z
opsesivno	ô p s e s iː ʋ n o
pretjeran	p r ě t j e r aː n
naknaditi	n ǎ k n a d i t i
zaposlen	z ǎ p o s l e n
Rajna	r âː j n a
putarina	p u t a r i n a
недостижан	n ê d o s t i ʒ a n
ублаживати	u b l a ʒ ǐː ʋ a t i
vještak	ʋ j ě ʃ t aː k
корозија	k ǒ r oː z i j a
milje	m i ʎ eː
си	s i
бахат	b â x a t
алзашки	ǎ l z a ʃ k iː
probrati	p r ǒ b r a t i
pregristi	p r ě ɡ r i s t i
kozji	k ô z j iː
производ	p r o ǐ z ʋ o d
plato	p l ǎ t oː
ovsen	ô ʋ s e n
aforist	a f ǒ r i s t
троцкизам	t r o t͡s k ǐ z a m
darivati	d a r ǐː ʋ a t i
zaplaviti	z a p l ǎː ʋ i t i
izjašnjavati	i z j a ʃ ɲ ǎː ʋ a t i
porota	p ô r o t a
признати	p r ǐ z n a t i
Ś	ɕ
тескера	t ê s k e r a
допринијети	d o p r ǐ n j eː t i
snošljivo	s n ǒ ʃ ʎ i ʋ o
бесмртница	b ě s m r̩ t n i t͡s a
gluvoća	ɡ l u ʋ ǒ t͡ɕ a
побјељивати	p o b j e ʎ ǐː ʋ a t i
рецепт	r ě t͡s e p t
хладноратовски	x l a d n o r ǎ t o ʋ s k iː
podnošljiv	p o d n ǒ ʃ ʎ i ʋ
афикс	ǎ f i k s
располовити	r a s p o l ǒ ʋ i t i
кмет	k m ê t
hranitelj	x r ǎ n i t e ʎ
враћати	ʋ r â t͡ɕ a t i
utešljiv	u t ě ʃ ʎ i ʋ
kakofonično	k a k o f ǒ n i t͡ʃ n o
сименталски	s i m ě n t aː l s k iː
šiba	ʃ î b a
утјешљив	u t j ě ʃ ʎ i ʋ
krolati	k r ǒ l a t i
dvoriti	d ʋ ǒ r i t i
потражити	p o t r ǎː ʒ i t i
лептир	l ê p t iː r
bubrežni	b ǔ b r e ʒ n iː
spasilac	s p ǎ s i l a t͡s
besprekorno	b e s p r ěː k oː r n o
змајев	z m â j e ʋ
замењив	z a m ě ɲ i ʋ
ukrutiti	u k r ǔː t i t i
barakuda	b a r a k ǔː d a
циглар	t͡s ǐ ɡ l aː r
грам	ɡ r â m
ахирет	ǎː x i r e t
krivudati	k r i ʋ ǔ d a t i
pelena	p ê l e n a
амортизација	a m o r t i z ǎː t͡s i j a
defetist	d e f ě t i s t
ружичаст	r û ʒ i t͡ʃ a s t
мисао	m îː s a o
udruga	û d r u ɡ a
панславист	p a n s l ǎ ʋ i s t
ručurda	r ǔ t͡ʃ uː r d a
стрмо	s t r̂ m o
kristalizirati	k r i s t a l i z ǐː r a t i
nekretnina	n e k r e t n ǐ n a
испасти	ǐ s p a s t i
tunjevina	t ǔ ɲ e ʋ i n a
spektralan	s p ê k t r aː l a n
tjelovježba	t j ě l o ʋ j e ʒ b a
doviknuti	d o ʋ ǐː k n u t i
pred	p r ê d
ovjeriti	ǒ ʋ j e r i t i
одлучан	ô d l uː t͡ʃ a n
ekavica	ěː k a ʋ i t͡s a
autosugestija	a u t o s u ɡ ě s t i j a
пензијски	p ěː n z iː j s k iː
nogomet	n ô ɡ o m eː t
čudotvoran	t͡ʃ û d o t ʋ oː r a n
Sanja	s â ɲ a
пратити	p r â t i t i
синтерирање	s i n t e r ǐː r aː ɲ e
učestvovati	ǔ t͡ʃ e s t ʋ o ʋ a t i
ikud	î k u d
klupa	k l ǔː p a
diplomirati	d i p l o m ǐː r a t i
turbulentan	t u r b ǔ l e n t a n
Баварска	b ǎ ʋ aː r s k a
торзија	t ǒ r z i j a
dodam	ˈm ôː r aː m
drača	d r â t͡ʃ a
uzor	ǔː z o r
izolirano	i z ǒ l iː r a n o
neznatno	n ê z n aː t n o
starčić	s t ǎ r t͡ʃ i t͡ɕ
стјецати	s t j ê t͡s a t i
preorati	p r e ǒ r a t i
fleksija	f l ě k s i j a
sultanat	s u l t ǎ n aː t
крепао	k r ê p a o
тачкица	t â t͡ʃ k i t͡s a
brodograditelj	b r o d o ɡ r ǎ d i t e ʎ
sebi	s ê b i
паучић	p â u t͡ʃ i t͡ɕ
puška	p û ʃ k a
о	o
fizioterapeutkinja	f i z i o t e r a p ě u t k i ɲ a
мирисан	m î r iː s a n
будница	b ǔː d n i t͡s a
ukočiti	u k ǒː t͡ʃ i t i
медијски	m êː d iː j s k iː
беженство	b ě ʒ eː n s t ʋ o
koautorski	k o ǎ u t o r s k iː
контемплативан	k ô n t e m p l a t iː ʋ a n
tijesan	t j ěː s a n
pehlivan	p e x l ǐ ʋ aː n
златник	z l âː t n iː k
konsekutivan	k ô n s e k u t iː ʋ a n
iluzionizam	i l u z i o n ǐ z a m
plućni	p l ûː t͡ɕ n iː
latvijski	l ǎ t ʋ iː j s k iː
lijevak	l i j ěː ʋ a k
крв	k r̩̂ː ʋ
kreirati	k r e ǐː r a t i
лицемерка	l î t͡s e m eː r k a
дешавати	d e ʃ ǎː ʋ a t i
otorinolaringolog	o t o r i n o l a r i n ɡ ǒ l o ɡ
ласкати	l â s k a t i
уличица	û l i t͡ʃ i t͡s a
алеутски	a l ě u t s k iː
монструм	m ǒ n s t r u m
ćunak	t͡ɕ û n a k
сензуалан	s ê n z uː a l a n
čovječanstvo	t͡ʃ o ʋ j e t͡ʃ ǎ n s t ʋ o
десет	d ê s e t
башче	b ǎː ʃ t͡ʃ e
vjetrenjača	ʋ j e t r ě ɲ a t͡ʃ a
тобом	t ô b oː m
imućan	î m uː t͡ɕ a n
идиом	i d ǐ oː m
sapunica	s a p ǔ n i t͡s a
тоталитет	t o t a l ǐ t eː t
објединити	o b j e d ǐː n i t i
monoton	m ô n o t o n
безуман	b ě z uː m a n
hrpa	x ř p a
крипта	k r î p t a
јагуар	j â ɡ u aː r
sajmišni	s â j m iː ʃ n iː
дјевац	d j ěː ʋ a t͡s
проповједник	p r o p o ʋ j ě d n iː k
одламати	o d l ǎː m a t i
bistroumlje	b î s t r o uː m ʎ e
хомеоморфизам	x o m e o m o r f ǐ z a m
колут	k ô l uː t
ајмо	ǎ j m o
švanengezang	ʃ ʋ ǎː n e n ɡ e z a n ɡ
суделовати	s ǔ d e l o ʋ a t i
zaseban	z ǎː s e b a n
доље	d ô ʎ e
pjenez	p j ê n eː z
кожара	k ǒ ʒ a r a
perspektivan	p ê r s p e k t iː ʋ a n
панда	p ǎː n d a
rijetkost	r i j ěː t k oː s t
rudeti	r ǔː d e t i
пркосно	p ř k o s n o
jarčev	j âː r t͡ʃ e ʋ
потписник	p ǒ t p i s n iː k
шпекулант	ʃ p e k ǔ l a n t
izraelski	î z r a e l s k iː
jadnica	j â d n i t͡s a
прештампавати	p r e ʃ t a m p ǎː ʋ a t i
кампања	k a m p ǎ ɲ a
dokle	d ǒː k l eː
suzivati	s u z ǐː ʋ a t i
džoker	d͡ʒ ǒ k e r
Северњача	s e ʋ ěː r ɲ a t͡ʃ a
леопардов	l ê o p aː r d o ʋ
krknuti	k r̂ k n u t i
grobnica	ɡ r ô b n i t͡s a
iscuriti	i s t͡s ǔː r i t i
jajašce	j a j ǎ ʃ t͡s e
esencija	e s ě n t͡s i j a
slavina	s l ǎ ʋ i n a
неверан	n ê ʋ e r a n
štovati	ʃ t ǒ ʋ a t i
бесмртан	b ě s m r t a n
дискретно	d ǐ s k r e t n o
спиритуализам	s p i r i t u a l ǐ z a m
safirni	s ǎ f iː r n iː
šperholc	ʃ p ě r x o l t͡s
hurikan	x û r i k a n
mesečarka	m ê s e t͡ʃ aː r k a
pratilac	p r ǎ t i l a t͡s
грамзивац	ɡ r ǎ m z i ʋ a t͡s
судство	s ǔ d s t ʋ o
ништаван	n î ʃ t aː ʋ a n
драматично	d r a m ǎ t i t͡ʃ n o
spasilački	s p ǎ s i l a t͡ʃ k iː
kasno	k â s n o
vreća	ʋ r ê t͡ɕ a
исцрпити	i s t͡s ř̩ː p i t i
sabrati	s ǎ b r a t i
zloglasan	z l ǒ ɡ l a s a n
slovnica	s l ǒː ʋ n i t͡s a
tvrdokornost	t ʋ r d o k ǒː r n oː s t
амандман	a m ǎ n d m aː n
blizanac	b l i z ǎː n a t͡s
Маџарска	m â d͡ʒ a r s k aː
neosiguran	n ê o s i ɡ u r aː n
узајамно	û z a j aː m n o
igdje	î ɡ d j e
šinter	ʃ îː n t e r
циркулација	t͡s i r k u l ǎː t͡s i j a
издаја	î z d a j a
родитељски	r ǒ d i t e ʎ s k iː
jasmin	j ǎ s m iː n
сјећи	s j ê t͡ɕ i
букван	b ǔ k ʋ a n
аутомат	a u t ǒ m aː t
čar	t͡ʃ âː r
obrezivati	o b r e z ǐː ʋ a t i
dosje	d ǒ s j eː
penušav	p e n ǔ ʃ a ʋ
контроверзија	k o n t r o ʋ ě r z i j a
hala	x a l a
navodnik	n ǎː ʋ o d n iː k
bob	b ô b
концентрат	k o n t͡s ě n t r aː t
Afrikanac	a f r i k ǎː n a t͡s
igračka	ǐ ɡ r a t͡ʃ k a
лутња	l ǔː t ɲ a
плебејац	p l e b ěː j a t͡s
djelić	d j ě l i t͡ɕ
računovođa	r a t͡ʃ u n ǒ ʋ o d͡ʑ a
podne	p ǒː d n eː
дужност	d ǔː ʒ n oː s t
algebra	ǎ l ɡ eː b r a
фолклорист	f o l k l ǒ r i s t
epigram	e p ǐ ɡ r a m
profit	p r ǒ f iː t
ajatolah	a j a t ǒ l a x
људождер	ʎ u d ǒ ʒ d e r
kleptomanija	k l e p t o m ǎ n i j a
разблудница	r ǎː z b l u d n i t͡s a
друкчији	d r ǔ k t͡ʃ i j iː
udarništvo	ǔ d aː r n iː ʃ t ʋ o
reparacija	r e p a r ǎː t͡s i j a
ненавидети	n e n ǎː ʋ i d e t i
dvije	d ʋ î j e
растати	r ǎ s t a t i
tupoglavac	t u p ǒ ɡ l a ʋ a t͡s
научити	n a ǔ t͡ʃ i t i
библиофил	b i b l i ǒ f iː l
анахронизам	a n a x r o n ǐ z a m
spanać	s p ă n aː t͡ɕ
plin	p l îː n
трпети	t řː p e t i
prepirka	p r ě p iː r k a
viti	ʋ î t i
гдјегдје	ɡ d j ě ɡ d j e
старински	s t a r ǐ n s k iː
strn	s t r̩̂ː n
трагичност	t r ǎ ɡ i t͡ʃ n oː s t
izlišno	î z l i ʃ n o
кркљанац	k r k ʎ ǎː n a t͡s
dve	d ʋ êː
немаштовитост	n e m a ʃ t ǒ ʋ i t oː s t
semantika	s e m ǎ n t i k a
autizam	a u t ǐ z a m
мутав	m û t a ʋ
трк	t r̂ː k
садитељ	s ǎ d i t e ʎ
ranoranilac	r a n o r ǎ n i l a t͡s
земљопосједник	z e m ʎ o p ǒː s j e d n iː k
pravdati	p r âː ʋ d a t i
mazati	m â z a t i
крашки	k r â ʃ k iː
sopranistica	s o p r a n ǐ s t i t͡s a
праваш	p r ǎ ʋ aː ʃ
привикавати	p r i ʋ i k ǎː ʋ a t i
сирота	s i r ǒ t a
ručno	r û t͡ʃ n o
diletant	d i l ě t a n t
мамурност	m â m uː r n oː s t
imenjak	î m e ɲ aː k
избирљив	i z b ǐ r ʎ i ʋ
кожни	k ô ʒ n iː
имигрирати	i m i ɡ r ǐː r a t i
relativitet	r e l a t i ʋ ǐ t eː t
аналитичар	a n a l ǐ t i t͡ʃ aː r
клизати	k l ǐː z a t i
amortizacija	a m o r t i z ǎː t͡s i j a
teatar	t e ǎː t a r
квартално	k ʋ ǎ r t aː l n o
лов	l ôː ʋ
оргија	ǒ r ɡ i j a
konverzacija	k o n ʋ e r z ǎː t͡s i j a
кошаркаш	k o ʃ ǎ r k aː ʃ
узбуђеност	ǔ z b uː d͡ʑ e n oː s t
бала	b â l a
neumeren	n e ǔ m e r e n
луталац	l ǔː t a l a t͡s
биљежити	b ǐ ʎ e ʒ i t i
расправљати	r ǎ s p r a ʋ ʎ a t i
sarma	s ǎ r m a
snježan	s ɲ ê ʒ a n
koriti	k ǒ r i t i
nedjeljiv	n e d j ě ʎ i ʋ
претопити	p r e t ǒ p i t i
predodžba	p r ě d o d͡ʒ b a
укрштати	u k řː ʃ t a t i
labav	l â b a ʋ
ојачавати	o j a t͡ʃ ǎː ʋ a t i
dol	d ôː l
тешити	t ê ʃ i t i
Skoplje	s k ô p ʎ e
slaboumnost	s l a b o ǔː m n oː s t
domorodac	d o m o r ǒː d a t͡s
sednica	s ê d n i t͡s a
граматичар	ɡ r a m ǎ t i t͡ʃ aː r
delikatno	d ê l i k aː t n o
dvojina	d ʋ o j ǐ n a
poznavati	p o z n ǎː ʋ a t i
pučina	p ǔ t͡ʃ i n a
kalkulirati	k a l k u l ǐː r a t i
безгрешно	b ě z ɡ r e ʃ n o
забољети	z a b ǒ ʎ e t i
zagrađivati	z a ɡ r a d͡ʑ ǐː ʋ a t i
слаткорјечив	s l a t k o r j ě t͡ʃ i ʋ
akov	ǎ k o ʋ
žabica	ʒ â b i t͡s a
етнологија	e t n o l ǒ ɡ i j a
individualnost	i n d i ʋ i d u ǎː l n oː s t
зацијело	z â t͡s i j eː l o
истосмеран	î s t o s m eː r a n
iznositi	i z n ǒ s i t i
темељито	t e m ě ʎ i t o
inaugurirati	i n a u ɡ u r ǐː r a t i
kamenac	k a m ěː n a t͡s
samotan	s â m o t a n
epitaf	e p ǐ t a f
судац	s ǔː d a t͡s
таласаст	t a l ǎ s a s t
стабилизација	s t a b i l i z ǎː t͡s i j a
glodati	ɡ l ǒ d a t i
ратарство	r a t ǎː r s t ʋ o
plavojka	p l ǎ ʋ oː j k a
пелуд	p ě l u d
шваља	ʃ ʋ â ʎ a
обао	ô b a o
groziti	ɡ r ǒ z i t i
iseljavati	i s e ʎ ǎː ʋ a t i
hijerarhijski	x i j e r ǎ r x iː j s k iː
досетљиво	d o s ě t ʎ i ʋ o
nasmejavati	n a s m e j ǎː ʋ a t i
адмирал	a d m ǐ r aː l
штосдемфер	ʃ t ôː s d e m f e r
дунстати	d û n s t a t i
примјерно	p r ǐː m j e r n o
marama	m ǎ r a m a
јечам	j ě t͡ʃ a m
tobdžija	t ǒ b d͡ʒ i j a
upisati	u p ǐː s a t i
објашњење	o b j a ʃ ɲ ěː ɲ e
Флорида	f l ǒ r i d a
smeon	s m ě o n
шмук	ʃ m û k
krakatost	k r ǎ k a t oː s t
самозаштита	s a m o z ǎ ʃ t i t a
пешице	p ê ʃ i t͡s eː
еротичан	e r ǒ t i t͡ʃ a n
бетонски	b ě t oː n s k iː
козјетина	k ǒ z j e t i n a
ситница	s i t n ǐ t͡s a
девастација	d e ʋ a s t ǎː t͡s i j a
примјењивати	p r i m j e ɲ ǐː ʋ a t i
guliti	ɡ ǔː l i t i
очекивање	o t͡ʃ e k ǐː ʋ aː ɲ e
гошће	ɡ ǒ ʃ t͡ɕ e
шафран	ʃ ǎ f r a n
замерљив	z a m ě r ʎ i ʋ
водопија	ʋ o d ǒ p i j a
Beotija	b e ǒ t i j a
злокобан	z l ǒ k o b a n
саламандар	s a l a m ǎ n d a r
temporalan	t ê m p o r aː l a n
beznadan	b ě z n a d a n
bokserice	b ô k s e r i t͡s e
neopozivo	n e o p ǒ z i ʋ o
салаш	s ǎ l aː ʃ
линеарно	l î n e aː r n o
lečiti	l ěː t͡ʃ i t i
новорођен	n o ʋ o r ǒ d͡ʑ e n
фашизам	f a ʃ ǐ z a m
неуроза	n e u r ǒː z a
špiccange	ʃ p î t͡s t͡s aː n ɡ e
Мјесец	m j ê s eː t͡s
perje	p êː r j e
скалпирати	s k a l p ǐː r a t i
puščani	p ǔ ʃ t͡ʃ a n iː
odustajati	o d ǔ s t a j a t i
izobličavati	i z o b l i t͡ʃ ǎː ʋ a t i
iskvariti	i s k ʋ ǎː r i t i
škrtost	ʃ k r̂ t oː s t
istinoljublje	î s t i n o ʎ uː b ʎ e
капиталан	k â p i t aː l a n
ispostavljati	i s p ǒ s t a ʋ ʎ a t i
прекидати	p r e k ǐː d a t i
preplaćivati	p r e p l a t͡ɕ ǐː ʋ a t i
пробуђивати	p r o b u d͡ʑ ǐː ʋ a t i
pogodan	p ô ɡ o d a n
derište	d ê r iː ʃ t e
belac	b ěː l a t͡s
пискати	p î s k a t i
okruženje	o k r u ʒ ěː ɲ e
refraktor	r ě f r a k t o r
košnuti	k ô s n u t i
ослонити	o s l ǒ n i t i
apscisa	a p s t͡s ǐ s a
sakatost	s ǎ k a t oː s t
фрустрација	f r u s t r ǎː t͡s i j a
побеђивати	p o b e d͡ʑ ǐː ʋ a t i
брбљав	b r̂ b ʎ a ʋ
Британија	b r ǐ t aː n i j a
bezizražajno	b ê z i z r a ʒ aː j n o
dogovor	d ô ɡ o ʋ oː r
кравујац	k r a ʋ ǔː j a t͡s
гласник	ɡ l âː s n iː k
krivovjerstvo	k r i ʋ ǒ ʋ j eː r s t ʋ o
прољеће	p r ǒ ʎ e t͡ɕ e
izricati	i z r ǐː t͡s a t i
бактериолог	b a k t e r i ǒ l o ɡ
poznatost	p ô z n aː t oː s t
usluga	û s l u ɡ a
sedmerac	s e d m ěː r a t͡s
ирационализам	i r a t͡s i o n a l ǐ z a m
жабљи	ʒ â b ʎ iː
проучавање	p r o u t͡ʃ ǎː ʋ aː ɲ e
birtija	b ǐ r t i j a
расплакивати	r a s p l a k ǐː ʋ a t i
губитница	ɡ ǔ b i t n i t͡s a
safer	s ǎ f e r
platina	p l ǎ t i n a
козоношка	k o z ǒ n o ʃ k a
Саксонија	s ǎ k s oː n i j a
промишљеност	p r ǒ m i ʃ ʎ e n oː s t
подао	p ô d a o
размак	r ǎː z m a k
рудлавост	r û d l a ʋ oː s t
sućut	s û t͡ɕ uː t
источни	ǐ s t o t͡ʃ n iː
притисак	p r ǐ t i s a k
утјешно	ǔ t j e ʃ n o
flatulencija	f l a t u l ě n t͡s i j a
diskreditirati	d i s k r e d i t ǐː r a t i
hefta	x ě f t a
срдачност	s r̩̂ d aː t͡ʃ n oː s t
литургијски	l i t ǔ r ɡ iː j s k iː
negator	n ě ɡ aː t o r
јарки	j âː r k iː
masturbirati	m a s t u r b ǐː r a t i
vrhunski	ʋ ř x uː n s k iː
анестезија	a n e s t ě z i j a
zlo	z l ô
свагдашњи	s ʋ ǎ ɡ d a ʃ ɲ iː
селендра	s ě l eː n d r a
krdžalija	k r̂ d͡ʒ a l i j a
krhati	k r̂ x a t i
Америка	a m ě r i k a
оружје	ǒ r uː ʒ j e
mliječnjak	m l i j êː t͡ʃ ɲ aː k
kontemplativan	k ô n t e m p l a t iː ʋ a n
трауматолог	t r a u m a t ǒ l o ɡ
bežati	b ě ʒ a t i
nevešt	n ě ʋ e ʃ t
praznični	p r âː z n i t͡ʃ n iː
шармирати	ʃ a r m ǐː r a t i
zelenaš	z e l ě n aː ʃ
разумно	r â z uː m n o
пласирати	p l a s ǐː r a t i
dotepuh	d o t ě p uː x
neredovit	n e r e d ǒ ʋ i t
написати	n a p ǐː s a t i
рано	r â n o
расходовати	r ǎː s x o d o ʋ a t i
масив	m ǎ s iː ʋ
тактички	t ǎ k t i t ʃ k iː
неуспело	n ê u s p e l o
crvojedina	t͡s r ʋ ǒ j e d i n a
бибер	b ǐ b e r
prijedložni	p r i j ěː d l o ʒ n iː
застајати	z ǎ s t a j a t i
медвед	m ě d ʋ e d
tvrtka	t ʋ r̂ t k a
masnica	m ǎ s n i t͡s a
окрутан	ô k r uː t a n
биљар	b ǐ ʎ aː r
избечити	i z b ěː t͡ʃ i t i
фокус	f ǒː k u s
унија	ûː n i j a
glogov	ɡ l ǒ ɡ o ʋ
prepoznati	p r e p ǒ z n a t i
rastvoriti	r a s t ʋ ǒ r i t i
ефикасан	ê f i k a s a n
одважност	ô d ʋ aː ʒ n oː s t
компетентно	k o m p e t ě n t n o
голишавац	ɡ o l ǐ ʃ a ʋ a t͡s
нељудски	n ê ʎ u d s k iː
šnešlager	ʃ n êː ʃ l aː ɡ e r
напећи	n ǎ p e t͡ɕ i
predlagati	p r e d l ǎː ɡ a t i
primjetljiv	p r i m j ě t ʎ i ʋ
precizno	p r ê t͡s iː z n o
sredstvo	s r ě d s t ʋ o
шписбиргер	ʃ p îː s b i r ɡ e r
пламенац	p l a m ěː n a t͡s
patnik	p â t n iː k
пепељаст	p ê p e ʎ a s t
debeo	d ě b e o
гондолијер	ɡ o n d o l ǐ j eː r
течан	t ê t͡ʃ a n
слепоочни	s l e p ǒ o t͡ʃ n iː
траса	t r â s a
kanibal	k ǎ n i b a l
tračara	t r ǎ t͡ʃ a r a
бос	b ôː s
сперма	s p ě r m a
пучина	p ǔ t͡ʃ i n a
Кострењанин	k o s t r ěː ɲ a n i n
tekstopisac	t e k s t o p ǐː s a t͡s
bačvar	b â t͡ʃ ʋ aː r
bezemljaš	b e z ě m ʎ aː ʃ
поравнавати	p o r a ʋ n ǎː ʋ a t i
industrijski	i n d ǔ s t r iː j s k iː
podsticati	p ǒ d s t i t͡s a t i
кострет	k ô s t r eː t
nesamostalno	n ê s a m o s t aː l n o
neznanje	n e z n ǎː ɲ e
пантљика	p ǎ n t ʎ i k a
прометејски	p r o m ě t e j s k iː
motka	m ô t k a
finansije	f i n ǎ n s i j e
негативан	n ê ɡ a t iː ʋ a n
мисал	m ǐ s aː l
грудњак	ɡ r ûː d ɲ aː k
органски	ǒ r ɡ aː n s k iː
причекати	p r ǐ t͡ʃ e k a t i
бувљак	b ǔ ʋ ʎ aː k
beglajter	b e ɡ l ǎ j t e r
упијати	u p ǐː j a t i
taktika	t ǎ k t i k a
kompromis	k o m p r ǒ m i s
прозивати	p r o z ǐː ʋ a t i
vetar	ʋ ê t a r
jezgro	j ěː z ɡ r o
imaginarno	î m a ɡ i n aː r n o
barem	b ǎ r e m
pripovedač	p r i p o ʋ ě d aː t͡ʃ
романтизам	r o m a n t ǐ z a m
obrisati	ǒ b r i s a t i
наткрилити	n a t k r ǐː l i t i
примаран	p r î m aː r a n
стручан	s t r û t͡ʃ a n
poremećivati	p o r e m e t͡ɕ ǐː ʋ a t i
пажљивост	p ǎ ʒ ʎ i ʋ oː s t
lisa	l î s a
упадљив	u p ǎ d ʎ i ʋ
hrabriti	x r ǎː b r i t i
šogor	ʃ ôː ɡ o r
научан	n ǎː u t͡ʃ a n
ormar	ǒ r m aː r
многостран	m n o ɡ ǒ s t r a n
зборник	z b ôː r n iː k
kovanica	k o ʋ ǎ n i t͡s a
воз	ʋ ôː z
upošljavati	u p o ʃ ʎ ǎː ʋ a t i
indolentnost	i n d o l ě n t n oː s t
услован	ǔː s l oː ʋ a n
крчмарски	k r̂ t͡ʃ m a r s k iː
lagodnost	l â ɡ o d n oː s t
некорисност	n ê k o r i s n oː s t
врба	ʋ řː b a
Данац	d ǎː n a t͡s
svlačiti	s ʋ l ǎː t͡ʃ i t i
tata	t â t a
корпулентан	k o r p u l ě n t a n
penjač	p ě ɲ aː t͡ʃ
obavezati	o b a ʋ ěː z a t i
albanolog	a l b a n ǒ l o ɡ
сакристија	s a k r ǐ s t i j a
затворен	z ǎ t ʋ o r e n
muškobanja	m u ʃ k ǒ b a ɲ a
bomba	b ôː m b a
iznervirati	i z n e r ʋ ǐː r a t i
promisliti	p r ǒ m i s l i t i
probava	p r ô b a ʋ a
krnjav	k r̂ ɲ a ʋ
procent	p r ǒ t͡s e n t
arhiepiskop	a r x i ě p i s k o p
изоштрити	i z ǒ ʃ t r i t i
neobično	n ê o b i t͡ʃ n o
neutralizirati	n e u t r a l i z ǐː r a t i
gotica	ɡ ǒ t i t͡s a
уклонити	u k l ǒ n i t i
listati	l ǐ s t a t i
ножица	n ǒ ʒ i t͡s a
лимарски	l î m a r s k iː
битка	b î t k a
oronuo	o r ǒ n u o
граничити	ɡ r ǎ n i t͡ʃ i t i
pudl	p ǔː d l
kutija	k ǔ t i j a
ogled	ô ɡ l eː d
kosturnica	k ǒ s t uː r n i t͡s a
поткријепити	p o t k r j ěː p i t i
равномјеран	r â ʋ n o m j eː r a n
atmosfera	a t m o s f ěː r a
површан	p ǒ ʋ r ʃ a n
страница	s t r ǎ n i t͡s a
ovđe	ǒː ʋ d͡ʑ e
triler	t r î l e r
sjediniti	s j e d ǐː n i t i
hidrat	x ǐ d r aː t
неуставан	n ê u s t aː ʋ a n
гигантски	ɡ ǐ ɡ a n t s k iː
predati	p r ě d a t i
dadaist	d a d ǎ i s t
slično	s l ǐ t͡ʃ n o
špajz	ʃ p â j z
ринути	r ǐ n u t i
razumno	r â z uː m n o
postariji	p ô s t a r i j iː
obedovati	ǒ b e d o ʋ a t i
apsorbirati	a p s o r b ǐː r a t i
бруталан	b r û t aː l a n
багер	b ǎː ɡ e r
vrijeme	ʋ r i j ěː m e
привјесак	p r ǐː ʋ j e s a k
zavetrina	z ǎː ʋ e t r i n a
бедно	b êː d n o
зеугма	z e ǔ ɡ m a
haićanski	x a ǐː t͡ɕ a n s k iː
roba	r ô b a
uspeh	ǔ s p e x
tranzitoran	t r â n z i t oː r a n
fikcija	f ǐ k t͡s i j a
pička	p î t͡ʃ k a
najednom	n a j ě d n oː m
šuštar	ʃ û ʃ t aː r
подмукло	p ǒ d m uː k l o
kozarenje	k o z ǎː r eː ɲ e
калкулатор	k a l k ǔ l aː t o r
vojvotkinja	ʋ ǒ j ʋ o t k i ɲ a
коничан	k ǒ n i t͡ʃ a n
obestan	ô b eː s t a n
регула	r ê ɡ u l a
sibilant	s i b ǐ l a n t
verenik	ʋ ê r e n iː k
fotografija	f o t o ɡ r ǎ f i j a
деби	d ě b iː
слобода	s l o b ǒ d a
аналфабетизам	a n a l f a b e t ǐ z a m
шогорица	ʃ o ɡ ǒ r i t͡s a
kreketavo	k r e k ě t a ʋ o
plod	p l ôː d
nemogućnost	n e m o ɡ ǔː t͡ɕ n oː s t
пљувачка	p ʎ ǔ ʋ a t͡ʃ k a
шепав	ʃ ê p a ʋ
egzaltacija	e ɡ z a l t ǎː t͡s i j a
snebiti	s n ě b i t i
разговор	r â z ɡ o ʋ oː r
stojećke	s t ǒ j eː t͡ɕ k e
архитектица	a r x ǐ t e k t i t͡s a
ptičji	p t î t͡ʃ j iː
pokrasti	p ǒ k r a s t i
odbrambeni	ǒ d b r a m b e n iː
ананас	â n a n a s
свуд	s ʋ û d
smalaksati	s m a l ǎ k s a t i
lokacija	l o k ǎː t͡s i j a
sanjar	s ǎ ɲ aː r
nerazborit	n e r ǎː z b o r i t
