kebut	k ə ˈb ʊ t̚
balur	ˈb a l ʊ r
demang	d ə ˈm a ŋ
musang	ˈm u s a ŋ
bozah	ˈb o z a h
tirani	t i . ˈr a . n i
membantah	m ə m . b a n . t a h
ester	ˈɛ s . t ə r
parang	ˈp a r a ŋ
bangsat	b a ŋ . s a t
menara	m ə ˈn a r a
andalas	a n . ˈd a . l a s
etana	e . t a . n a
sepur	s ə ˈp u r
prei	p r e i
KPK	k a ˈp e k a
transparansi	t r a n s p a ˈr a n s i
menggali	m ə ŋ . ɡ a . l i
qasar	ˈq a . s a r
ambekdarma	a m b ə k̚ ˈd a r m a
taksir	ˈt a k̚ s ɪ r
galat	ˈɡ a l a t̚
alferes	a l ˈf e r e s
balobo	b a ˈl o b o
bagel	ˈb a ɡ ə l
informatif	ɪ n f ɔ r ˈm a t ɪ f
akselerator	a k . s e . l ə . ˈr a . t ɔ r
membangunkan	m ə m b a ˈŋ ʊ n k a n
akil	a . k ɪ l
paroki	p a . r o . k i
keempat	k ə ˈə m p a t
perobatan	p ə r ˈɔ b a t a n
pronomina	p r o . n o . ˈm i . n a
petrus	p ə ˈt r ʊ s
arti	a r . t i
puntung	p ʊ n t ʊ ŋ
lapar	ˈl a p a r
mukjizat	m ʊ ʔ ˈd͡ʒ i z a t̚
penghulu	p ə ŋ . ˈh u . l u
katoda	k a . t o . d a
L	ɛ l
ribosom	r i ˈb o s ɔ m
lengkung	l ə ŋ . ˈk ʊ ŋ
berakhiran	b ə r a ˈx ɪ r a n
sekrup	s ə . k r u p
eksim	ˈɛ k . s ɪ m
pangkat	ˈp a ŋ k a t̚
feodal	f e ˈo d a l
maklumat	m a ʔ ˈl u m a t̚
darma	d a r . m a
umat	ˈu m a t̚
kuas	ˈk u a s
BBLR	b e b e ˈɛ l ɛ r
kelurahan	k ə . l u . ˈr a h . a n
glikogen	ɡ l i ˈk o ɡ ɛ n
anglo	a ŋ . l o
bersihan	b ə r . ˈs ɪ h . a n
pertahanan	p ə r t a ˈh a n a n
malem	m a . l ə m
tuas	t u a s
bendu	b ə n . ˈd u
daun	ˈd a ʊ n
hutan	ˈh u t a n
akademi	a k a . d e . m i
karam	ˈk a . r a m
PHBS	p e h a ˈb e ɛ s
mancanegara	m a n . t͡ʃ a . n ə ˈɡ a . r a
ompol	ˈo m . p o l
cuat	ˈt͡ʃ u . a t
nirharapan	n i r h a r a p a n
rela	ˈr e . l a
akeo	a k e o
lebar	ˈl e b a r
sarapan	s a ˈr a p̚ a n
videografer	v i d e o ˈɡ r a f ə r
angrem	a ŋ r ə m
gelis	ɡ ə . ˈl ɪ s
bekintangon	b ɛ k ɪ n ˈt a ŋ ɔ n
khilafah	x i . l a . f a h
beledu	b ə l ə d u
mengamankan	m ə ŋ ˈa m a n k a n
sebentar	s ə ˈb ə n t a r
memperaman	m ə m p ə r ˈa m a n
adorasi	a . d o . ˈr a . s i
ensambel	ɛ n ˈs a m b ə l
hadiah	h a ˈd i j a h
mengubah	m ə ˈŋ u b a h
tayamum	t a ˈj a m ʊ m
kontestan	k ɔ n ˈt ɛ s t a n
meritokratis	m e . r i . t o . ˈk r a . t ɪ s
menyatakan	m ə ɲ a ˈt a k a n
perembesan	p ə . r ə m . b ə s . ˈa n
kopi	k o . p i
berapa	b ə . r a . p a
kepatuhan	k ə . p a . ˈt ʊ h . a n
penggalian	p ə ŋ ˈɡ a l i a n
Belanda	b ə . l a n . d a
maktub	ˈm a k t u b
Sarawak	s a ˈr a w a ʔ
amra	a m r a
permukaan	p ə r . m u . k a . a n
diet	ˈd i e t̚
pleidoi	ˈp l e i . d o i̯
suara	s u . ˈw ä . r ä
kuilu	k u ˈi . l u
kelarutan	k ə . l a . r u . t a n
lelang	ˈl ɛ l a ŋ
anjang	ˈa n d͡ʒ a ŋ
sabar	ˈs a b a r
mu	m u
rambut	ˈr ä m . b u t̪̚
ipar	ˈi p a r
memberikan	m ə m b ə r i k a n
laku	ˈl a k u
materai	m a . t ə . r a i
segel	s ɛ ɡ ə l
perkataan	p ə r . k a . ˈt a . a n
dosa	d o s a
degeneratif	d e ɡ e n ə ˈr a t ɪ f
anggap	ˈa ŋ ɡ a p̚
antunga	a n . ˈt u . ŋ a
adicita	a d i ˈt͡ʃ i t a
ꦢꦺꦱ	d e . s ɔ
gilik	ˈɡ i l ɪ k̚
angsana	a ŋ ˈs a n a
piama	p i ˈa m a
adipenghantar	a d i p ə ŋ ˈh a n t a r
amane	ˈa m a n ɛ
harapan	h a . ˈr a p . a n
antarbahasa	a n t a r b a ˈh a s a
Surakarta	s u r a k a r t a
mengumpamakan	m ə ŋ u m p a m a k a n
romansa	r o ˈm a n s a
khawatir	x a ˈw a t ɪ r
toksik	ˈt ɔ k . s ɪ k
JPU	d͡ʒ e ˈp e u
akatopi	a k a ˈt o p i
adijana	a . d i . ˈd͡ʒ a . n a
averoisme	a . v e . r o . ˈɪ s . m ə
tamadun	t a . ˈm a . d ʊ n
abalalu	a b a ˈl a l u
taklimat	t a ʔ ˈl i m a t̚
badak	ˈb a . d a ʔ
amiug	ˈa m i ʊ k̚
ekor	ɛ . k o r
terkenal	t ə r k ə n a l
nah	n a h
balai	ˈb a l a i̯
penguat	p ə ˈŋ u a t
rasio	ˈr a s i o̯
lasik	l a . s i k
ampal	ˈa m p a l
gap	ˈɡ a p
konpers	ˈk ɔ n p ɛ r s
komet	ˈk o . m ɛ t̚
bodok	ˈb o d ɔ k̚
kiai	ˈk i a i̯
silabis	s i . ˈl a . b ɪ s
gaul	ɡ a u l
sabun	ˈs a b ʊ n
pelopor	p ə ˈl o p ɔ r
perak	ˈp e . r a k
awak	a w a k
alumpa	ˈa l ʊ m p a
amplek	ˈa m p l ɛ k̚
ulun	ˈu l u n
apa	a p a
hama	ˈh a m a
ayo	a ˈj o
deduktif	d e ˈd ʊ k t ɪ f
semong	s ə ˈm ɔ ŋ
anaria	a . n a . ˈr i . a
rahayu	r a ˈh a j u
adat	a . d a t
regu	r ə ˈɡ u
mesjid	m ə s ˈd͡ʒ ɪ t̚
etik	ˈɛ t ɪ k
banyak	b a ɲ a k
pelapukan	p ə . l a . ˈp ʊ k . a n
padi	p a d i
imprimatur	i m p r i m a t u r
mitos	m i t o s
pertumbuhan	p ə r t ʊ m ˈb ʊ h a n
babo	ˈb a . b o
memindai	m ə . m i n . d a i̯
bibir	ˈb ɪ . b ɪ r
sementara	s ə m ə n ˈt a r a
merusak	m ə r u s a ʔ
cakram	t͡ʃ a k . r a m
amati	a . ˈm a . t i
resleting	r e s . l ɛ . t i ŋ
turun	ˈt u . r ʊ n
KTP	k a t ɛ ˈp ɛ
adaptif	ˈa d a p . t ɪ f
lahir	ˈl a . h ɪ r
kehakiman	k ə . h a . ˈk ɪ m . a n
pergelaran	p ə r . ɡ ə . ˈl a r . a n
pembilang	p ə m ˈb i l a ŋ
aktivitas	a k̚ t i v i t a s
syah	ʃ a h
harimau	h a ˈr i m a u̯
kaftan	ˈk a f t a n
berantas	b ə ˈr a n t a s
konfeti	k o n . f e . t i
informasi	i n f ɔ r m a s i
independen	i n . d ə . p ɛ n . d ə n
bhayangkara	b a . j a ŋ . k a . r a
halia	h a l i a
gimnasium	ɡ ɪ m n a ˈs i ʊ m
Palu	p a . l u
redundansi	r e . d ʊ n . ˈd a n . s i
BNN	b e ˈɛ n ɛ n
voucer	ˈv o u̯ t͡ʃ ə r
barongsai	b a . r o ŋ . s a i̯
halusinasi	h a l u s i ˈn a s i
amanra	ˈa m a n r o
kadaster	k a d a s t ə r
kelab	k ə l a b
perhentian	p ə r ˈh ə n t j a n
cagar	ˈt͡ʃ a . ɡ a r
nafiri	n a ˈf i r i
asbabulwurud	a s . b a . b ʊ l . ˈw u . r ʊ t
penuntut	p ə . n u n . t ʊ t
Maryam	ˈm a r . j a m
piadah	p i ˈa d a h
magnet	ˈm a k . n ɛ t
ubin	ˈu b i n
seratus	s ə ˈr a t ʊ s
ꦱꦺꦧ	s e b a
kakak	k a . k a ʔ
protein	p r o ˈt e ɪ n
gagak	ˈɡ a . ɡ a ʔ
kuintal	ˈk w i n t a l
pencucian	p ə n t͡ʃ u t͡ʃ iʲ a n
perban	p ə r . b a n
panekuk	p a . n ə . k u k
kitas	k i . t a s
menghasilkan	m ə ŋ h a s i l k a n
sabit	ˈs a b ɪ t̚
ustaz	ˈʊ s t a z
seprai	s ə p . r a i
kabur	k a . b ʊ r
lensa	l ɛ n s a
umur	u m ʊ r
retensi	r ə . t ɛ n . s i
alpukat	a l p u k a t
anyir	a ɲ ɪ r
Wates	ˈw a t ə s
giro	ɡ i r o
gua	ɡ u a
cogan	t͡ʃ o . ɡ a n
bapak	b a p a ʔ
hadirin	h a ˈd i r ɪ n
magnitudo	m a k n i ˈt u d o
kelinci	k ə ˈl ɪ n . t͡ʃ i
amputan	a m ˈp ʊ t a n
Saka	s a k a
PPDB	p e . p e . d e . b e
ambulralra	a m b ʊ l ˈr a l r a
gerus	ɡ ə . ˈr ʊ s
sipil	s i p ɪ l
angkruk	ˈa ŋ k r ʊ k̚
śāsana	s a . s a . n a
bam	ˈb a m
profesor	p r o ˈf ɛ . s ɔ r
aktifitas	a k̚ t i f i t a s
acar	ˈa t͡ʃ a r
tiri	ˈt i r i
urut	ˈu r u t
demografis	d e m o ˈɡ r a f ɪ s
manuver	m a . ˈn u . v ə r
mendung	m ə n d u ŋ
ꦲꦤ	ɔ n ɔ
semah	s ə ˈm a h
rekonsiliasi	r e . k ɔ n . s i . l i . ˈa . s i
lembar	l ə m b a r
kanji	k a n . d͡ʒ i
sendawa	s ə n . d a . w a
erotis	ˈɛ r o t ɪ s
holistis	h o . ˈl ɪ s . t ɪ s
membeli	m ə m . b e . l i
alwah	ˈa l w a h
badul	ˈb a . d ʊ l
rujak	ˈr u d͡ʒ a ʔ
ortu	o r . t u
parlementer	p a r l ə m ɛ n t ɛ r
bunting	b ʊ n . t ɪ ŋ
pastor	p a s t o r
memimpin	m ə ˈm ɪ m p ɪ n
campur	t͡ʃ a m . p ʊ r
bandung	ˈb a n . d ʊ ŋ
empiris	ɛ m ˈp i r ɪ s
takut	t a . k u t
kedatangan	k ə ˈd a t a ŋ a n
loket	a b o n ə m ɛ n
Antartika	a n t a r ˈt i k a
Denmark	ˈd ɛ n m a r k
spesifisitas	s p e s i f i ˈs i t a s
pemulangan	p ə . m u . ˈl a ŋ . a n
pengawasan	p ə ŋ a ˈw a s a n
anting	a n t i ŋ
hikmah	h i k m a h
ikan	i k a n
datuk	ˈd a t ʊ k̚
rem	ˈr ɛ m
ahin	ˈa h ɪ n
mudigah	m u ˈd i ɡ a h
tadarus	t a d a r u s
masakan	m a ˈs a k̚ a n
suami	ˈs u a̯ . m i
mengemban	m ə ŋ ə m ˈb a n
menganiayai	m ə ŋ a n i a j a i
punia	p u . n i a̯
dakwaan	d a ʔ ˈw a a n
Waruna	w a . r u . n a
keramat	k ə ˈr a m a t̚
babka	ˈb a p . k a
tafsir	ˈt a f s ɪ r
terung	t ə . ˈr ʊ ŋ
asinkron	a . ˈs ɪ n . k r ɔ n
Italia	ɪ ˈt a l i a̯
boikot	ˈb o i̯ k ɔ t̚
faktor	ˈf a k̚ t ɔ r
iklim	i k . l ɪ m
amo	ˈa m o
jijik	d͡ʒ i . d͡ʒ ɪ ʔ
kongruen	k ɔ n . ˈɡ r u . ɛ n
parut	ˈp a . r ʊ t
hiperaktivitas	h i . p ə r . a k . t i . ˈv i . t a s
erti	ə r . t i
swatantra	s ʋ a t a n t r a
tanda	ˈt a n d a
muda	m u . d a
am	ˈa m
gelut	ɡ ə . ˈl ʊ t
ambo	ˈa m . b o
tabal	ˈt a . b a l
elipsis	e . ˈl ɪ p . s ɪ s
kamuflase	k a m u f l a s ə
angkutan	a ŋ ˈk ʊ t a n
penerimaan	p ə . n ə . r i . ˈm a . a n
elektromagnetisme	ɛ l ɛ k t r o m a k n ɛ t ˈɪ s m ə
lipur	l i . p ʊ r
audite	a u̯ . ˈd i . t e
tiram	ˈt i r a m
kepada	k ə ˈp a d a
anta	ˈa n t a
permutasi	p ə r m u ˈt a s i
gabah	ˈɡ a b a h
cendana	t͡ʃ ə n . d a . n a
slang	s ə l a ŋ
balot	b a l ɔ t̚
gilap	ˈɡ i l a p̚
linear	l i ˈn ɛ a r
kertas	k ə r ˈt a s
anggal	ˈa ŋ . ɡ a l
dinamis	d i ˈn a m ɪ s
perambah	p ə r a m b a h
badam	ˈb a d a m
angsang	ˈa ŋ s a ŋ
standardisasi	s t a n . d a r . d i . s a . s i
sandung	ˈs a n d ʊ ŋ
aliran	a . ˈl ɪ r . a n
unta	ˈʊ n t a
transparan	t r a n s ˈp a r a n
takraw	ˈt a k̚ . r a w
film	ˈf ɪ l ə m
gambus	ˈɡ a m . b ʊ s
bang	b a ŋ
hembus	h ə m ˈb u s
kesegarisan	k ə . s ə . ɡ a . ˈr ɪ s . a n
akresi	a . ˈk r e . s i
kerbau	k ə r b a u̯
kehidupan	k ə . h i . ˈd ʊ p . a n
adiwastra	a d i ˈw a s t r a
berubah	b ə r ˈʊ b a h
bahtera	b a h . t ə . r a
alokai	ˈa l o k a i̯
baftah	ˈb a f t a h
tabut	ˈt a b ʊ t̚
s'lalu	s l a . l u
pita	p i . t a
albatros	a l . ˈb a . t r ɔ s
kandungan	k a n ˈd ʊ ŋ a n
oksimeter	ɔ k̚ s i ˈm ɛ t ə r
instrumentasi	ɪ n . s t r u . m ɛ n . ˈt a . s i
membakar	m ə m . b a . k a r
umbi	ˈʊ m . b i
l	ɛ l
bayam	ˈb a . j a m
influen	ɪ n ˈf l u ɛ n
kajur	ˈk a d͡ʒ u r
lestari	l ə s . ˈt a . r i
ari	ˈa . r i
kontestasi	k ɔ n t ɛ s ˈt a s i
kabus	k a b ʊ s
daster	ˈd a s t ɛ ɾ
televisi	t e l e v i s i
isu	ˈɪ s u
sedawa	s ə . d a . w a
ampul	a m . p ʊ l
d	d e
awat	a . w a t
pasang	ˈp a . s a ŋ
bantahan	b a n ˈt a h a n
pengucapan	p ə ŋ . u . ˈt͡ʃ a p . a n
anaye	ˈa n a j ɛ
keasaman	k ə a ˈs a m a n
karnivora	k a r n i ˈv o r a
rakyat	ˈr a k j a t
klub	ˈk l u p
tanya	t a . ɲ a
unggul	u ŋ ɡ ʊ l
imperialisme	ɪ m p ɛ r i a ˈl ɪ s m ə
peria	p ə ˈr i a̯
pokok	ˈp o k ɔ k̚
arjer	ˈa r . d͡ʒ ɛ r
prematur	p r e . ˈm a . t ʊ r
kumico	k u . m i . t͡ʃ o
beban	b ə ˈb a n
kemacetan	k ə m a t͡ʃ ə t ˈa n
tambur	ˈt a m b ʊ r
daur	ˈd a ʊ r
penanda	p ə n a n d a
lakon	ˈl a k ɔ n
hitung	ˈh i t ʊ ŋ
awar	ˈa w a r
turus	ˈt u . r ʊ s
kitab	ˈk i . t a p̚
pemilik	p ə ˈm i l ɪ ʔ̚
henti	h ə n̪ . ˈt̪ i
hanya	h a . ɲ a
memodernkan	m ə . m o . d ɛ r n . k a n
antum	ˈa n t ʊ m
disebar	d i s ə ˈb a r
ampa	ˈa m p a
berbicara	b ə r b i t͡ʃ a r a
dipantau	d i ˈp a n t a u̯
kompetisi	k ɔ m p ə ˈt i s i
memencar	m ə ˈm ə n t͡ʃ a r
sublimasi	s ʊ p l i ˈm a s i
mufasir	m u f a s ɪ r
buana	b u a̯ . n a
praktik	ˈp r a k̚ t ɪ k̚
SHUN	ɛ s h a ˈu ɛ n
fatamorgana	f a t a m ɔ r ˈɡ a n a
agmaman	a ɡ ˈm a m a n
enzim	ˈɛ n . z ɪ m
lulusan	l u ˈl ʊ s a n
nasi	ˈn a s i
antrap	ˈa n t r a p̚
PDIP	p ɛ d ɛ i ˈp ɛ
kaki	ˈk ä . k i
adenopati	a . d ə . n o . ˈp a . t i
intensi	i n t ɛ n s i
Maroko	m a . ˈr o . k o
lazuardi	l a z u a r d i
tegap	t ə ˈɡ a p̚
tidak	ˈt i . d a k
pelacur	p ə . l a . t͡ʃ ʊ r
persada	p ə r . s a . d a
tanggapan	t a ŋ . ɡ a . p a n
patik	ˈp a . t ɪ k
karateka	k a . r a . t e . k a
gula	ˈɡ u . l a
verano	v e ˈr a n o
amfibi	a m ˈf i b i
humanisme	h u . m a . ˈn ɪ s . m ə
gerha	ɡ ə r . h a
adenosina	a . d e . n o . ˈs i . n a
prinsip	ˈp r ɪ n s ɪ p̚
bakpia	b a ʔ p i a̯
spesies	s p ɛ . ˈs i . ɛ s
kokoh	ˈk o k ɔ h
ribu	ˈr i b u
Nyepi	ɲ ə ˈp i
hantu	ˈh a n . t u
warak	ˈw a . r a k
marmer	ˈm a r m ə r
asam	ˈa s a m
seterika	s ə . t ə . r i . k a
beber	ˈb ɛ b ɛ r
takal	ˈt a . k a l
dinamika	d i n a ˈm i k a
gita	ɡ i . t a
meong	ˈm e . o ŋ
sulit	ˈs u l ɪ t̚
tumbuh	ˈt ʊ m b ʊ h
antimikroba	a n t i m i ˈk r o b a
umi	ˈʊ m i
angki	ˈa ŋ k i
kumulatif	k u m u ˈl a t ɪ f
insaf	i n . s a f
ate	ˈa . t e
ikhlas	i x l a s
nepotisme	n e p ɔ t̚ ˈɪ s m ə
difraksi	d i . ˈf r a k . s i
semaya	s ə ˈm a j a
ancaman	a n . t͡ʃ a . m a n
urbanisasi	ʊ r b a n i ˈs a s i
samudra	s a ˈm u d r a
asid	ˈa s ɪ t
sungsang	ˈs ʊ ŋ s a ŋ
cadang	ˈt͡ʃ a . d a ŋ
partus	ˈp a r . t ʊ s
personalitas	p ə r s o n a ˈl i t a s
perserikatan	p ə r . s ə . r i . ˈk a t . a n
termin	t ə r ˈm ɪ n
syal	ʃ a l
Maria	m a . ˈr i . a
aspal	a s . p a l
perulangan	p ə r . ˈʊ l a ŋ . a n
yudikatif	j u d i ˈk a t ɪ f
sintas	ˈs ɪ n t a s
sangat	s a . ŋ a t
busana	b u . s a . n a
penegakan	p ə . n ə . ˈɡ a k . a n
kuliah	k u ˈl i a h
ambiguitas	a m b i ɡ u ˈi t a s
ganjar	ˈɡ a n d͡ʒ a r
krans	ˈk r a n s
cita	t͡ʃ i . t a
pek	p ɛ k
netra	n ə t . r a
Indra	i n . d r a
sarkas	ˈs a r k a s
dorong	d o r o ŋ
silsilah	s ɪ l ˈs i l a h
santap	ˈs a n . t a p̚
pantat	ˈp a n t a t̚
hasad	ˈh a s a t̚
segara	s ə ˈɡ a r a
bulbul	ˈb ʊ l b ʊ l
watak	ˈw a . t a ʔ
jalu	d͡ʒ a . l u
lusin	ˈl u s i n
aib	aʲ i b
puja	p u . d͡ʒ a
tagih	ˈt a ɡ ɪ h
y	j e
terowongan	t ə r o ˈw ɔ ŋ a n
ketan	k ə ˈt a n
adenoma	a . d e . n o . m a
bunga	ˈb u ŋ a
toksisitas	t ɔ k . s i . ˈs i . t a s
H	h a
piket	p i k ɛ t̚
layan	ˈl a j a n
embrio	ɛ m ˈb r i o
berteori	b ə r t e o r i
jenazah	d͡ʒ ə ˈn a z a h
waja	ˈw a d͡ʒ a
tudung	ˈt u . d ʊ ŋ
doyo	d o . j o
kerepek	k ə ˈr ɛ p ə k̚
situasional	s i t u a s i ˈo n a l
memperkokoh	m ə m p ə r ˈk o k ɔ h
abras	a b . r a s
yakin	ˈj a k ɪ n
waria	ˈw a . r i . j a
sahaya	s a ˈh a j a
reksa	r ə k . s a
kegagalan	k ə . ɡ a . ˈɡ a l . a n
veteriner	v ɛ . t ə . ˈr i . n ɛ r
ijazah	ˈɪ d͡ʒ a z a h
hidrokarbon	h i . d r o . ˈk a r . b ɔ n
telefon	t e ˈl e f ɔ n
bijak	b i . d͡ʒ a k
asrok	ˈa s . r ɔ k
arwah	ˈa r . w a h
anaplasmosis	a . n a . p l a s . ˈm o . s ɪ s
dikti	ˈd ɪ k̚ t i
estafet	ɛ s . t a . f ɛ t
lantamal	l a n ˈt a m a l
luak	ˈl u a k̚
heiho	h e i . h o
kendala	k ə n ˈd a l a
tandang	ˈt a n . d a ŋ
keberatan	k ə b ə ˈr a t a n
salpeter	s a l . p ɛ . t ə r
n	n
akselerasi	a k s e l ə ˈr a s i
akrilamida	a k r i l a ˈm i d a
timbang	ˈt ɪ m . b a ŋ
biner	ˈb i n ɛ r
riskan	r i s . k a n
atmosferis	a t m ɔ s ˈf ɛ r ɪ s
panas	p a . n a s
karna	k a r . n a
tepar	ˈt ɛ p a r
kanti	ˈk a n . t i
aplikatif	a p l i ˈk a t ɪ f
mengetatkan	m ə ŋ ə t a t̚ k a n
perintah	p ə ˈr ɪ n t a h
pleno	ˈp l e n o
agen	ˈa . ɡ ɛ n
November	n o . ˈv ɛ m . b ə r
undur	u n ˈd ʊ ɾ
zakat	ˈz a k a t̚
idap	ˈɪ d a p̚
granat	ɡ r a . n a t̚
hina	h i n a
saudara	s a u̯ d a r a
pikir	ˈp i k ɪ r
Petrus	ˈp ɛ t r ʊ s
balabad	b a ˈl a b a t̚
polen	ˈp o l ə n
swasta	s w a s t a
tarekat	t a ˈr ɛ k a t̚
simak	ˈs i m a ʔ
parah	ˈp a r a h
muamalah	m u a m a l a h
bioinformatika	b i o . ɪ n . f ɔ r . m a . ˈt i . k a
toksikologi	ˈt ɔ k . s i . k o . ˈl o . ɡ i
sampling	ˈs a m p l ɪ ŋ
tali	ˈt a l i
aktivasi	a k̚ t i v a s i
dansa	d a n . s a
butana	b u . t a . n a
langcia	l a ŋ . t͡ʃ i a̯
giling	ˈɡ i l ɪ ŋ
malik	ˈm a . l ɪ ʔ
terpanjang	t ə r ˈp a n d͡ʒ a ŋ
perahu	p ə ˈr a h u
unik	ˈu n i k
kolam	ˈk o . l a m
cantik	t͡ʃ a n . t i k
naskah	ˈn a s . k a h
empati	ɛ m ˈp a t i
klitik	k l i . t i k
catat	ˈt͡ʃ a t a t̚
ketombe	k ə ˈt ɔ m b e
kompet	ˈk ɔ m p ɛ t̚
bencong	b ɛ n . t͡ʃ o ŋ
patahan	p a ˈt a h a n
cowok	t ʃ o . w o ʔ
memetieskan	m ə . m ə . t i . ɛ s . k a n
pasraman	p a s . r a . m a n
gigit	ˈɡ ɪ . ɡ ɪ t̚
kadi	ˈk a . d i
tebusan	t ə . b u . s a n
kamikaze	k a m i k a z e
bacot	b a ˈc o t
lowong	ˈl ɔ w ɔ ŋ
gala	ɡ a l a
hakam	ˈh a . k a m
cenangga	t͡ʃ ə . n a ŋ . ɡ a
adhesif	a b o n ə m ɛ n
kajian	k a . ˈd͡ʒ i . a n
kedaluwarsa	k ə . d a . l u . ˈw a r . s a
meninggal	m ə ˈn ɪ ŋ ɡ a l
berus	b ə ˈr ʊ s
ataninai	a . t a . n i . ˈn a . i
litigasi	l i . t i . ˈɡ a . s i
dosen	d o . s ɛ n
laksana	l a k s a n a
mudah	m u d a h
emoji	e . m o . d͡ʒ i
vulkanis	v ʊ l ˈk a n ɪ s
andege	a n ˈd e ɡ e
asrama	a s . r a . m a
siomay	ˈs j o m a j
apek	a . p ɛ k
penera	p ə . n ə . r a
bumi	b u m i
IP	ˈi . p e
seko	s e . k o
brankar	b r a n k a r
mayat	ˈm a j a t̚
awuta	ˈa w u . t a
judogi	d͡ʒ u . d o . ɡ i
dingin	d i ŋ ɪ n
reduksi	r e ˈd ʊ k s i
dasar	ˈd a s a r
bersenandung	b ə r s ə ˈn a n d ʊ ŋ
rumput	ˈr ʊ m p ʊ t̚
kenyataan	k ə . ɲ a . ˈt a . a n
kartun	k a r t u n
muhrim	ˈm ʊ h r ɪ m
pemeruman	p ə m ə ˈr u m a n
olah	ˈɔ l a h
kartel	k a r . t ɛ l
wadah	ˈw a . d a h
KHS	k a ˈh a ɛ s
mahakuasa	m a h a k u a s a
bravo	ˈb r a . v o
percuma	p ə r t͡ʃ u m a
dargah	ˈd a r ɡ a h
konsumerisme	k ɔ n s u m ɛ r ˈɪ s m ə
depresi	d e ˈp r ɛ s i
diperkokoh	d i p ə r ˈk o k ɔ h
difusi	d i ˈf u s i
ibadah	i . b a . d a h
iga	ˈɪ ɡ a
inferensi	ɪ n . f e . ˈr ɛ n . s i
ayun	ˈa j ʊ n
pelembapan	p ə . l ə m . ˈb a p . a n
jalan	d ʒ a . l a n
seremoni	s e . r e . m o . n i
nuansa	n u ˈa n s a
kamber	ˈk a m . b ə r
kap	ˈk a p̚
q	k
mungkir	ˈm u ŋ k i r
permainan	p ə r ˈm a i . n a n
kami	ˈk ä . m i
askese	a s k e s ə
impuls	ˈɪ m . p ʊ l s
asesmen	a s ɛ s m ə n
resistor	r e ˈs ɪ s t ɔ r
peraturan	p ə r a t u r a n
melekas	m ə l ə ˈk a s
ransel	ˈr a n . s ə l
membunuh	m ə m b u n ʊ h
publikasi	p u b l i ˈk a s i
kardiovaskuler	k a r d i o v a s ˈk u l ɛ r
lelangit	l ə . ˈl ä . ŋ ɪ t̪̚
seprei	s ə p . r e i
ampot	ˈa m p ɔ t̚
heptana	h e p . t a . n a
aler	ˈa l ɛ r
mag	ˈm ɑ h
genta	ɡ ə n t a
terpidana	t ə r . p i . ˈd a . n a
anaweli	a . n a . ˈw e . l i
terbit	t ə r ˈb ɪ t̚
membutir	m ə m ˈb u t i r
masjid	ˈm a s d͡ʒ ɪ t̚
J	d͡ʒ e
pengguna	p ə ŋ ˈɡ u n a
menganiaya	m ə ŋ a n i a j a
penderita	p ə n d ə r i t a
nisbah	ˈn ɪ s b a h
apokdim	a . ˈp ɔ ʔ . d ɪ m
Turki	ˈt u r k i
diberhentikan	d i b ə r h ə n ˈt i k a n
kedaerahan	k ə . d a ɛ . ˈr a h . a n
membanguni	m ə m b a ˈŋ ʊ n i
ider	i d ə r
tiris	ˈt i r i s
terjemahan	t ə r d͡ʒ ə ˈm a h a n
spoelhoek	s p ʊ l h ʊ k̚
kopitiam	k o p i t i a m
advisor	a t . ˈv i . s ɔ r
ketumbar	k ə ˈt ʊ m b a r
tunjangan	t ʊ n ˈd͡ʒ a ŋ a n
amleng	ˈa m . l ə ŋ
B	b e
produk	ˈp r o . d ʊ k
anggrang	ˈa ŋ . ɡ r a ŋ
Februari	f ɛ b r u ˈa r i
pemberitahuan	p ə m . b ə . r i . t a . ˈh u . a n
hai	h a ɪ
helikopter	h e . l i . ˈk ɔ p . t ə r
mengalir	m ə ŋ . ˈa . l ɪ r
baba	ˈb a . b a
losmen	l o s . m ɛ n
adiyuswa	a d i ˈj ʊ s w a
tempat	t ə m p a t
mempengaruhi	m ə m . p ə . ŋ a . r u h . i
prabu	p r a . b u
uskup	u s . k ʊ p
bendahara	b ə n . d a . h a . r a
gastrointestinal	ɡ a s . t r o . ɪ n . t ɛ s . ˈt i . n a l
kartika	k a r . t i . k a
benik	b ə ˈn ɪ k̚
deforestasi	d e . f o . r ə s . ˈt a . s i
agul	ˈa ɡ ʊ l
apsara	a p . s a . r a
musyawarah	m u ʃ a ˈw a r a h
turunan	t u ˈr u n a n
secang	s ə . t͡ʃ a ŋ
cerutu	t͡ʃ ə ˈr u t u
sela	ˈs e . l a
wol	ˈw o l
wortel	w o r . t ə l
seminar	s ə ˈm i n a r
abilah	ˈa b i l a h
amplokan	a m ˈp l o k a n
awam	ˈa w a m
ia	ˈi a̯
IPS	i . ˈp e . ɛ s
aliah	a l i a h
bawi	b a . w i
izin	ˈɪ z ɪ n
jangka	ˈd͡ʒ a ŋ k a
jarum	ˈd͡ʒ a r u m
Naufal	n a u . f a l
tamat	ˈt a m a t̚
amanat	ˈa m a n a t̚
x	ɛ k s
Nyonya	ɲ o ɲ a
obi	o . b i
tenggorok	t̪ ə ŋ . ˈɡ o . r o k̚
taring	t a . r ɪ ŋ
baki	ˈb a k i
sami	ˈs a m i
ilopasia	ɪ l o ˈp a s i a̯
iktidal	ɪ ʔ ˈt i d a l
karsa	k a r s a
gudang	ɡ u d a ŋ
handschoen	h a n . s ə k ʊ n
alutta	ˈa l ʊ t t a
adiafora	a d i a ˈf o r a
rasisme	r a ˈs ɪ s m ə
ketat	k ə ˈt a t
layanan	l a ˈj a n a n
eksponen	ɛ k s . ˈp o . n ɛ n
kohesi	k o ˈh e s i
bahu	ˈb ä . h u
anak	a . n a k
visus	ˈv i s ʊ s
alpiris	a l . ˈp i . r ɪ s
jujutsu	d ʒ u . d ʒ ʊ t . s u
gunung	ˈɡ u n u ŋ
anuhuai	a . n u . ˈh u . a i̯
seri	ˈs e . r i
banci	b a n . t͡ʃ i
ini	ˈi n i
bentar	b ə n ˈt a r
surat	s u . r a t
latih	ˈl a t ɪ h
kelapa	k ə ˈl a p a
radikalisasi	r a d i k a l ˈɪ s a s i
sutra	s u . t r a
kanonis	k a n o n ɪ s
sampir	ˈs a m p ɪ r
eceran	ˈɛ t͡ʃ ɛ r a n
bausastra	b a . u . s a s . t r a
menurun	m ə ˈn u r ʊ n
kidal	k i d a l
tunda	ˈt ʊ n d a
aliansi	a l i ˈa n s i
anfal	a n . f a l
sampai	s a m p a i̯
nazar	ˈn a z a r
magang	ˈm a . ɡ a ŋ
memasang	m ə m a s a ŋ
biadab	b i ˈa d a p̚
jurnalisme	d͡ʒ ʊ r . n a . ˈl ɪ s . m ə
kebo	k ə ˈb o
GGL	ɡ e . ɡ e . ɛ l
China	ˈt͡ʃ ɪ n a
rehabilitasi	r e h a b i l i ˈt a s i
biku	b i . k u
Ibrani	i ˈb r a n i
tautan	t a ˈʊ t a n
amerta	a m ə r . t a
lokalisir	l o k a l i s ɪ r
harta	h a r . t a
anjiman	a n ˈd͡ʒ i m a n
ambong	ˈa m b ɔ ŋ
soba	s o . b a
tanpa	ˈt a n p a
kardiolog	k a r . d i . ˈo . l ɔ k
makan	m a . k a n
cilik	ˈt͡ʃ i . l ɪ k
editor	ˈɛ d i t ɔ r
ideologi	i d e o ˈl o ɡ i
lempira	l e m ˈp i r a
kahar	ˈk a h a r
kofte	ˈk ɔ f t e
mencium	m ə ɲ t͡ʃ i u m
ku	k u
garansi	ɡ a ˈr a n s i
sarasehan	s a . r a . ˈs ɛ h . a n
maestro	m a . ˈɛ s . t r o
iktibar	ɪ ʔ ˈt i b a r
moda	ˈm o . d a
idep	ˈɪ d ə p̚
keparat	k ə . p a . r a t
uap	ˈʊ a p̚
nalar	ˈn a l a r
Tamil	ˈt a m ɪ l
pulut	ˈp u l ʊ t̚
Bulgaria	b ʊ l ˈɡ a r i a̯
penjahat	p ə n ˈd͡ʒ a h a t̚
badar	ˈb a . d a r
psikologis	p ə s i k o ˈl o ɡ ɪ s
lauk	ˈl a . ʊ ʔ
hasyis	ˈh a ʃ ɪ s
kalurahan	k a . l u . ˈr a h . a n
persik	ˈp ɛ r . s ɪ k
aksara	a k . s a . r a
stadium	s t a ˈd i ʊ m
aluakas	a l u ˈa k a s
asmara	a s . m a . r a
kesejahteraan	k ə s ə d͡ʒ a h t ə ˈr a a n
tekstur	ˈt ɛ k s t ʊ r
korps	ˈk ɔ r p s
syogun	ʃ o . ɡ u n
angsongar	a ŋ ˈs o ŋ a r
kunjung	ˈk ʊ n . d͡ʒ ʊ ŋ
dari	d a . r i
dramatis	d r a ˈm a t ɪ s
munsyi	m u n . ʃ i
padus	p a . d u s
anungo	a . ˈn u . ŋ o
stoples	ˈs t ɔ p l ɛ s
timpang	ˈt ɪ m . p a ŋ
lapuk	ˈl a p u k
gugus	ˈɡ u ɡ ʊ s
arif	ˈa r ɪ f
sayang	ˈs a j a ŋ
beradab	b ə r ˈa d a p̚
daidanco	d a i . d a n . t͡ʃ o
kustar	ˈk ʊ s t a r
arababu	a r a ˈb a b u
bikini	b i ˈk i n i
antolong	a n ˈt o l ɔ ŋ
darji	ˈd a r d͡ʒ i
bagi	b a . ɡ i
hibrida	h i ˈb r i d a
kandelir	k a n . d ə . ˈl ɪ r
ligamen	l i ˈɡ a m ɛ n
dokumentografi	d o k u m ɛ n t o ˈɡ r a f i
bodoh	ˈb o d ɔ h
hanzi	h a n . z i
teladan	t ə l a d a n
kompi	ˈk ɔ m p i
bidadari	b i . d a . d a . r i
mengencingi	m ə . ŋ e n . c i ŋ . i
lomba	ˈl ɔ m b a
handasah	h a n ˈd a s a h
rahmat	r a h m a t
rantau	ˈr a n . t a u̯
berketombe	b ə r k ə ˈt ɔ m b e
pedagogi	p e d a ˈɡ o ɡ i
sarkastis	s a r ˈk a s t ɪ s
terburuk	t ə r ˈb u r ʊ k̚
heterogen	h e . t e . ˈr o . ɡ ɛ n
eigendom	e i . ɡ ə n . d o m
Jakarta	d͡ʒ a ˈk a r t a
Ankara	a n ˈk a r a
dedak	d ə . ˈd a k
kuap	ˈk u a p̚
pengeluaran	p ə ŋ ə ˈl u a r a n
faring	ˈf ä . r i ŋ
Georgia	ɡ e ɔ r ˈɡ i a
introspeksi	ɪ n t r o ˈs p ɛ k̚ s i
antariksawan	a n t a r ɪ k s a w a n
aktuator	a k t u ˈa t ɔ r
tanduk	t a n d u k
bodo	ˈb o . d o
eksplikatif	ɛ k s p l i ˈk a t ɪ f
nori	n o . r i
markas	ˈm a r . k a s
formatif	f ɔ r . ˈm a . t ɪ f
abortus	ˈa b ɔ r t̪ ʊ s
anaheha	a n a ˈh e h a
peta	p ə ˈt a
pion	p i . o n
ponsel	p o n s ɛ l
makaroni	m a . k a . ˈr o . n i
sponsor	ˈs p ɔ n . s ɔ r
aforestasi	a f o r ɛ s ˈt a s i
semenanjung	s ə m ə ˈn a n d͡ʒ ʊ ŋ
gusi	ˈɡ u . s i
mukbang	ˈm ʊ k b ɑ ŋ
fiat	ˈf i a t
dorongan	d ɔ ˈr ɔ ŋ a n
berangkat	b ə . r a ŋ . k a t
aktif	a k̚ t ɪ f
kultivasi	k ʊ l t i ˈv a s i
keanekaragaman	k ə . a . n ɛ . k a . r a . ɡ a . m a n
membangun	m ə m ˈb a ŋ u n
apotek	a p o . t e k
gulana	ɡ u l a n a
datang	ˈd a t a ŋ
cetera	t͡ʃ ə . t ə . r a
teriyaki	t ɛ . r i . j a . k i
kali	k a . l i
pariwisata	p a . r i . w i . s a . t a
terjelas	d͡ʒ ə ˈl a s
pintu	ˈp ɪ n t u
menjaring	m ə n ˈd͡ʒ a r i ŋ
nyiur	ˈɲ j u r
manira	m a . ˈn i . r a
pemabuk	p ə m a b u k
perbani	p ə r . ˈb a . n i
delman	ˈd e l . m a n
lintasan	l ɪ n . ˈt a s . a n
promovendus	p r o m o ˈv ɛ n d ʊ s
sepeda	s ə ˈp ɛ . d a
Jateng	d͡ʒ a ˈt ə ŋ
ri	r i
coba	ˈt͡ʃ o b a
seharian	s ə . h a . r i . a n
terkait	t ə r ˈk a ɪ t̚
fantosmia	f a n ˈt ɔ s m i a̯
antor	ˈa n t ɔ r
saputangan	ˈs ä p u ˌt ä ŋ a n
ketimpangan	k ə t ɪ m ˈp a ŋ a n
suplai	ˈs ʊ p l a i̯
cara	t͡ʃ a . r a
kanca	ˈk ɔ n t͡ʃ ɔ
eter	ˈɛ t ə r
Estonia	e s ˈt o n i a̯
binatang	b i ˈn a t a ŋ
manset	ˈm a n s ɛ t
tinjau	t i n d͡ʒ a u̯
basmi	b a s . m i
analitis	a n a ˈl i t ɪ s
feodalisme	f e o d a l ˈɪ s m ə
devosi	d e v o s i
dongkrak	ˈd ɔ ŋ k r a k̚
maju	ˈm a . d͡ʒ u
renta	ˈr ɛ n t a
doa	d o a
toto	t o t o
kurawa	k u ˈr a w a
gravitasi	ɡ r a v i ˈt a s i
kuwu	ˈk u . w u
paha	ˈp a h a
perdata	p ə r ˈd a t a
batur	ˈb a t ʊ r
diri	d i . r i
batik	b a t ɪ k
interferensi	ɪ n t ə r f ə ˈr ɛ n s i
altar	ˈa l t a r
andem	ˈa n d ə m
perwakilan	p ə r w a ˈk ɪ l a n
reduksionisme	r e . d ʊ k . s i . o . ˈn ɪ s . m ə
rogol	ˈr ɔ . ɡ ɔ l
dikau	d i k a u̯
literasi	l i t ə ˈr a s i
atan	ˈa t a n
serampang	s ə ˈr a m p a ŋ
kedokteran	k ə . d o k . t ə . r a n
waralaba	w a r a ˈl a b a
peluk	p ə l ʊ k
lapangan	l a ˈp a ŋ a n
peranti	p ə ˈr a n t i
alarm	ˈa l a r m
ais	ˈa ʔ ɪ s
baktau	b a k . t a ʊ̯
retorika	r e t o ˈr i k a
mudra	m u d . r a
kanit	k a . n i t
mana	m a . n a
yuyitsu	j u . j i t . s u
pemufakatan	p ə m u f a ˈk a t a n
instruksional	ɪ n . s t r ʊ k . s i . ˈo . n a l
aci	a t͡ʃ i
mendarahi	m ə n . d a . ˈr a h . i
roman	ˈr o . m a n
impas	ˈɪ m p a s
hakim	ˈh a k ɪ m
berkembang	b ə r k ə m ˈb a ŋ
ayam	a . j a m
Selasa	s ə ˈl a s a
pelatih	p ə ˈl a t ɪ h
mager	ˈm a ɡ ə r
dengar	d ə . ŋ a r
pengurangan	p ə ŋ u ˈr a ŋ a n
bineka	b i . ˈn e . k a
calir	ˈt͡ʃ a l ɪ r
sesak	s ə . ˈs a k
bakiak	b a . k i . a k
audiometri	a u̯ . d i . o . ˈm e . t r i
kelembapan	k ə . l ə m . ˈb a p . a n
terasi	t ə ˈr a s i
rokade	r o ˈk a d ə
mengoplos	m ə ŋ . o p . l o s
aloun	a . ˈl o . ʊ n
jadi	d ʒ a . d i
nyonya	ɲ o ɲ a
dayah	ˈd a j a h
menghukum	m ə ŋ . h u . k ʊ m
momentum	m o . ˈm ɛ n . t ʊ m
amin	ˈa . m ɪ n
saat	s a . ʔ a t
amporo	a m ˈp o r o
tindakan	t ɪ n . d a . k a n
pala	p a . l a
bohong	b o . h o ŋ
penguatan	p ə ŋ u ˈa t̚ a n
aruna	ˈa r u n a
mencela	m ə ŋ t͡ʃ ə l a
weker	w ɛ . k ə r
kontingensi	k ɔ n . t i . ˈŋ ɛ n . s i
titrasi	t i ˈt r a s i
samurai	s a . m u . r a i
teraniaya	t ə r a n i a j a
hamba	h a m . b a
wajib	ˈw a d͡ʒ ɪ p
kewartawanan	k ə . w a r . t a . ˈw a n . a n
meletus	m ə l ə t u s
membuka	m ə m ˈb u k a
perjanjian	p ə r . d͡ʒ a n . ˈd͡ʒ i . a n
perasat	p ə . ˈr a . s a t
lisan	l i . s a n
kers	ˈk ɛ r s
terbang	t ə r . b a ŋ
kuantum	k u ˈa n t ʊ m
amar	ˈa m a r
urita	u ˈr i t a
kumpul	ˈk ʊ m p ʊ l
agunan	a . ˈɡ ʊ n . a n
ceroboh	ˈt ʃ ə . r o . b o h
memiliki	m ə ˈm i l ɪ k i
cempaka	t͡ʃ ə m . p a . k a
sebar	s ə ˈb a r
ansai	ˈa n . s a i̯
hosti	h o s t i
borgol	ˈb ɔ r ɡ ɔ l
apoking	a . ˈp o . k ɪ ŋ
ancut	ˈa n . t͡ʃ ʊ t
pagu	p a ɡ u
ragil	ˈr a . ɡ ɪ l
amporang	a m ˈp o r a ŋ
kardiologi	k a r . d i . o . ˈl o . ɡ i
sujud	ˈs u d͡ʒ ʊ t̚
difabel	d i ˈf a b ə l
syuriken	ʃ u . r i . k ɛ n
ꦱꦺꦴꦕ	s o t͡ʃ ɔ
andap	ˈa n . d a p
agung	ˈa ɡ ʊ ŋ
anamolepo	a n a m o ˈl e p o
padri	p a d r i
capung	ˈt͡ʃ a p ʊ ŋ
pinta	ˈp i n t a
jenasah	d͡ʒ ə ˈn a s a h
songket	s o ŋ k ɛ̀ t
andala	a n ˈd a l a
talian	t a ˈl i a n
e	e
keturunan	k ə . t u . r u . n a n
gergasi	ɡ ə r . ˈɡ a . s i
o	o
bangku	ˈb ä ŋ . k u
surga	ˈs ʊ r ɡ a
balairung	b a . ˈl a i̯ . r ʊ ŋ
mustahik	m ʊ s ˈt a h ɪ k̚
Januari	d͡ʒ a . n u . ˈa . r i
pengungsi	p ə ŋ . ˈʊ ŋ . s i
Indonesia	i n . ˈd o . n ɛ . s ɪ . j a
gelita	ɡ ə l i t a
benduan	b ə n . ˈd u . a n
uban	ˈu . b a n
makanan	m a k a . n a n
peradaban	p ə r ˈa d a p a n
antofilia	a n . t o . f i . ˈl i . a
garuda	ɡ a ˈr u d a
satwa	ˈs a t̚ w a
ancur	ˈa n . t͡ʃ ʊ r
proyek	ˈp r o . j ɛ k
siomai	s i ˈo m a j
awota	ˈa w o . t a
cedera	t͡ʃ ə . d ə . r a
agresi	a ɡ . r ɛ . s i
min	ˈm ɪ n
penerus	p ə . n ə . ˈr ʊ s
bertambah	b ə r ˈt a m b a h
telaah	t ə . l a . ʔ a h
sprint	ˈs p r ɪ n t
romantis	r o ˈm a n t ɪ s
Sunda	ˈs ʊ n d a
eutanasia	e u t a n a ˈs i a
vasodilatasi	v a s o d i l a ˈt a s i
perjaka	p ə r . ˈd͡ʒ a . k a
honje	ˈh ɔ n d͡ʒ e
pemacu	p ə . ˈm a . t͡ʃ u
lengkuas	l ə ŋ . ˈk u . a s
widyaiswara	w i t j a i s ʋ a r a
adiksimba	a d ɪ k ˈs ɪ m b a
diperkeruh	d i p ə r k ə ˈr ʊ h
anido	ˈa n i d o
raga	r a . ɡ a
antok	ˈa n t ɔ k̚
hadir	h a . d ɪ r
mangkuk	ˈm a ŋ k ʊ k̚
balik	ˈb a l ɪ k̚
pengoplos	p ɘ ŋ . o p . l o s
gakari	ɡ a . k a . r i
kilap	ˈk i l a p̚
kecil	k ə ˈt͡ʃ i l
lada	ˈl a d a
registri	r e . ˈɡ ɪ s . t r i
yubileum	j u b i ˈl e ʊ m
hop	h o p
nira	n i . r a
katedral	k a t ə d r a l
takar	ˈt a k a r
fermentasi	f e r m e n ˈt a s i
kartu	ˈk a r t u
aldehida	a l d e ˈh i d a
arkunel	a r . ˈk u . n ɛ l
landasan	l a n . d a . s a n
benar	ˈb e . n a r
gagang	ˈɡ a . ɡ a ŋ
kesenjangan	k ə . s ə n . d͡ʒ a ŋ . a n
satori	s a . t o . r i
pengelasan	p ə ŋ ə ˈl a s a n
toko	ˈt o . k o
ana	a n a
bustan	ˈb ʊ s t a n
itas	i t a s
kuartal	k u a r t a l
kapan	k a . p a n
beha	b e . h a
tempur	t ə m ˈp ʊ r
pejagalan	p ə . d͡ʒ a . ˈɡ a l . a n
tinggal	ˈt ɪ ŋ ɡ a l
eksperimental	ɛ k s . p ə . r i . ˈm ɛ n . t a l
debus	d ə ˈb ʊ s
nabi	ˈn a b i
parsimoni	p a r . s i . ˈm o . n i
penghancuran	p ə ŋ h a n ˈt͡ʃ ʊ r a n
anjul	ˈa n d͡ʒ ʊ l
pengen	p ɛ . ŋ ɛ n
perpaduan	p ə r p a ˈd u a n
tawar	t a w a r
tua	t u . a
populasi	p o p u ˈl a s i
rasa	r a . s a
huruf	ˈh u r ʊ f
atma	a t . m a
mengemasi	m ə ɲ ə m a s i
konduktivitas	k ɔ n . d ʊ k . t i . ˈv i . t a s
Injil	ˈɪ n . d͡ʒ ɪ l
dimakan	ˈd i . m a k a n
gugur	ˈɡ u . ɡ ʊ r
daerah	d a ˈɛ r a h
berdasar	b ə r ˈd a s a r
tabungan	t a ˈb ʊ ŋ a n
mastautin	m a s ˈt a u̯ t ɪ n
luang	ˈl u a ŋ
seniman	s ə ˈn i m a n
konjungtiva	k ɔ n d͡ʒ ʊ ŋ ˈt i v a
pagi	ˈp a ɡ i
serong	ˈs ɛ r ɔ ŋ
sudoku	s u . d o . k u
degenerasi	d e ɡ e n ə ˈr a s i
taaruf	t a a r u f
joli	ˈd͡ʒ o l i
pit	ˈp ɪ t
WA	w e . ʔ a
flan	ˈf l a n
wana	w a . n a
sudra	ˈs ʊ t . r a
suci	s u . t͡ʃ i
stasioner	s t a s i ˈo n ɛ r
gayung	ɡ a j u ŋ
pupuk	ˈp ʊ p ʊ ʔ
survei	ˈs ʊ r . v e i̯
parpol	p a r . p o l
gamang	ˈɡ a m a ŋ
kanguru	k a ˈŋ u r u
jawi	ˈd͡ʒ a . w i
C	t͡ʃ e
bangsi	b a ŋ . s i
membulat	m ə m ˈb u l a t
fantastis	f a n ˈt a s t ɪ s
kering	k ə ˈr ɪ ŋ
babelih	b a . b ə . ˈl ɪ h
azan	ˈa z a n
kirik	ˈk i . r ɪ ʔ
menjijikkan	m ə n . d͡ʒ i . d͡ʒ ɪ ʔ . k a n
pantau	ˈp a n t a u̯
rembes	ˈr ɛ m b ɛ s
swakriya	s w a ˈk r i j a
perdikan	p ə r ˈd i k a n
eksplorasi	ɛ k s p l o ˈr a s i
Olimpiade	o . l ɪ m . p i . ˈa . d ə
chindo	t͡ʃ i n d o
masyarakat	m a ʃ a ˈr a k a t̚
begawan	b ə . ɡ a . w a n
semalem	s ə . m a . l ə m
usul	ˈu s ʊ l
kelahiran	k ə . l a . ˈh ɪ r . a n
ketersediaan	k ə . t ə r . s ə . d i . ˈa . a n
awetan	a . ˈw ɛ t . a n
jiwa	d͡ʒ i . w a
ambu	ˈa m b u
algoritmik	a l ɡ o ˈr ɪ t̚ m ɪ k̚
ambyur	ˈa m bʲ ʊ r
alewar	ˈa l e w a r
watas	ˈw a t a s
menggarisbawahi	m ə ŋ . ɡ a . r i s . b a . w a h . i
jelus	d͡ʒ ə ˈl ʊ s
fluida	f l u ˈi d a
sensitivitas	s ɛ n s i t i ˈv i t a s
manti	ˈm a n t i
deselerasi	d e s ɛ l ə ˈr a s i
siram	ˈs i . r a m
sima	ˈs i . m a
arbei	a r . b e i̯
ḍiri	a b o n ə m ɛ n
laksmana	l a k s . m a . n a
ambil	ˈa m b ɪ l
bumbung	ˈb u m b u ŋ
isama	i s a m a
taun	ˈt a . ʊ n
sembuh	s ə m ˈb ʊ h
diploma	d i ˈp l o m a
piktogram	p ɪ k . ˈt o . ɡ r a m
sasana	s a . s a . n a
aswa	a s . w a
D	d e
kencana	k ə n . t͡ʃ a . n a
inflasi	ɪ n . ˈf l a . s i
makrokosmos	m a k . r o . ˈk ɔ s . m ɔ s
Finlandia	f ɪ n ˈl a n d i a̯
peringatan	p ə r ˈɪ ŋ a t̚ a n
ensiklik	e n s i k l i k
khatam	ˈx a t a m
persiapan	p ə r . s i . ˈa p . a n
nakhoda	n a ˈx o d a
resmi	r ə s . m i
pencitraan	p ə ŋ t͡ʃ i ˈt r a a n
atur	ˈa t ʊ r
sapu	ˈs a . p u
anggana	a ŋ ˈɡ a n a
berdarah	b ə r ˈd a r a h
satah	ˈs a t a h
biostatika	b i . o . s t a . ˈt i . k a
Callista	ˈk a l i s t a
penyelenggaraan	p ə . ɲ ə . l ə ŋ . ɡ a . ˈr a . a n
antesis	a n ˈt e s ɪ s
alat	a l a t
Islandia	ɪ s ˈl a n d i a̯
kapitan	k a ˈp i t a n
sungkit	s ʊ ŋ k ɪ t
asat	ˈa s a t̚
makmum	ˈm a ʔ m ʊ m
Khairunnisa	ˈx a i r u n i s a
kolon	ˈk o l ɔ n
evaluasi	ɛ v a l u ˈa s i
rumah	ˈr u m a h
pertambangan	p ə r t a m ˈb a ŋ a n
ekstrinsik	ɛ k s . ˈt r ɪ n . s ɪ k
agar	ˈa ɡ a r
tsuru	ʃ u . r u
lokalisasi	l o k a l i s a s i
abi	a b i
gabungan	ɡ a ˈb ʊ ŋ a n
antuk	ˈa n t u k
laher	l a . h ə r
aksiomatik	a k . s i . o . ˈm a . t ɪ k
menggempita	m ə ŋ . ɡ ə m . p i . t a
tipu	t i . p u
konsultatif	k ɔ n . s ʊ l . ˈt a . t ɪ f
cabai	ˈt͡ʃ a b a j
penyesuaian	p ə ɲ ə s u ˈa i̯ a n
kehausan	k ə . h a ʊ s . a n
gandu	ˈɡ a n d u
bazar	b a . z a r
zalir	ˈz a l i r
undangan	ʊ n . ˈd a ŋ . a n
psikolog	p ə s i ˈk o l ɔ k̚
magis	ˈm a . ɡ ɪ s
resonansi	r e . s o . ˈn a n . s i
gletser	ˈɡ l ɛ t s ə r
benih	b ə n ɪ h
borang	ˈb ɔ r a ŋ
lenga	l ə . ˈŋ a
kuna	ˈk u n a
akut	a . k u t
menayangkan	m ə n a j a ŋ k a n
pajanan	p a . ˈd͡ʒ a n . a n
mual	ˈm u a l
kapten	ˈk a p̚ t ɛ n
mencatat	m ə n ˈt͡ʃ a t a t̚
tangguh	ˈt a ŋ ɡ ʊ h
katode	k a . t o . d ə
Isa	i s a
andurabian	a n d u r a ˈb i a n
tablig	ˈt a b l ɪ k̚
incung	ˈɪ n t͡ʃ ʊ ŋ
fluks	ˈf l ʊ k s
brahmana	b r a h ˈm a n a
tersier	t ɛ r ˈs i ɛ r
adikara	a d i . k a . r a
perpindahan	p ə r p ɪ n ˈd a h a n
upawasa	u p a . w a . s a
mayit	ˈm a j i t̚
haiku	h a i . k u
lurah	ˈl u . r a h
eco	ˈe . t͡ʃ o
peres	ˈp ɛ . r ɛ s
kebakaran	k ə ˈb a . k a ˈr a n
lantas	ˈl a n t a s
abam	ˈa b a m
tabu	ˈt a b u
sudut	ˈs u . d ʊ t
bersuasana	b ə r . ˈs u . w ä . r ä
dekan	d e k a n
absolusi	a b s o l u s i
kewajiban	k ə w a ˈd͡ʒ i b a n
eling	ˈe . l ɪ ŋ
angkar	ˈa ŋ k a r
anangkolaki	a n a ŋ k o ˈl a k i
canang	ˈt͡ʃ a . n a ŋ
ekaristi	ɛ k a r i s t i
rancang	ˈr a n . t͡ʃ a ŋ
tuntut	t u n . t ʊ t
memperketat	m ə m p ə r k ə t a t
remas	r ə . ˈm a s
intipan	ɪ n ˈt ɪ p̚ a n
termoregulasi	t ɛ r . m o . r e . ɡ u . ˈl a . s i
gaz	ˈɡ a z
biwara	b i . ˈw a . r a
memilih	m ə . m i . l i h
adisi	a . ˈd i . s i
tensi	t ɛ n s i
nasabah	n a ˈs a b a h
deflasi	d e ˈf l a s i
prakiraan	p r a . k i . ˈr a . a n
bagong	b a . ɡ ɔ ŋ
fiskal	ˈf ɪ s . k a l
menjarum	m ə n ˈd͡ʒ a r u m
arloji	a r l o d͡ʒ i
tempura	t ə m . p u . r a
rusak	r u . s a k̚
sumo	s u . m o
sumbu	ˈs ʊ m . b u
amer	ˈa m ɛ r
ako	a k e o
kardiovaskular	k a r d i o v a s ˈk u l a r
ergonomis	e r ɡ o ˈn o m ɪ k
ayeuh	a ˈj ɤ h
tinta	t i n . t a
letjend	l ə t ˈd͡ʒ ə n d
baya	b a . j a
tengar	t ə ˈŋ a r
determinisme	d e . t ɛ r . m ɪ n . ˈɪ s . m ə
tekidanto	t ɛ . k i . d a n . t o
bajaj	ˈb a . d ʒ a i̯
gampar	ɡ a m . p a r
kotor	k o t o r
nanti	n a n . t i
kapanewon	k a . p a . n e . w ɔ n
obesitas	o b ɛ . s i . t a s
galak	ɡ a . l a k
jelas	d͡ʒ ə ˈl a s
pekerti	p ə k ə r ˈt i
tabel	ˈt a b ə l
duka	d u . k a
apang	ˈa p a ŋ
kayas	k a ˈj a s
kolaborator	k ɔ l a b ɔ ˈr a t ɔ r
manga	ˈm a n ɡ a
tenge	ˈt e ŋ e
satu	ˈs ä . t̪ u
geng	ɡ ɛ ŋ
tamtama	t a m ˈt a m a
kombinasi	k ɔ m b i ˈn a s i
beli	b ə ˈl i
indra	i n . d r a
ageisme	a ɡ e ˈɪ s m ə
tengkujuh	t ə ŋ ˈk u d͡ʒ ʊ h
amoa	ˈa m o a̯
LPMP	ɛ l p e ˈɛ m p e
mewah	ˈm ɛ w a h
toksin	ˈt ɔ k . s ɪ n
sri	s ə r i
pada	ˈp a d a
lupa	l u . p a
temu	t ə ˈm u
akidah	ˈa k i d a h
buruk	ˈb u r u k
Allah	ɑ l l ɑ h
spaning	s p a . n i ŋ
himpunan	h ɪ m ˈp ʊ n a n
jagung	ˈd͡ʒ a ɡ ʊ ŋ
folklor	ˈf ɔ l ʔ . l ɔ r
kafilah	k a ˈf i l a h
parak	ˈp a . r a ʔ
watan	w a . t a n
kesukaran	k ə . s u . ˈk a r . a n
riba	ˈr i b a
kegiatan	k ə . ɡ i . ˈa t . a n
permanen	p ə r ˈm a n ɛ n
mengurutkan	m ə ŋ u ˈr u t k a n
ꦱꦺꦮ	s e w a
liturgis	l i . ˈt ʊ r . ɡ ɪ s
kumpulan	k ʊ m ˈp ʊ l a n
negoisasi	n ɛ . ɡ o . s i . a . s i
pernyataan	p ə r . ɲ a . ˈt a . a n
Bima	ˈb i m a
moci	m o t͡ʃ i
sinergi	s i . ˈn ɛ r . ɡ i
anakia	ˈa n a k i a̯
dorna	d o r n a
bakpau	b a k . p a ʊ̯
aneka	a n ɛ . k a
kenan	k ə . ˈn a n
artikula	a r . t i . ˈk u . l a
badek	ˈb a . d ə k
efektif	ˈɛ f ɛ k̚ t ɪ f
bibi	ˈb i b i
bab	b a b
bajing	ˈb a . d͡ʒ ɪ ŋ
hukuman	h u ˈk u . m a n
takwim	ˈt a k w ɪ m
Sumbar	ˈs u m b a r
mengatakan	m ə ŋ a ˈt a k a n
hayat	h a . j a t̚
narasi	n a . ˈr a . s i
hemisfer	h e ˈm i . s f ɛ r
alkana	a l . k a . n a
penguji	p ə ŋ . ˈʊ d͡ʒ i
astana	a s . t a . n a
loh	ˈl ɔ h
duta	d u . t a
j	d͡ʒ e
tekor	t ə . k o r
flop	ˈf l ɔ p̚
mertua	m ə r ˈt u a̯
giat	ˈɡ i a t̚
belantara	b ə . l a n . t a . r a
arbor	ˈa r b ɔ r
sijil	s i d͡ʒ ɪ l
kecam	k ə . ˈt͡ʃ a m
anggrek	ˈa ŋ ɡ r ɛ ʔ
asuhan	a . ˈs ʊ h . a n
anastilosis	a . n a . s t i . ˈl o . s ɪ s
tegas	t ə ˈɡ a s
baginda	b a ɡ i n d a
oase	o ˈa s ə
margasatwa	m a r . ɡ a . ˈs a t . w a
sempurna	s ə m . p u r . n a
penggiling	p ə ŋ . ɡ ɪ . l ɪ ŋ
karak	ˈk a . r a k
ecer	ˈɛ t͡ʃ ɛ r
hentai	h ɛ n . t a i̯
objektivitas	ɔ p d͡ʒ ɛ k t i ˈf i t a s
kek	k ɛ ʔ
penelitian	p ə . n ə . l i . ˈt i . a n
solidaritas	s o . l i . d a . ˈr i . t a s
ahad	ˈa h a t̚
darwis	ˈd a r w ɪ s
sumuran	s u ˈm u r a n
farsakh	ˈf a r s a x
warita	w a ˈr i t a
eka	e . k a
menghadiri	m ə ŋ . h a . d i r . i
angkasawan	a ŋ k a s a w a n
abiseka	a b i . s e . k a
kawasan	k a . w a . s a n
tanah	t a . n a h
keadilan	k ə ˈa d ɪ l a n
wanara	w a . n a . r a
persneling	p ə r . s n e . l i ŋ
aningo	a . ˈn i . ŋ o
h	h a
canggih	t͡ʃ a ŋ . ɡ i h
balikan	b a l i k a n
tadah	ˈt a d a h
sinse	s i n . s e
gagu	ˈɡ a ɡ u
heterogenitas	h e . t e . r o . ɡ e . ˈn i . t a s
Bapa	b a p a
tasbih	ˈt a s b ɪ h
komisi	k o ˈm i . s i
gen	ˈɡ ɛ n
MIPA	m i . p a
awas	ˈa w a s
kaca	k a t͡ʃ a
makasih	m a . k a . s ɪ h
lancia	l a n . t͡ʃ i a̯
lengket	ˈl ɛ ŋ k ɛ t̚
ᬰᬶᬯ	s i w a
jadul	ˈd͡ʒ a d ʊ l
arhir	ˈa r . h ɪ r
budi	b u . d i
mama	ˈm a m a
anau	ˈa n a u̯
ovum	ˈɔ v ʊ m
amput	ˈa m p ʊ t̚
cultuurstelsel	k ʊ l t ʊ r s t ɛ l s ə l
kailan	k a . i . l a n
ꦔꦺꦴꦏꦺꦴ	ŋ ɔ k ɔ
sensei	s e n . s e i
gawang	ˈɡ a w a ŋ
hijau	ˈh i d͡ʒ a w
hidrogen	h i d r o ɡ ɛ n
adpis	ˈa t̚ p ɪ s
tukang	ˈt u . k a ŋ
taksaka	t a k ˈs a k a
tentang	t ə n t a ŋ
jenawi	d͡ʒ ə ˈn a w i
Bali	b a l i
salam	ˈs a l a m
wanaternak	w a n a ˈt ə r n a k
abur	ˈa b ʊ r
fantasi	f a n ˈt a s i
permusyawarahan	p ə r m u ʃ a w a ˈr a h a n
patriarki	p a . t r i . ˈa r . k i
segitiga	s ə . ɡ i . t i . ɡ a
orangtua	o . r a ŋ . t u . a
dehidrasi	d e h i ˈd r a s i
keranda	k ə r a n d a
risalah	r i ˈs a l a h
internasional	i n t ə r n a s i o n a l
sentosa	s ə n . t o . s a
ambyok	ˈa m b j ɔ k̚
persentil	p ə r . ˈs ɛ n . t ɪ l
pembangkang	p ə m ˈb a ŋ k a ŋ
Jatim	ˈd͡ʒ a t i m
Skotlandia	s k ɔ t ˈl a n d i a̯
ngab	ŋ a b
nalam	ˈn a l a m
pendekatan	p ə ŋ . d ə . ˈk a t . a n
sandar	ˈs a n d a r
juag	ˈd͡ʒ u a k̚
indikator	ɪ n d i ˈk a t ɔ r
deplesi	d e ˈp l e s i
menemukan	m ə n ə ˈm u k a n
irama	i r a m a
penganiayaan	p ə ŋ a n i a j a a n
menambah	m ə n a m b a h
belajar	b ə . l a . d͡ʒ a r
jika	ˈd͡ʒ i k a
taat	ˈt a . ʔ a t̚
alis	ˈʔ ä . l i s
wangsa	w a ŋ . s a
menghadirkan	m ə ŋ . h a . d i r . k a n
kapal	k a . p a l
E	e
wudu	ˈw u . d u
planetarium	p l a . n e . t a . ˈr i . ʊ m
adodui	ˈa d o d u i̯
BNPT	b e ɛ n ˈp e t e
gangsa	ˈɡ a ŋ . s a
cerana	t͡ʃ ə . r a . n a
amahatua	a m a ˈh a t u a̯
datu	ˈd a t u
obrol	ˈɔ b r ɔ l
anua	a . ˈn u . a
melansir	m ə . ˈl a n . s ɪ r
kembang	k ə m ˈb a ŋ
inspirasi	ɪ n s p i ˈr a s i
kinase	k i . ˈn a . s ə
bungsu	b u ŋ s u
laman	l a . m a n
adimanusia	a . d i . m a . n u . ˈs i . a
bancakan	b a n ˈt͡ʃ a k a n
persidangan	p ə r s i ˈd a ŋ a n
gelora	ɡ ə l o r a
bagan	ˈb a . ɡ a n
sendratari	s ə n . d r a . t a . r i
kelas	k ə ˈl a s
dijelaskan	d i d͡ʒ ə ˈl a s k a n
binawah	b i ˈn a w a h
gelak	ɡ ə ˈl a k
amoh	ˈa m ɔ h
ketuhanan	k ə t u ˈh a n a n
rapat	ˈr a p a t
sentul	s ə n . ˈt ʊ l
serundeng	s ə . ˈr ʊ n . d ɛ ŋ
timbal	ˈt ɪ m b a l
pengecaman	p ə . ŋ ə . ˈt͡ʃ a m . a n
kusuma	k u s u m a
polis	p o . l ɪ s
terpal	t ə r ˈp a l
pendukung	p ə n ˈd u k ʊ ŋ
bakwan	b a ʔ w a n
swasembada	s w a . s ə m . b a . d a
papir	ˈp a p ɪ r
ampilalas	a m p i ˈl a l a s
rungu	ˈr u . ŋ u
audiometer	a u̯ . d i . o . ˈm e . t ə r
automasi	a u̯ t o ˈm a s i
waktu	w a k . t u
daidan	d a i . d a n
tengok	ˈt e . ŋ ɔ k
gading	ɡ a . d i ŋ
penjagaan	p ə n ˈd͡ʒ a . ɡ a . a n
etude	e t u d ɛ
titinada	t i . t i . ˈn a . d a
gapura	ɡ a p u r a
galuh	ɡ a l u h
basahan	b a ˈs a h a n
banua	ˈb a n u a̯
asinkronus	a . s ɪ n . ˈk r ɔ n . ʊ s
z	z
perlengkapan	p ə r . l ə ŋ . ˈk a p . a n
torsi	t o r . s i
astronaut	a s t r o n a u̯ t̚
mampu	m a m p u
pengendali	p ə . ŋ ə n . ˈd a . l i
gagal	ˈɡ a . ɡ a l
fotosel	f o ˈt o s ɛ l
jentera	d͡ʒ ə n t ə r a
dawat	ˈd a w a t̚
membaca	m ə m ˈb a t͡ʃ a
senter	ˈs ɛ n t ə r
balak	ˈb a l a ʔ
sehat	s ɛ h a t̚
awet	ˈa . w ɛ t
pengacakan	p ə ŋ . ˈa t͡ʃ a k . a n
mazbah	ˈm a z b a h
gender	ˈɡ ɛ n d ə r
kartografer	k a r t o ˈɡ r a f ə r
kompleks	ˈk ɔ m p l ɛ k s
aboi	ˈa . b o i̯
tahun	ˈt a . h ʊ n
kaliks	ˈk a l ɪ k s
propana	p r o . p a . n a
administratur	a t̚ m i n ɪ s t r a t ʊ r
anggong	ˈa ŋ ɡ ɔ ŋ
yen	j ɛ n
pemuliaan	p ə m u ˈl i a̯ a n
September	s ɛ p̚ . ˈt ɛ m . b ə r
teokrasi	t e o ˈk r a s i
handelar	h a n ˈd ə l a r
yakitori	j a . k i . t o . r i
mol	ˈm ɔ l
wihara	w i . h a . r a
deduksi	d e ˈd ʊ k s i
insidental	ɪ n . s i . ˈd ɛ n . t a l
penganjur	p ə ŋ ˈa n d͡ʒ ʊ r
jauhar	ˈd͡ʒ a u̯ h a r
sudah	ˈs u d a h
kuat	ˈk u a t̚
pertemuan	p ə r . t ə . ˈm u . a n
memunculkan	m ə . m u n . t͡ʃ ʊ l . k a n
menghadap	m ə ŋ . ˈh a . d a p
alasan	ˈa l a s a n
bawang	ˈb a w a ŋ
seru	s ə ˈr u
kutang	k u . t a ŋ
gulud	ˈɡ u l ʊ t̚
ekonomis	ɛ k o ˈn o m ɪ s
alel	ˈa . l ɛ l
kultivar	k ʊ l . ˈt i . v a r
utama	ˈu t a m a
rembesan	r ə m b ə s ˈa n
PR	p ɛ . ɛ r
ganti	ɡ a n . t i
Juni	ˈd͡ʒ u . n i
polimer	p o . ˈl i . m ɛ r
mencekokkan	m ə n . t͡ʃ ə . k o ʔ . k a n
akte	a k̚ t ə
kacung	ˈk a t͡ʃ ʊ ŋ
aftab	ˈa f t a p̚
elektris	ɛ l ɛ k . t r ɪ s
kubak	ˈk u b a ʔ
audit	ˈa u̯ . d ɪ t
aji	ˈa d͡ʒ i
pangkuan	p a ŋ ˈk u a n
tustel	t u s . t ɛ l
endapan	ə n ˈd a p a n
angpao	a ŋ . p a o
empal	ə m . ˈp a l
limit	ˈl i m ɪ t̚
kosakata	k o . s a . ˈk a . t a
target	ˈt a r ɡ ɛ t̚
cakrawala	t͡ʃ a k . r a . w a . l a
falak	ˈf a l a k̚
banjir	ˈb a n . d͡ʒ ɪ r
gundik	ˈɡ u n d i ʔ
debu	d ə ˈb u
coker	ˈt͡ʃ o k ə r
bawah	ˈb a w a h
kecap	k ɛ t͡ʃ a p
gejala	ɡ ə . ˈd͡ʒ a . l a
berjibaku	b ə r . d͡ʒ i . b a . k u
blumbak	ˈb l ʊ m b a k̚
tirta	t i r . t a
pekerjaan	p ə . k ə r . d ʒ a . ʔ a n
auban	a u . b a n
anggi	ˈa ŋ ɡ i
sein	s e ɪ̯ n
terorisme	t e . r ɔ r . ˈɪ s . m ə
ansambel	a n ˈs a m b ə l
mizab	ˈm i z a p̚
aerasi	a e ˈr a s i
kandung	ˈk a n d ʊ ŋ
pemanfaatan	p ə . m a n . f a . ˈa t . a n
Jumat	d͡ʒ ʊ m . ʔ a t
aplikan	a p̚ ˈl i k a n
tato	ˈt a t o
uduk	ˈu . d ʊ k
lateral	l a . t ə . ˈr a l
anggas	ˈa ŋ ɡ a s
muluk	ˈm u . l ʊ ʔ
slank	s l ɑ ŋ k
pramulansia	p r a . m u . l a n . s i a
sekong	s e . k o ŋ
patriarkat	p a . t r i . ˈa r . k a t̚
balo	ˈb a l o
darah	ˈd a r a h
kemudahan	k ə m u ˈd a h a n
hewani	h e ˈw a n i
voli	ˈv o . l i
kini	ˈk i n i
harmonisasi	h a r . m o . n i . ˈs a . s i
pemandian	p ə m a n ˈd i a n
devisa	d e . ˈv i . s a
gempa	ɡ ə m ˈp a
kenceng	k ə n . t͡ʃ ə ŋ
lekong	l e . k o ŋ
maljum	ˈm a l d͡ʒ u m
yudisium	j u d i ˈs i ʊ m
aktivisme	a k̚ t i v ɪ s m ə
kedaton	k ə ˈd a t ɔ n
blek	b l ɛ k
tar	t a r
impulsivitas	ɪ m . p ʊ l . s i . ˈv i . t a s
asonisoni	a . s o . n i . ˈs o . n i
pengumuman	p ə ŋ u ˈm ʊ m a n
ditemukan	d i t ə ˈm u k a n
pranatal	p r a . ˈn a . t a l
staf	s t a f
agraris	ˈa ɡ r a r ɪ s
alfa	ˈa l . f a
sapa	ˈs a . p a
kudeta	k u ˈd ɛ t a
cuek	c u e ʔ
sumatif	s u . ˈm a . t ɪ f
akseptasi	a k . s ɛ p . ˈt a . s i
sembrono	s ə m . ˈb ə̆ r o . n o
duren	ˈd u . r ɛ n
asin	ˈa s ɪ n
PM	ˈp e ɛ m
seorang	s ə . o . r a ŋ
kolektivisme	k o l ɛ k t i ˈv ɪ s m ə
alot	ˈa l ɔ t̚
senantiasa	s ə n a n t i ˈa s a
tegak	t ə ˈɡ a k̚
rasional	r a s i ˈo n a l
sarana	s a . r a . n a
provos	ˈp r o v ɔ s
lemper	ˈl ə m p ə r
paleontologi	p a . l e . ɔ n . t o . ˈl o . ɡ i
asmaraguna	a s . m a . r a . ˈɡ u . n a
sekat	s ə . ˈk a t̚
ASEAN	a ˈs e a n
japri	d͡ʒ a . p r i
adoptif	ˈa d ɔ p . t ɪ f
batara	b a . t a . r a
finansial	f i n a n ˈs i a l
ligan	ˈl i . ɡ a n
kau	k a u̯
menit	m ə ˈn ɪ t
laknat	ˈl a k n a t̚
sungut	ˈs u ŋ ʊ t
menikah	m ə n i k a h
puji	p u . d͡ʒ i
pemda	p ə m ˈd a
ansos	a n . s o s
panjang	ˈp a n d͡ʒ a ŋ
antigen	a n . ˈt i . ɡ ɛ n
kardiogram	k a r . d i . ˈo . ɡ r a m
duktus	ˈd ʊ k̚ t ʊ s
genderuwo	ɡ ə n . d ə . ˈr u . w o
sentralistis	s ɛ n t r a ˈl ɪ s t ɪ s
syahbandar	ʃ a h . b a n . d a r
derita	d ə . r i . t a
inset	i n s ɛ t
ateisme	a t e ˈɪ s m ə
sana	ˈs a n a
Anatolia	a . n a . t o . ˈl i . a
margin	ˈm a r . ɡ ɪ n
romusa	r o . m u . s a
heterotrof	h e . t e . r o . t r o f
resep	r ə ˈs ɛ p
gang	ɡ a ŋ
angkrok	ˈa ŋ k r ɔ k̚
cucu	ˈt͡ʃ u . t͡ʃ u
bangsa	b a ŋ . s a
nyaman	ˈɲ a m a n
membawa	m ə m ˈb a w a
Habel	h a b e l
kredo	ˈk r e . d o
plak	p l a k
lipat	ˈl i . p a t̚
cengkerawak	t͡ʃ ə ŋ . k ə . r a . w a k
gempita	ɡ ə m . p i . t a
pekan	p ə k a n
sosialisme	s o s i a l ˈɪ s m ə
harus	h a . r ʊ s
pelanggar	p ə . ˈl a ŋ . ɡ a r
sake	s a . k e
saset	ˈs a s ɛ t
afdeling	a f . d e . l i ŋ
khizanatulkitab	x i z a n a t ʊ l ˈk i t a p̚
kaji	k a d͡ʒ i
KY	ˈk a j e
keseruan	k ə s ə ˈr u a n
fajar	ˈf a d͡ʒ a r
terwelu	t ə r ˈw ɛ . l u
kandil	ˈk a n . d ɪ l
majelis	m a ˈd͡ʒ ə l ɪ s
jataka	d͡ʒ a ˈt a k a
mendasar	m ə n ˈd a s a r
didik	d i d ɪ ʔ
proklamasi	p r o k l a ˈm a s i
katun	ˈk a t u n
wanprestasi	w a n p r e s t a s i
telur	t ə ˈl u r
keripik	k ə ˈr i p ɪ k̚
hijriah	h i d͡ʒ r i a h
geman	ɡ ə ˈm a n
ambir	ˈa m b ɪ r
eksperimen	ɛ k s p ɛ ˈr i m ɛ n
berkap	b ə r ˈk a p̚
apanase	a p a ˈn a s ə
hijrah	h i d͡ʒ r a h
sanggah	ˈs a ŋ ɡ a h
fasakh	ˈf a s a ʔ
memola	m ə ˈm o l a
papan	ˈp a p a n
emas	ə m a s
letak	l ə ˈt a ʔ
duit	d u . i t
suiseki	s u i . s e . k i
asyik	a . ʃ ɪ k
kenek	k ə ˈn ɛ k
romo	ˈr o m o
metana	m ɛ . t a . n a
lajur	ˈl a d͡ʒ u r
wazari	w a . z a . r i
pesumo	p ə . s u . m o
betik	b ə . ˈt ɪ k
penyederhanaan	p ə . ɲ ə . d ə r . h a . ˈn a . a n
frekwensi	f r e k . w ɛ n . s i
KK	k a . k a
amben	ˈa m b ə n
candra	t͡ʃ a n . d r a
ensiklopedi	ɛ n s i k l o ˈp ɛ d i
bushido	b u s . h i . d o
lihat	l i h a t̚
perunggu	p ə . ˈr ʊ ŋ . ɡ u
keponakan	k ə p o ˈn a k a n
zalim	ˈz a l ɪ m
losin	ˈl o . s i n
lokapasar	l o k a ˈp a s a r
julang	ˈd͡ʒ u l a ŋ
versi	ˈv ɛ r s i
tenggelam	t ə ŋ ɡ ə ˈl a m
hechting	h ɛ k̚ t ɪ ŋ
masih	m a . s i h
hadap	ˈh a d a p̚
desalinasi	d e . s a . l i . ˈn a . s i
kuadran	ˈk u a̯ d r a n
linier	l i ˈn i ɛ r
lanjar	ˈl a n d͡ʒ a r
samcan	s a m . t͡ʃ a n
endorsemen	ɛ n . d ɔ r . s ə . ˈm ɛ n
semayam	s ə ˈm a j a m
gandeng	ˈɡ a n . d ɛ ŋ
punca	ˈp ʊ n . t͡ʃ a
menyanggah	m ə ˈɲ a ŋ ɡ a h
romusya	r o . m u . ʃ a
katak	ˈk a t a ʔ
angko	ˈa ŋ k o
perut	p ə . ˈr ʊ t̚
bel	b ɛ l
jajahan	d͡ʒ a ˈd͡ʒ a h a n
hedon	h e . d o n
resesi	r ɛ ˈs ɛ s i
seronok	s ə . ˈr o . n ɔ ʔ
contoh	ˈt͡ʃ ɔ n t ɔ h
kastil	k a s . t ɪ l
menatapi	m ə . n a . t a p . i
rumus	ˈr u m ʊ s
asiri	ˈa s i r i
setempat	s ə t ə m ˈp a t̚
demografi	d e m o ˈɡ r a f i
lama	l a . m a
antardesa	a n t a r ˈd ɛ s a
tawakal	t a ˈw a k a l
transfigurasi	t r a n s f i ɡ u ˈr a s i
instruktur	ɪ n . ˈs t r ʊ k . t ʊ r
konsul	ˈk ɔ n s ʊ l
adutan	ˈa d ʊ t a n
asal	ˈa . s a l
hidayah	h i ˈd a j a h
mandraguna	m a n . d r a . ˈɡ u . n a
angkatan	a ŋ ˈk a t a n
udon	u . d o n
kosmonaut	k ɔ s m o n a u̯ t̚
bruder	b r u d ə r
luka	ˈl u k a
paus	ˈp a ʊ s
sanggul	s a ŋ . ɡ ʊ l
raba	ˈr a b a
hindar	ˈh ɪ n . d a r
instrumental	ɪ n . s t r u . ˈm ɛ n . t a l
tepis	t ə . ˈp ɪ s
istibra	ɪ s ˈt ɪ p r a ʔ
fleksibel	f l ɛ k . ˈs i . b ə l
onigiri	o . n i . ɡ i . r i
kadaver	k a . d a . v ə r
bugil	ˈb u ɡ ɪ l
basmati	b a s ˈm a t i
ucul	u . t͡ʃ u l
mangkat	ˈm a ŋ k a t̚
vasokonstriksi	v a s o k ɔ n s ˈt r ɪ k s i
makna	ˈm a ʔ n a
pelarian	p ə . l a . ˈr i . a n
pecut	p ə . ˈt͡ʃ ʊ t
pecahan	p ə . t͡ʃ a . h a n
siluet	s i . ˈl u . ɛ t
artropoda	a r t r o ˈp o d a
selalu	s ə l a l u
beton	b ə . t o n
berida	b ə . r i . d a
kelengkiak	k ə l ə ŋ ˈk i a k̚
perasaan	p ə r a ˈs a a n
selada	s a l a d a
defleksi	d e . ˈf l ɛ k . s i
sentimen	s ɛ n . ˈt i . m ɛ n
bengkel	ˈb ɛ ŋ k ɛ l
bancak	b a n t͡ʃ a ʔ
honji	h o n . d͡ʒ i
perpanjangan	p ə r p a n ˈd͡ʒ a ŋ a n
cerpelai	t͡ʃ ə r ˈp ə l a j
sentral	ˈs ɛ n t r a l
goniometri	ɡ o . n i . o . ˈm e . t r i
penganiaya	p ə ŋ a n i a j a
ketahanan	k ə t a ˈh a n a n
pecutan	p ə ˈt͡ʃ ʊ t a n
visa	ˈv i s a
kekasih	k ə ˈk a s ɪ h
KTT	k a . ˈt e . t e
keibodan	k e i . b o . d a n
mentol	ˈm ɛ n . t ɔ l
jurang	ˈd͡ʒ u . r a ŋ
dadih	d a . d i h
anghun	a ŋ . h u n
darat	ˈd a r a t
muka	m u k a
lima	ˈl i . m ä
lantamil	l a n ˈt a m ɪ l
nila	n i . l a
mahram	ˈm a h r a m
bukak	ˈb u k a k̚
penanggalan	p ə n a ŋ ˈɡ a l a n
onagata	o . n a . ɡ a . t a
arunika	a . r u . ˈn i . k a
sambungan	s a m . ˈb ʊ ŋ . a n
pernah	p ə r . n a h
grup	ˈɡ r ʊ p̚
sengsai	s ɛ ŋ . s a i
bulu	ˈb u . l u
bradikardia	b r a . d i . ˈk a r . d i a̯
Rabu	r a . b u
madrasah	m a d ˈr a s a h
daitia	d a i . t i a
sistemis	s ɪ s . ˈt e . m ɪ s
pulau	ˈp u l a u̯
menyiarkan	m ə ɲ i a r k a n
montase	m ɔ n . ˈt a . s ə
memberi	m ə m b ə r i
puri	p u . r i
ayah	a . j a h
bakcang	b a ʔ . t͡ʃ a ŋ
hiu	ˈh i . u
dicatat	d i ˈt͡ʃ a t a t̚
bujangga	b u . d͡ʒ a ŋ . ɡ a
meraja	m ə r a d͡ʒ a
jasmani	d͡ʒ a s ˈm a n i
rasuah	r a . s u . a h
sanawiah	s a n a ˈw i a h
pejamu	p ə . ˈd͡ʒ a . m u
adempauze	a d ə m . p a u̯ . z ə
digdaya	d i ɡ . d a . j a
geostasioner	ɡ e o s t a s i ˈo n ɛ r
eksipien	ɛ k . s i . ˈp i . ɛ n
kolega	k o ˈl e ɡ a
Habil	h a b ɪ l
aborsi	ˈa b ɔ r s i
laki	ˈl a k i
stereotipe	s t e r e o ˈt i p ə
cerita	t͡ʃ ə . r i . t a
herbarium	h ɛ r . b a . ˈr i . ʊ m
steker	a b o n ə m ɛ n
berambang	b ə . ˈr a m . b a ŋ
duri	ˈd u . r i
agihan	a ɡ i h a n
tapa	t a . p a
Shinto	ʃ i n . t o
kedutaan	k ə d u t a a n
kebupatian	k ə b u p a ˈt i a n
gereja	ɡ ə ˈr ɛ d͡ʒ a
gunseikan	ɡ u n . s e i . k a n
sadir	ˈs a d ɪ r
coli	t͡ʃ o . l i
argentum	a r . ˈɡ ɛ n . t ʊ m
kerosin	k e ˈr o s ɪ n
rektum	ˈr ɛ k̚ t ʊ m
ambekpati	a m b ə k̚ ˈp a t i
benzol	b e n . z o l
abu	a b u
cakalang	t͡ʃ a . ˈk a . l a ŋ
langau	l a ŋ a u̯
agih	ˈa ɡ ɪ h
infeksius	ɪ n . f ɛ k . ˈs i . ʊ s
ambataron	a m b a ˈt a r ɔ n
sini	ˈs i n i
autokrasi	a u t o k r a s i
lenjer	l ə n ˈd͡ʒ ə r
wewenang	w ə . w ə . ˈn a ŋ
aora	a . ˈo . r a
takeyari	t a . k e . y a . r i
bayu	b a j u
wafat	ˈw a f a t̚
perolehan	p ə r o ˈl ɛ h . a n
penganggaran	p e ŋ . a ŋ . ˈɡ a r . a n
humanis	h u . ˈm a . n ɪ s
sopir	ˈs o p ɪ r
kabuki	k a ˈb u k i
pemompaan	p ə m ɔ m ˈp a a n
SAKIP	ˈs a k ɪ p̚
Ngawi	ŋ a ˈw i
ragu	ˈr a ɡ u
kolusi	k o ˈl u s i
balugut	b a ˈl u ɡ ʊ t̚
geulis	ɡ ɘ . ˈl ɪ s
ajara	ˈa d͡ʒ a r a
ekstrapolasi	ɛ k s . t r a . p o . ˈl a . s i
kelar	k ə . l a r
paro	ˈp a r o
mendengar	m ə n . d ə . ŋ a r
komandan	k o . m a n . d a n
Malingsia	m ä l ɪ ŋ . s i a
industri	ɪ n . ˈd ʊ s . t r i
kabupaten	k a . b u . p a . t e n
aruris	a . ˈr u . r ɪ s
digali	ˈd i . ɡ a l i
graf	ˈɡ r a f
wizurai	w i ˈz u r a i̯
pialang	ˈp ɪ j a l a ŋ
tertinggal	t ə r ˈt ɪ ŋ ɡ a l
soleh	ˈs o . l ɛ h
gagah	ˈɡ a . ɡ a h
sepupu	s ə p u p u
arya	a r . j a
angin	ˈa ŋ i n
kobak	ˈk o b a ʔ
bersama	b ə r s a m a
argiria	a r ˈɡ i r i a̯
sepatu	s ə . p a . t u
akelit	ˈa k ɛ l ɪ t̚
anvian	a n . ˈv i . a n
pelatihan	p ə l a ˈt ɪ h a n
N	ɛ n
mengendalikan	m ə . ŋ ə n . d a . l i . k a n
besikal	b ə ˈs i . k a l
takikardia	t a . k i . ˈk a r . d i a̯
graha	ɡ r a . h a
lepra	l ɛ p r a
G	ɡ e
jelata	d͡ʒ ə . l a . t a
lajak	ˈl a d͡ʒ a k̚
koneksi	k o n ɛ k s i
celaan	t͡ʃ ə ˈl a a n
bibit	ˈb i b ɪ t̚
kor	ˈk ɔ r
badare	b a . ˈd a . r ə
tebang	t ə . ˈb a ŋ
A	a
badi	ˈb a d i
galer	ɡ a . l e r
jasuke	d͡ʒ a ˈs u k e
panduan	p a n . ˈd u . a n
silet	ˈs i l ɛ t̚
pelepah	p ə . l ə . ˈp a h
kriptogamik	k r ɪ p t o ˈɡ a m ɪ k
yakni	ˈj a ʔ n i
monarki	m o ˈn a r k i
pembelahan	p ə m b ə ˈl a h a n
amau	a b u
iotasisme	i o t a ˈs ɪ s m ə
maka	ˈm a k a
betonase	b ə t o ˈn a s ə
danau	d a n a u̯
dolar	ˈd o l a r
benda	b ə n . d a
anjing	ˈa n d͡ʒ i ŋ
pemberontakan	p ə m b ə r ɔ n ˈt a k a n
menampilkan	m ə n a m p i l k a n
sakelar	s a . k ə . l a r
layu	ˈl a . j u
mulai	m u . l a i̯
qanun	q a n u n
lawan	l a . w a n
biliun	b i ˈl i ʊ n
maja	ˈm a d͡ʒ a
lansia	l a n ˈs i a
aporia	a . p o . ˈr i . a
wicara	w i . t͡ʃ a . r a
pakaian	p a ˈk a j a n
kasuistik	k a s u ˈɪ s t ɪ k̚
alami	ˈa l a m i
itu	ˈi t u
akhlak	ˈa x l a k
kilang	k i l a ŋ
sambilan	s a m . ˈb ɪ l . a n
heng	h ɛ ŋ
Perak	ˈp ɛ . ɾ ʌ ʔ
sa	s a
lalat	ˈl a . l a t̚
biro	b i . r o
pacu	ˈp a . t͡ʃ u
reforestasi	r e f o r ɛ s ˈt a s i
elang	ˈə l a ŋ
afirmasi	a f ɪ r ˈm a s i
gaga	ˈɡ a . ɡ a
piranti	p i ˈr a n t i
zikir	ˈz i k ɪ r
cenderasa	t͡ʃ ə n . d ə . r a . s a
sewu	s e . w u
kaprodi	k a . ˈp r o . d i
raksasa	r a k ˈs a s a
kusta	k ʊ s t a
kring	k r ɪ ŋ
seudati	s ɘ ˈd a t i
anapaso	a n a ˈp a s o
teh	ˈt ɛ h
memberantakkan	m ə m . b ə . r a n . t a k . k a n
sayur	s a j u r
ancuan	a n ˈt͡ʃ u a n
burung	ˈb u . r ʊ ŋ
duli	d u l i
dirgahayu	d i r . ɡ a . h a . j u
Bibel	ˈb i . b ə l
matkul	m a t . k ʊ l
komplot	k o m p l o t
sagu	ˈs a ɡ o
jumlah	ˈd͡ʒ ʊ m l a h
membranofon	m ɛ m b r a ˈn o f ɔ n
taju	ˈt a d͡ʒ u
kewarganegaraan	k ə w a r ɡ a n ə ɡ a ˈr a a n
praktek	ˈp r a k̚ t ɛ k̚
plan	p l a n
ilah	ˈɪ l a h
engkau	ə ŋ k a u̯
asumsi	a ˈs ʊ m s i
bayangan	b a ˈj a ŋ a n
babatan	b a . ˈb a t . a n
parwa	ˈp a r w a
paru	ˈp ä . r u
ken	k ɛ n
rokok	ˈr o k o ʔ
hayati	h a . j a . t i
pengudaraan	p ə ŋ u d a ˈr a a n
jeneng	ˈd͡ʒ ɛ . n ɛ ŋ
edisi	ˈɛ d i s i
dua	ˈd u w ä
kuy	ˈk u j
Kristen	ˈk r ɪ s . t ə n
nahas	ˈn a h a s
ramal	r a m a l
margarin	m a r ˈɡ a r ɪ n
daras	d a r a s
cerca	t͡ʃ ə r . t͡ʃ a
dewa	d ɛ . w a
Batam	ˈb a t a m
khalayak	x a ˈl a j a ʔ
bahwa	b a h . w a
Ahad	ˈa h a t̚
memproklamasikan	m ə m p r o k l a m a ˈs i k a n
bagian	b a ˈɡ iʲ a n
nekrokrasi	n e k r o k r a s i
syahadat	ʃ a ˈh a . d a t̚
bisban	ˈb ɪ s b a n
apakah	a p a . k a h
mengabadi	m ə ŋ . a . b a . d i
terlalu	t ə r l a l u
alamete	a l a ˈm ɛ t e
tahu	ˈt a u
tuwung	ˈt ʊ w ʊ ŋ
lencang	l ə n ˈt͡ʃ a ŋ
tunang	ˈt u . n a ŋ
aslosin	a s . ˈl o . s ɪ n
buta	b u . t a
syabas	ˈʃ a . b a s
Indo	ˈɪ n d o
Betawi	b ə t a w i
Belarusia	b e l a ˈr u s i a̯
reanimasi	r e a n i m a s i
indekos	i n d ə ˈk ɔ s
suket	ˈs u k ə t̚
ponpes	ˈp ɔ n p ə s
buku	ˈb u k u
frater	f r a t ə r
berpulang	b ə r ˈp u l a ŋ
aktan	ˈa k̚ t a n
mengabsen	m ə ŋ . a p . s e n
tersebar	t ə r s ə ˈb a r
perdana	p ə r d a n a
baksis	ˈb a k s ɪ s
algojo	a l ˈɡ o d͡ʒ o
perdarahan	p ə r . d a . ˈr a h . a n
pembohong	p ə m . b o . h o n ɡ
arupera	a . r u . ˈp e . r a
gemuk	ˈɡ ə m ʊ ʔ
peka	ˈp e . k a
asalamualaikum	a s . s a . ˌl a m . m u . a . l a j ˈk u m
klasikal	k l a ˈs ɪ k . a l
bihun	b i . h u n
calon	ˈt͡ʃ a . l o n
malam	ˈm a l a m
palisade	p a l i ˈs a d ə
antarpemain	a n t a r p ə ˈm a ɪ n
jangan	d͡ʒ a ŋ a n
laskar	l a s ˈk a r
petahana	p ə t a ˈh a n a
perkara	p ə r . k a . r a
i	i
frekuensi	f r e k u ˈɛ n s i
ajar	a . d͡ʒ a r
sitoplasma	s i t o ˈp l a s m a
tangkap	ˈt a ŋ k a p̚
antik	a n . t i k
makalah	m a . ˈk a . l a h
handuk	h a n d ʊ k̚
dunia	d u . n i . a
jelita	d͡ʒ ə l i t a
menyebar	m ə ɲ ə ˈb a r
bea	ˈb e a̯
ramai	ˈr a m a i̯
jernih	d͡ʒ ə r ˈn i h
dana	d a . n a
pembakuan	p ə m . b a . ˈk u . a n
tentu	t ə n ˈt u
jawab	d͡ʒ a . w a p̚
mukminat	m ʊ ʔ ˈm i n a t̚
jerami	d͡ʒ ə ˈr a m i
anyam	ˈa ɲ a m
suf	ˈs ʊ f
curah	ˈt͡ʃ u . r a h
suka	ˈs u k a
lubang	ˈl u b a ŋ
mengingat	m ə ŋ ˈɪ ŋ a t̚
tatap	t a . t a p̚
pandemi	p a n ˈd e m i
I	i
inventaris	ɪ n . v ɛ n . ˈt a . r ɪ s
bina	ˈb i n a
ajaran	a d͡ʒ a r a n
disposisi	d i s . p o . s i . s i
eklips	ɛ k . l i p s
pola	ˈp o l a
bakero	b a k e r o
damkar	d a m . k a r
aeropolis	a e r o ˈp o l ɪ s
esa	ə . s a
mantul	ˈm a n t ʊ l
ulam	ˈu . l a m
kais	ˈk a . ɪ s
orang	o . r a ŋ
hipotenusa	h i p o t ə ˈn u s a
cam	ˈt͡ʃ a m
akar	a . k a r
nestapa	n ə s ˈt a p a
teori	t e o r i
gada	ɡ a d a
loper	l o . p ə r
menggarisi	m ə ŋ . ɡ a . r i s . i
andam	ˈa n d a m
penerapan	p ə . n ə . ˈr a p . a n
liyan	ˈl i j a n
lobak	l o . b a k
sembilan	s ə m . ˈb i . l ä n
altitudo	a l t i ˈt u d o
polah	ˈp o l a h
Arab	ˈa r a p̚
baronsai	b a . r o n . s a i̯
juta	d͡ʒ u t a
terbesar	t ə r b ə ˈs a r
timah	ˈt i m a h
ditangkap	d i ˈt a ŋ k a p̚
saja	ˈs a d͡ʒ a
fatwa	ˈf a t . w a
swafoto	s w a . f o . t o
jamur	ˈd͡ʒ a . m ʊ r
fonemis	f o ˈn e m ɪ s
ampor	ˈa m p ɔ r
planologi	p l a n o ˈl o ɡ i
timur	t i m ʊ r
memutakhirkan	m ə m u t a x i r k a n
utara	u t a r a
ameto	a . ˈm e . t o
uber	u b ə r
baiduri	b a i̯ . d u . r i
kening	ˈk ə . n ɪ ŋ
mukminin	m ʊ ʔ ˈm i n ɪ n
ramalan	r a . ˈm a l . a n
jangankan	d͡ʒ a . ŋ a n . k a n
kebugaran	k ə . b u . ˈɡ a r . a n
gelar	ɡ ə . ˈl a r
klem	ˈk l ɛ m
herbisida	h ɛ r b i ˈs i d a
anjal	ˈa n d͡ʒ a l
endap	ə n . ˈd a p
hibah	ˈh i b a h
keterangan	k ə . t ə . r a . ŋ a n
toh	ˈt ɔ h
puas	ˈp u a s
peduli	p ə d u l i
babango	b a . ˈb a . ŋ o
mula	m u l a
resistansi	r e s ɪ s ˈt a n s i
