ruralidad	r u ɾ a l i ˈd a d
difónicas	d i ˈf o n i k a s
cautelados	k a u t e ˈl a d o s
proclamados	p ɾ o k l a ˈm a d o s
abajáremos	a b a ˈx a ɾ e m o s
paracaidista	p a ɾ a k a i ˈd i s t a
comprará	k o m p ɾ a ˈɾ a
Cordillera	k o ɾ d i ˈʝ e ɾ a
desfogados	d e s f o ˈɡ a d o s
esprín	e s ˈp ɾ i n
amigdalectomía	a m i ɡ d a l e ɡ t o ˈm i a
Cardona	k a ɾ ˈd o n a
insumir	i n s u ˈm i ɾ
jugadas	x u ˈɡ a d a s
substituidos	s u b s t i ˈt w i d o s
regido	r e ˈx i d o
repostear	r e p o s t e ˈa ɾ
disputáramos	d i s p u ˈt a ɾ a m o s
libreta	l i ˈb ɾ e t a
apellidada	a p e ʝ i ˈd a d a
disputable	d i s p u ˈt a b l e
solaré	s o l a ˈɾ e
notro	ˈn o t ɾ o
estrígiles	e s ˈt ɾ i x i l e s
tomatico	t o m a ˈt i k o
leninistas	l e n i ˈn i s t a s
angelino	a n x e ˈl i n o
sopladas	s o ˈp l a d a s
ahusados	a u ˈs a d o s
onde	ˈo n d e
desafecta	d e s a ˈf e ɡ t a
fotografiados	f o t o ɡ ɾ a ˈf j a d o s
traficante	t ɾ a f i ˈk a n t e
parafraseadas	p a ɾ a f ɾ a s e ˈa d a s
clic	ˈk l i k
taponear	t a p o n e ˈa ɾ
catalogadora	k a t a l o ɡ a ˈd o ɾ a
andén	a n ˈd e n
depredados	d e p ɾ e ˈd a d o s
colectivista	k o l e ɡ t i ˈb i s t a
trapera	t ɾ a ˈp e ɾ a
deformar	d e f o ɾ ˈm a ɾ
runa	ˈr u n a
taquito	t a ˈk i t o
fijar	f i ˈx a ɾ
castigados	k a s t i ˈɡ a d o s
Tomasa	t o ˈm a s a
monitorear	m o n i t o ɾ e ˈa ɾ
cuasidelito	k w a s i d e ˈl i t o
fosforilaras	f o s f o ɾ i ˈl a ɾ a s
contrarrestadas	k o n t ɾ a r e s ˈt a d a s
biodinámicos	b i o d i ˈn a m i k o s
desintegrar	d e s i n t e ˈɡ ɾ a ɾ
malévolo	m a ˈl e b o l o
autarquía	a u t a ɾ ˈk i a
trapito	t ɾ a ˈp i t o
germanio	x e ɾ ˈm a n j o
hanguear	a n ɡ e ˈa ɾ
fariano	f a ˈɾ j a n o
digestible	d i x e s ˈt i b l e
adores	a ˈd o ɾ e s
contrariado	k o n t ɾ a ˈɾ j a d o
presupuestario	p ɾ e s u p w e s ˈt a ɾ j o
extrusiva	e ɡ s t ɾ u ˈs i b a
bagual	b a ˈɡ w a l
Fani	ˈf a n i
chapurreados	t͡ʃ a p u r e ˈa d o s
baeneras	b a e ˈn e ɾ a s
disparado	d i s p a ˈɾ a d o
nihilismo	n i i ˈl i s m o
empoderadas	e m p o d e ˈɾ a d a s
putrefactas	p u t ɾ e ˈf a ɡ t a s
anhedonia	a n e ˈd o n j a
aduana	a ˈd w a n a
sobresaltar	s o b ɾ e s a l ˈt a ɾ
formaldehido	f o ɾ m a l ˈd e i d o
ensalada	e n s a ˈl a d a
abluidas	a ˈb l w i d a s
ventoseado	b e n t o s e ˈa d o
amillararemos	a m i ʝ a ɾ a ˈɾ e m o s
taheño	t a ˈe ɲ o
Shanghái	ʃ a n ˈɡ a i
bebienda	b e ˈb j e n d a
preaviso	p ɾ e a ˈb i s o
calesa	k a ˈl e s a
lamentaste	l a m e n ˈt a s t e
hollado	o ˈʝ a d o
yudoca	ʝ u ˈd o k a
nanorrobot	n a n o r o ˈb o t
ilegitimidad	i l e x i t i m i ˈd a d
detectados	d e t e ɡ ˈt a d o s
indumentaria	i n d u m e n ˈt a ɾ j a
alcano	a l ˈk a n o
abastada	a b a s ˈt a d a
comandados	k o m a n ˈd a d o s
argüíais	a ɾ ˈɡ w i a i s
góndola	ˈɡ o n d o l a
puterío	p u t e ˈɾ i o
brótola	ˈb ɾ o t o l a
resolladas	r e s o ˈʝ a d a s
artrósico	a ɾ ˈt ɾ o s i k o
desagradadas	d e s a ɡ ɾ a ˈd a d a s
agüé	a ˈɡ w e
farero	f a ˈɾ e ɾ o
reintensificado	r e i n t e n s i f i ˈk a d o
pisamos	p i ˈs a m o s
bolómetros	b o ˈl o m e t ɾ o s
cantalupo	k a n t a ˈl u p o
premeditar	p ɾ e m e d i ˈt a ɾ
Araujo	a ˈɾ a u x o
mosquear	m o s k e ˈa ɾ
agostino	a ɡ o s ˈt i n o
pegón	p e ˈɡ o n
dinamita	d i n a ˈm i t a
Pireo	p i ˈɾ e o
lama	ˈl a m a
espectrómetros	e s p e ɡ ˈt ɾ o m e t ɾ o s
alavesista	a l a b e ˈs i s t a
Yoro	ˈʝ o ɾ o
emirato	e m i ˈɾ a t o
empapelar	e m p a p e ˈl a ɾ
lisosómico	l i s o ˈs o m i k o
ladrido	l a ˈd ɾ i d o
jurídico	x u ˈɾ i d i k o
llamarlos	ʝ a ˈm a ɾ l o s
cantándoos	k a n ˈt a n d o o s
infiltrante	i n f i l ˈt ɾ a n t e
atribular	a t ɾ i b u ˈl a ɾ
prever	p ɾ e ˈb e ɾ
chucho	ˈt͡ʃ u t͡ʃ o
temblequeado	t e m b l e k e ˈa d o
torrada	t o ˈr a d a
indignidad	i n d i ɡ n i ˈd a d
Marsella	m a ɾ ˈs e ʝ a
alojara	a l o ˈx a ɾ a
fisgoneados	f i s ɡ o n e ˈa d o s
pavo	ˈp a b o
rascador	r a s k a ˈd o ɾ
aireadas	a i ɾ e ˈa d a s
Cauquenes	k a u ˈk e n e s
profundidad	p ɾ o f u n d i ˈd a d
policromas	p o l i ˈk ɾ o m a s
variables	b a ˈɾ j a b l e s
esponjaren	e s p o n ˈx a ɾ e n
carcanapire	k a ɾ k a n a ˈp i ɾ e
designado	d e s i ɡ ˈn a d o
procrastinar	p ɾ o k ɾ a s t i ˈn a ɾ
lobulillar	l o b u l i ˈʝ a ɾ
triptongo	t ɾ i b ˈt o n ɡ o
garabateada	ɡ a ɾ a b a t e ˈa d a
Majagua	m a ˈx a ɡ w a
desnudamiento	d e s n u d a ˈm j e n t o
vermiculadas	b e ɾ m i k u ˈl a d a s
bodegonista	b o d e ɡ o ˈn i s t a
choquear	t͡ʃ o k e ˈa ɾ
avenarán	a b e n a ˈɾ a n
seriada	s e ˈɾ j a d a
programada	p ɾ o ɡ ɾ a ˈm a d a
autobombeados	a u t o b o m b e ˈa d o s
brasileñas	b ɾ a s i ˈl e ɲ a s
otolito	o t o ˈl i t o
m'ijo	ˈm i x o
mielodisplasia	m j e l o d i s ˈp l a s j a
consensuar	k o n s e n ˈs w a ɾ
fileteada	f i l e t e ˈa d a
resplandor	r e s p l a n ˈd o ɾ
deletreada	d e l e t ɾ e ˈa d a
deambuladas	d e a m b u ˈl a d a s
oncohematológico	o n k o e m a t o ˈl o x i k o
amentoflavona	a m e n t o f l a ˈb o n a
empreñador	e m p ɾ e ɲ a ˈd o ɾ
juguetonamente	x u ɡ e ˌt o n a ˈm e n t e
monoaural	m o n o a u ˈɾ a l
labial	l a ˈb j a l
operativo	o p e ɾ a ˈt i b o
autónomos	a u ˈt o n o m o s
capuchina	k a p u ˈt͡ʃ i n a
desvirtuados	d e s b i ɾ ˈt w a d o s
fornicamos	f o ɾ n i ˈk a m o s
salteado	s a l t e ˈa d o
alargamiento	a l a ɾ ɡ a ˈm j e n t o
penúltima	p e ˈn u l t i m a
elegible	e l e ˈx i b l e
desglose	d e s ˈɡ l o s e
rapsoda	r a b ˈs o d a
fontanería	f o n t a n e ˈɾ i a
semisedentario	s e m i s e d e n ˈt a ɾ j o
patchwork	ˈp a t͡ʃ w o ɾ k
flaubertianas	f l o b e ɾ ˈt j a n a s
plantares	p l a n ˈt a ɾ e s
imperará	i m p e ɾ a ˈɾ a
orbitadas	o ɾ b i ˈt a d a s
ecléctico	e ˈk l e ɡ t i k o
durados	d u ˈɾ a d o s
venerables	b e n e ˈɾ a b l e s
caed	k a ˈe d
volcadas	b o l ˈk a d a s
devotas	d e ˈb o t a s
prestatario	p ɾ e s t a ˈt a ɾ j o
hackearás	x a k e a ˈɾ a s
coreografiar	k o ɾ e o ɡ ɾ a ˈf j a ɾ
esquivares	e s k i ˈb a ɾ e s
okapi	o ˈk a p i
tricoto	t ɾ i ˈk o t o
riñón	r i ˈɲ o n
enfocados	e n f o ˈk a d o s
reargüidas	r e a ɾ ˈɡ w i d a s
votará	b o t a ˈɾ a
disputador	d i s p u t a ˈd o ɾ
tonos	ˈt o n o s
remara	r e ˈm a ɾ a
bilabial	b i l a ˈb j a l
chequeados	t͡ʃ e k e ˈa d o s
reinona	r e i ˈn o n a
catadas	k a ˈt a d a s
compartimentados	k o m p a ɾ t i m e n ˈt a d o s
dentaria	d e n ˈt a ɾ j a
encantadores	e n k a n t a ˈd o ɾ e s
quebracho	k e ˈb ɾ a t͡ʃ o
tirémoslas	t i ˈɾ e m o s l a s
galio	ˈɡ a l j o
limosneado	l i m o s n e ˈa d o
babélica	b a ˈb e l i k a
superaremos	s u p e ɾ a ˈɾ e m o s
cojinúa	k o x i ˈn u a
mal	ˈm a l
beguina	b e ˈɡ i n a
acábalos	a ˈk a b a l o s
amenguados	a m e n ˈɡ w a d o s
pielero	p j e ˈl e ɾ o
comprensivo	k o m p ɾ e n ˈs i b o
opinas	o ˈp i n a s
hipsómetros	i b ˈs o m e t ɾ o s
panarabista	p a n a ɾ a ˈb i s t a
chele	ˈt͡ʃ e l e
elaborados	e l a b o ˈɾ a d o s
continuando	k o n t i ˈn w a n d o
jactá	x a ɡ ˈt a
derribar	d e r i ˈb a ɾ
glaseado	ɡ l a s e ˈa d o
mirla	ˈm i ɾ l a
hidrométricas	i d ɾ o ˈm e t ɾ i k a s
posesivos	p o s e ˈs i b o s
espongiforme	e s p o n x i ˈf o ɾ m e
twittero	t w i ˈt e ɾ o
hidrográfico	i d ɾ o ˈɡ ɾ a f i k o
vieran	ˈb j e ɾ a n
cuico	ˈk w i k o
subida	s u ˈb i d a
litigares	l i t i ˈɡ a ɾ e s
retirado	r e t i ˈɾ a d o
paliada	p a ˈl j a d a
redimidos	r e d i ˈm i d o s
solerlo	s o ˈl e ɾ l o
divinado	d i b i ˈn a d o
banqueteada	b a n k e t e ˈa d a
hubimos	u ˈb i m o s
cal	ˈk a l
definiríamos	d e f i n i ˈɾ i a m o s
transparente	t ɾ a n s p a ˈɾ e n t e
torpedeados	t o ɾ p e d e ˈa d o s
criopreservadas	k ɾ j o p ɾ e s e ɾ ˈb a d a s
escalonar	e s k a l o ˈn a ɾ
haríamos	a ˈɾ i a m o s
chontaduro	t͡ʃ o n t a ˈd u ɾ o
gramatical	ɡ ɾ a m a t i ˈk a l
skúa	e s ˈk u a
engallar	e n ɡ a ˈʝ a ɾ
bonarda	b o ˈn a ɾ d a
coexistir	k o e ɡ s i s ˈt i ɾ
oncológica	o n k o ˈl o x i k a
vístanlo	ˈb i s t a n l o
afanosas	a f a ˈn o s a s
andaos	a n ˈd a o s
vengados	b e n ˈɡ a d o s
caligrafiados	k a l i ɡ ɾ a ˈf j a d o s
descuajar	d e s k w a ˈx a ɾ
depilar	d e p i ˈl a ɾ
sauna	ˈs a u n a
amoldable	a m o l ˈd a b l e
padrear	p a d ɾ e ˈa ɾ
surreal	s u r e ˈa l
trovero	t ɾ o ˈb e ɾ o
dialogadas	d j a l o ˈɡ a d a s
alcantarillar	a l k a n t a ɾ i ˈʝ a ɾ
Enka	ˈe n k a
tántalo	ˈt a n t a l o
sudanés	s u d a ˈn e s
tened	t e ˈn e d
atutía	a t u ˈt i a
sobrescribir	s o b ɾ e s k ɾ i ˈb i ɾ
enferma	e n ˈf e ɾ m a
Donaire	d o ˈn a i ɾ e
aborregabais	a b o r e ˈɡ a b a i s
Natan	ˈn a t a n
aviará	a b j a ˈɾ a
interna	i n ˈt e ɾ n a
Helios	ˈe l j o s
hábito	ˈa b i t o
metros	ˈm e t ɾ o s
biflagelado	b i f l a x e ˈl a d o
arquear	a ɾ k e ˈa ɾ
soleros	s o ˈl e ɾ o s
nada	ˈn a d a
multáramos	m u l ˈt a ɾ a m o s
alongadas	a l o n ˈɡ a d a s
numerable	n u m e ˈɾ a b l e
abadernabais	a b a d e ɾ ˈn a b a i s
permutarás	p e ɾ m u t a ˈɾ a s
correaje	k o r e ˈa x e
vesicante	b e s i ˈk a n t e
oleados	o l e ˈa d o s
calares	k a ˈl a ɾ e s
matula	m a ˈt u l a
ayuno	a ˈʝ u n o
Goliat	ɡ o ˈl j a t
tardadas	t a ɾ ˈd a d a s
sacristía	s a k ɾ i s ˈt i a
eslalon	e s ˈl a l o n
aglomeradas	a ɡ l o m e ˈɾ a d a s
raídas	r a ˈi d a s
homofóbico	o m o ˈf o b i k o
desbarrancadas	d e s b a r a n ˈk a d a s
churruscar	t͡ʃ u r u s ˈk a ɾ
adherir	a d e ˈɾ i ɾ
sunroof	ˈs a n r u f
aglutinar	a ɡ l u t i ˈn a ɾ
gastrina	ɡ a s ˈt ɾ i n a
fornicada	f o ɾ n i ˈk a d a
pausadas	p a u ˈs a d a s
peligro	p e ˈl i ɡ ɾ o
colofón	k o l o ˈf o n
embarulladas	e m b a ɾ u ˈʝ a d a s
conjurar	k o n x u ˈɾ a ɾ
vedarme	b e ˈd a ɾ m e
Jaca	ˈx a k a
arraigar	a r a i ˈɡ a ɾ
alante	a ˈl a n t e
dalia	ˈd a l j a
jacau	ˈx a k a u
codifiques	k o d i ˈf i k e s
lisar	l i ˈs a ɾ
IFE	ˈi f e
colegido	k o l e ˈx i d o
cultivo	k u l ˈt i b o
escavar	e s k a ˈb a ɾ
girado	x i ˈɾ a d o
escamotear	e s k a m o t e ˈa ɾ
angulados	a n ɡ u ˈl a d o s
avenasen	a b e ˈn a s e n
lastimar	l a s t i ˈm a ɾ
yukpa	ˈʝ u ɡ p a
argentina	a ɾ x e n ˈt i n a
autómata	a u ˈt o m a t a
parasailing	p a ɾ a ˈs e i l i n
difractada	d i f ɾ a ɡ ˈt a d a
hipocraterimorfo	i p o k ɾ a t e ɾ i ˈm o ɾ f o
condenado	k o n d e ˈn a d o
mentecatos	m e n t e ˈk a t o s
cardíaco	k a ɾ ˈd i a k o
enseñado	e n s e ˈɲ a d o
contristado	k o n t ɾ i s ˈt a d o
padouca	p a ˈd o u k a
koala	k o ˈa l a
compensadas	k o m p e n ˈs a d a s
desincorporar	d e s i n k o ɾ p o ˈɾ a ɾ
pluvioso	p l u ˈb j o s o
confesora	k o n f e ˈs o ɾ a
victoreada	b i ɡ t o ɾ e ˈa d a
villalbés	b i ʝ a l ˈb e s
impetrado	i m p e ˈt ɾ a d o
alcaldada	a l k a l ˈd a d a
tascó	t a s ˈk o
yuxtaponer	ʝ u ɡ s t a p o ˈn e ɾ
archivado	a ɾ t͡ʃ i ˈb a d o
achorar	a t͡ʃ o ˈɾ a ɾ
abañadas	a b a ˈɲ a d a s
posibles	p o ˈs i b l e s
depósitos	d e ˈp o s i t o s
tiritada	t i ɾ i ˈt a d a
abarrares	a b a ˈr a ɾ e s
costearíamos	k o s t e a ˈɾ i a m o s
amohinadas	a m o i ˈn a d a s
sobresalir	s o b ɾ e s a ˈl i ɾ
Almaguer	a l m a ˈɡ e ɾ
tururú	t u ɾ u ˈɾ u
atravesar	a t ɾ a b e ˈs a ɾ
sobresaltadas	s o b ɾ e s a l ˈt a d a s
abacoras	a b a ˈk o ɾ a s
intrigados	i n t ɾ i ˈɡ a d o s
desasosegado	d e s a s o s e ˈɡ a d o
alojar	a l o ˈx a ɾ
bahaísmo	b a a ˈi s m o
minúscula	m i ˈn u s k u l a
extendidas	e ɡ s t e n ˈd i d a s
aserrados	a s e ˈr a d o s
solad	s o ˈl a d
forjadura	f o ɾ x a ˈd u ɾ a
compurgar	k o m p u ɾ ˈɡ a ɾ
ascua	ˈa s k w a
extermino	e ɡ s t e ɾ ˈm i n o
regladas	r e ˈɡ l a d a s
retreparse	r e t ɾ e ˈp a ɾ s e
chingongo	t͡ʃ i n ˈɡ o n ɡ o
fondeados	f o n d e ˈa d o s
modifico	m o d i ˈf i k o
Canuto	k a ˈn u t o
Tagle	ˈt a ɡ l e
tijereteo	t i x e ɾ e ˈt e o
nacas	ˈn a k a s
supuesto	s u ˈp w e s t o
presa	ˈp ɾ e s a
amartillado	a m a ɾ t i ˈʝ a d o
acostaste	a k o s ˈt a s t e
súcubo	ˈs u k u b o
alumnado	a l u m ˈn a d o
intervalo	i n t e ɾ ˈb a l o
semiarco	s e ˈm j a ɾ k o
refrendadas	r e f ɾ e n ˈd a d a s
psicofisiología	s i k o f i s j o l o ˈx i a
encanijar	e n k a n i ˈx a ɾ
desgarrante	d e s ɡ a ˈr a n t e
agusánese	a ɡ u ˈs a n e s e
coescriptas	k o e s ˈk ɾ i b t a s
Blas	ˈb l a s
bamba	ˈb a m b a
Torralba	t o ˈr a l b a
ventilar	b e n t i ˈl a ɾ
Rojas	ˈr o x a s
trastabillear	t ɾ a s t a b i ʝ e ˈa ɾ
tortures	t o ɾ ˈt u ɾ e s
anestesiados	a n e s t e ˈs j a d o s
estadísticamente	e s t a ˌd i s t i k a ˈm e n t e
roca	ˈr o k a
columbrado	k o l u m ˈb ɾ a d o
lamela	l a ˈm e l a
lavando	l a ˈb a n d o
soldadesco	s o l d a ˈd e s k o
grato	ˈɡ ɾ a t o
penco	ˈp e n k o
envolver	e m b o l ˈb e ɾ
mixturamos	m i ɡ s t u ˈɾ a m o s
fibroso	f i ˈb ɾ o s o
hiladora	i l a ˈd o ɾ a
vivaqueada	b i b a k e ˈa d a
bufónico	b u ˈf o n i k o
chocoano	t͡ʃ o k o ˈa n o
caricatures	k a ɾ i k a ˈt u ɾ e s
granjeada	ɡ ɾ a n x e ˈa d a
adquirible	a d k i ˈɾ i b l e
Laurel	l a u ˈɾ e l
enviar	e m ˈb j a ɾ
hipogastrio	i p o ˈɡ a s t ɾ j o
periquitos	p e ɾ i ˈk i t o s
playas	ˈp l a ʝ a s
abreviara	a b ɾ e ˈb j a ɾ a
desclasificado	d e s k l a s i f i ˈk a d o
follable	f o ˈʝ a b l e
desembrujada	d e s e m b ɾ u ˈx a d a
aguador	a ɡ w a ˈd o ɾ
palatino	p a l a ˈt i n o
estriada	e s ˈt ɾ j a d a
guiñadas	ɡ i ˈɲ a d a s
hemínico	e ˈm i n i k o
gobernados	ɡ o b e ɾ ˈn a d o s
pendíamos	p e n ˈd i a m o s
ponchadora	p o n t͡ʃ a ˈd o ɾ a
hilandera	i l a n ˈd e ɾ a
conjuntadas	k o n x u n ˈt a d a s
atemos	a ˈt e m o s
Yara	ˈʝ a ɾ a
enagua	e ˈn a ɡ w a
trancado	t ɾ a n ˈk a d o
concuñada	k o n k u ˈɲ a d a
hipertensión	i p e ɾ t e n ˈs j o n
Fuerteventura	f w e ɾ t e b e n ˈt u ɾ a
administráramos	a d m i n i s ˈt ɾ a ɾ a m o s
pájaros	ˈp a x a ɾ o s
optrónico	o b ˈt ɾ o n i k o
emolientero	e m o l j e n ˈt e ɾ o
alguien	ˈa l ɡ j e n
cabreada	k a b ɾ e ˈa d a
Alexandrescu	a l e ɡ s a n ˈd ɾ e s k u
amplificado	a m p l i f i ˈk a d o
bifurcado	b i f u ɾ ˈk a d o
colador	k o l a ˈd o ɾ
náuticas	ˈn a u t i k a s
revalidadas	r e b a l i ˈd a d a s
ballesta	b a ˈʝ e s t a
cagona	k a ˈɡ o n a
varsoviano	b a ɾ s o ˈb j a n o
completamos	k o m p l e ˈt a m o s
monárquica	m o ˈn a ɾ k i k a
consultar	k o n s u l ˈt a ɾ
licopodio	l i k o ˈp o d j o
pastes	ˈp a s t e s
diana	ˈd j a n a
lacón	l a ˈk o n
extracto	e ɡ s ˈt ɾ a ɡ t o
apararás	a p a ɾ a ˈɾ a s
polirritmia	p o l i ˈr i d m j a
decolorados	d e k o l o ˈɾ a d o s
sucursalista	s u k u ɾ s a ˈl i s t a
singular	s i n ɡ u ˈl a ɾ
influjo	i n ˈf l u x o
dietilo	d j e ˈt i l o
abate	a ˈb a t e
tricotaren	t ɾ i k o ˈt a ɾ e n
abaluartar	a b a l w a ɾ ˈt a ɾ
desprotegida	d e s p ɾ o t e ˈx i d a
sublimado	s u b l i ˈm a d o
coordinadas	k o o ɾ d i ˈn a d a s
detergidas	d e t e ɾ ˈx i d a s
afluir	a ˈf l w i ɾ
frentista	f ɾ e n ˈt i s t a
limpiador	l i m p j a ˈd o ɾ
remoloneada	r e m o l o n e ˈa d a
petipuá	p e t i ˈp w a
has	ˈa s
evangelio	e b a n ˈx e l j o
tético	ˈt e t i k o
arbitramento	a ɾ b i t ɾ a ˈm e n t o
presentes	p ɾ e ˈs e n t e s
añadir	a ɲ a ˈd i ɾ
Némesis	ˈn e m e s i s
fosforosa	f o s f o ˈɾ o s a
mensurar	m e n s u ˈɾ a ɾ
chaquetita	t͡ʃ a k e ˈt i t a
copada	k o ˈp a d a
arraigado	a r a i ˈɡ a d o
consultaremos	k o n s u l t a ˈɾ e m o s
estruja	e s ˈt ɾ u x a
provicario	p ɾ o b i ˈk a ɾ j o
Argentina	a ɾ x e n ˈt i n a
trilema	t ɾ i ˈl e m a
brie	ˈb ɾ i
oyó	o ˈʝ o
almiar	a l ˈm j a ɾ
cosmópolis	k o s ˈm o p o l i s
kineses	k i ˈn e s e s
afirmemos	a f i ɾ ˈm e m o s
psicoterapias	s i k o t e ˈɾ a p j a s
sajón	s a ˈx o n
pun	ˈp u n
legítima	l e ˈx i t i m a
rabiada	r a ˈb j a d a
fonda	ˈf o n d a
díganla	ˈd i ɡ a n l a
alboreada	a l b o ɾ e ˈa d a
mentirosa	m e n t i ˈɾ o s a
matas	ˈm a t a s
radiculopatías	r a d i k u l o p a ˈt i a s
confirmareis	k o n f i ɾ ˈm a ɾ e i s
envainadoras	e m b a i n a ˈd o ɾ a s
allí	a ˈʝ i
etnologías	e d n o l o ˈx i a s
nectáreas	n e ɡ ˈt a ɾ e a s
vételo	ˈb e t e l o
coexista	k o e ɡ ˈs i s t a
italófonos	i t a ˈl o f o n o s
sanguinolentos	s a n ɡ i n o ˈl e n t o s
indefenso	i n d e ˈf e n s o
gatear	ɡ a t e ˈa ɾ
tratamos	t ɾ a ˈt a m o s
exageres	e ɡ s a ˈx e ɾ e s
inquisidora	i n k i s i ˈd o ɾ a
saquete	s a ˈk e t e
encarnados	e n k a ɾ ˈn a d o s
adrenalínico	a d ɾ e n a ˈl i n i k o
restauraste	r e s t a u ˈɾ a s t e
gráfico	ˈɡ ɾ a f i k o
pronósticos	p ɾ o ˈn o s t i k o s
resondrar	r e s o n ˈd ɾ a ɾ
moraste	m o ˈɾ a s t e
afiebrada	a f j e ˈb ɾ a d a
fundidas	f u n ˈd i d a s
argumentes	a ɾ ɡ u ˈm e n t e s
cánones	ˈk a n o n e s
englobadas	e n ɡ l o ˈb a d a s
adiando	a ˈd j a n d o
argüimos	a ɾ ˈɡ w i m o s
biotecnóloga	b j o t e ɡ ˈn o l o ɡ a
parlas	ˈp a ɾ l a s
inhabitable	i n a b i ˈt a b l e
funicular	f u n i k u ˈl a ɾ
invernaderos	i m b e ɾ n a ˈd e ɾ o s
hipovolémicas	i p o b o ˈl e m i k a s
reparemos	r e p a ˈɾ e m o s
fenghuang	f e n ˈx w a n
haríais	a ˈɾ i a i s
esotéricas	e s o ˈt e ɾ i k a s
endrogado	e n d ɾ o ˈɡ a d o
adehesar	a d e e ˈs a ɾ
ronda	ˈr o n d a
próximo	ˈp ɾ o ɡ s i m o
marihuanas	m a ɾ i ˈw a n a s
estrafalario	e s t ɾ a f a ˈl a ɾ j o
portera	p o ɾ ˈt e ɾ a
diría	d i ˈɾ i a
laudados	l a u ˈd a d o s
conejito	k o n e ˈx i t o
toloache	t o l o ˈa t͡ʃ e
vestidura	b e s t i ˈd u ɾ a
endocrino	e n d o ˈk ɾ i n o
donada	d o ˈn a d a
reseñada	r e s e ˈɲ a d a
venteadas	b e n t e ˈa d a s
ahechados	a e ˈt͡ʃ a d o s
exhalar	e ɡ s a ˈl a ɾ
respaldados	r e s p a l ˈd a d o s
abortar	a b o ɾ ˈt a ɾ
benigna	b e ˈn i ɡ n a
amputadas	a m p u ˈt a d a s
acotolados	a k o t o ˈl a d o s
complique	k o m ˈp l i k e
horneadas	o ɾ n e ˈa d a s
sinoestadounidense	s i n o e s t a d o u n i ˈd e n s e
Tato	ˈt a t o
Ybarra	i ˈb a r a
gorrón	ɡ o ˈr o n
desabejar	d e s a b e ˈx a ɾ
vedarte	b e ˈd a ɾ t e
angostados	a n ɡ o s ˈt a d o s
hablémoos	a ˈb l e m o o s
rockismo	r o ˈk i s m o
tintineo	t i n t i ˈn e o
suyos	ˈs u ʝ o s
repoblar	r e p o ˈb l a ɾ
tatuada	t a ˈt w a d a
protesta	p ɾ o ˈt e s t a
descocada	d e s k o ˈk a d a
atrayente	a t ɾ a ˈʝ e n t e
plastificaríamos	p l a s t i f i k a ˈɾ i a m o s
mercurio	m e ɾ ˈk u ɾ j o
culito	k u ˈl i t o
Putumayo	p u t u ˈm a ʝ o
embebidos	e m b e ˈb i d o s
enjertal	e n x e ɾ ˈt a l
enfriadas	e n ˈf ɾ j a d a s
estratigrafía	e s t ɾ a t i ɡ ɾ a ˈf i a
amaestrados	a m a e s ˈt ɾ a d o s
habrás	a ˈb ɾ a s
prontito	p ɾ o n ˈt i t o
retromandibular	r e t ɾ o m a n d i b u ˈl a ɾ
guardoso	ɡ w a ɾ ˈd o s o
apabullados	a p a b u ˈʝ a d o s
antropomórficas	a n t ɾ o p o ˈm o ɾ f i k a s
inopia	i ˈn o p j a
lenón	l e ˈn o n
calvito	k a l ˈb i t o
diletante	d i l e ˈt a n t e
anfipáticos	a n f i ˈp a t i k o s
radal	r a ˈd a l
atenido	a t e ˈn i d o
alérgeno	a ˈl e ɾ x e n o
comilón	k o m i ˈl o n
alegal	a l e ˈɡ a l
gloriareis	ɡ l o ˈɾ j a ɾ e i s
acondroplasia	a k o n d ɾ o ˈp l a s j a
Crono	ˈk ɾ o n o
tripolitano	t ɾ i p o l i ˈt a n o
reasentar	r e a s e n ˈt a ɾ
astrosas	a s ˈt ɾ o s a s
debías	d e ˈb i a s
abstuviste	a b s t u ˈb i s t e
subdividir	s u b d i b i ˈd i ɾ
Luis	ˈl w i s
obsoleta	o b s o ˈl e t a
subactuar	s u b a ɡ ˈt w a ɾ
esculpida	e s k u l ˈp i d a
normativismo	n o ɾ m a t i ˈb i s m o
honores	o ˈn o ɾ e s
soltamos	s o l ˈt a m o s
abordadas	a b o ɾ ˈd a d a s
laso	ˈl a s o
falisco	f a ˈl i s k o
pesqueras	p e s ˈk e ɾ a s
guayadas	ɡ w a ˈʝ a d a s
pajúos	p a ˈx u o s
cantémoslos	k a n ˈt e m o s l o s
lijadas	l i ˈx a d a s
atestar	a t e s ˈt a ɾ
melotrón	m e l o ˈt ɾ o n
ulco	ˈu l k o
corneadas	k o ɾ n e ˈa d a s
denotaríamos	d e n o t a ˈɾ i a m o s
prologal	p ɾ o l o ˈɡ a l
desentender	d e s e n t e n ˈd e ɾ
trasegador	t ɾ a s e ɡ a ˈd o ɾ
abaluartares	a b a l w a ɾ ˈt a ɾ e s
intelectualismo	i n t e l e ɡ t w a ˈl i s m o
acompañante	a k o m p a ˈɲ a n t e
viéndote	ˈb j e n d o t e
pinate	p i ˈn a t e
auto	ˈa u t o
asolada	a s o ˈl a d a
alimaña	a l i ˈm a ɲ a
andémoste	a n ˈd e m o s t e
libadas	l i ˈb a d a s
eritema	e ɾ i ˈt e m a
trajinados	t ɾ a x i ˈn a d o s
senador	s e n a ˈd o ɾ
indómitas	i n ˈd o m i t a s
rematado	r e m a ˈt a d o
desdoblado	d e s d o ˈb l a d o
erre	ˈe r e
autosaboteados	a u t o s a b o t e ˈa d o s
fiteogeográfico	f i t e o x e o ˈɡ ɾ a f i k o
contactes	k o n ˈt a ɡ t e s
abaldonases	a b a l d o ˈn a s e s
hemispingo	e m i s ˈp i n ɡ o
presididos	p ɾ e s i ˈd i d o s
copernicanos	k o p e ɾ n i ˈk a n o s
babosada	b a b o ˈs a d a
inexplicables	i n e ɡ s p l i ˈk a b l e s
aseverado	a s e b e ˈɾ a d o
destocadas	d e s t o ˈk a d a s
amurar	a m u ˈɾ a ɾ
anguladas	a n ɡ u ˈl a d a s
mostrará	m o s t ɾ a ˈɾ a
robre	ˈr o b ɾ e
articulado	a ɾ t i k u ˈl a d o
sófora	ˈs o f o ɾ a
explayados	e ɡ s p l a ˈʝ a d o s
expansionar	e ɡ s p a n s j o ˈn a ɾ
bicroma	b i ˈk ɾ o m a
histoquímicas	i s t o ˈk i m i k a s
procurares	p ɾ o k u ˈɾ a ɾ e s
respiras	r e s ˈp i ɾ a s
crocodiliforme	k ɾ o k o d i l i ˈf o ɾ m e
abandonista	a b a n d o ˈn i s t a
endodérmico	e n d o ˈd e ɾ m i k o
investigadoras	i m b e s t i ɡ a ˈd o ɾ a s
extraacadémica	e ɡ s t ɾ a a k a ˈd e m i k a
yaracuyano	ʝ a ɾ a k u ˈʝ a n o
Atlanta	a ˈt l a n t a
ahondada	a o n ˈd a d a
avasallados	a b a s a ˈʝ a d o s
animaras	a n i ˈm a ɾ a s
lubrificá	l u b ɾ i f i ˈk a
liberta	l i ˈb e ɾ t a
guitarra	ɡ i ˈt a r a
mártaga	ˈm a ɾ t a ɡ a
cartografiados	k a ɾ t o ɡ ɾ a ˈf j a d o s
reflectadas	r e f l e ɡ ˈt a d a s
costoso	k o s ˈt o s o
troglodítica	t ɾ o ɡ l o ˈd i t i k a
pastito	p a s ˈt i t o
dihueñe	d i ˈw e ɲ e
huaca	ˈw̝ a k a
nigroestriados	n i ɡ ɾ o e s ˈt ɾ j a d o s
otaku	o ˈt a k u
confortamos	k o n f o ɾ ˈt a m o s
involutivos	i m b o l u ˈt i b o s
sedes	ˈs e d e s
búlgara	ˈb u l ɡ a ɾ a
skopiote	e s k o ˈp j o t e
microendémico	m i k ɾ o e n ˈd e m i k o
agendada	a x e n ˈd a d a
trasliteradas	t ɾ a s l i t e ˈɾ a d a s
neoplateresco	n e o p l a t e ˈɾ e s k o
sugestionable	s u x e s t j o ˈn a b l e
decretadas	d e k ɾ e ˈt a d a s
reverberaréis	r e b e ɾ b e ɾ a ˈɾ e i s
limada	l i ˈm a d a
pyme	ˈp i m e
siútico	ˈs j u t i k o
anglocatólica	a n ɡ l o k a ˈt o l i k a
regeneras	r e x e ˈn e ɾ a s
bebería	b e b e ˈɾ i a
recalificada	r e k a l i f i ˈk a d a
aparado	a p a ˈɾ a d o
bonificadas	b o n i f i ˈk a d a s
pocheadas	p o t͡ʃ e ˈa d a s
ufanados	u f a ˈn a d o s
mate	ˈm a t e
sagitada	s a x i ˈt a d a
persistidas	p e ɾ s i s ˈt i d a s
enfurruñados	e n f u r u ˈɲ a d o s
tabicadas	t a b i ˈk a d a s
connatural	k o n n a t u ˈɾ a l
desvividas	d e s b i ˈb i d a s
demolidos	d e m o ˈl i d o s
pipada	p i ˈp a d a
ateísmo	a t e ˈi s m o
alcapurria	a l k a ˈp u r j a
abaldóneles	a b a l ˈd o n e l e s
psicosomático	s i k o s o ˈm a t i k o
donas	ˈd o n a s
lapo	ˈl a p o
enumerado	e n u m e ˈɾ a d o
protesto	p ɾ o ˈt e s t o
indivisibilidad	i n d i b i s i b i l i ˈd a d
trebolito	t ɾ e b o ˈl i t o
abrevadero	a b ɾ e b a ˈd e ɾ o
impulsivas	i m p u l ˈs i b a s
aquilón	a k i ˈl o n
desolladora	d e s o ʝ a ˈd o ɾ a
palladiano	p a ʝ a ˈd j a n o
abacoraseis	a b a k o ˈɾ a s e i s
padrino	p a ˈd ɾ i n o
salón	s a ˈl o n
susurrar	s u s u ˈr a ɾ
sicofanta	s i k o ˈf a n t a
playeras	p l a ˈʝ e ɾ a s
ey	ˈe i
deleitadas	d e l e i ˈt a d a s
hubiese	u ˈb j e s e
cajón	k a ˈx o n
humita	u ˈm i t a
disuadida	d i s w a ˈd i d a
actitudinal	a ɡ t i t u d i ˈn a l
masculina	m a s k u ˈl i n a
astragalinos	a s t ɾ a ɡ a ˈl i n o s
samba	ˈs a m b a
indisimulada	i n d i s i m u ˈl a d a
abandonamiento	a b a n d o n a ˈm j e n t o
vagaríamos	b a ɡ a ˈɾ i a m o s
hipoclorador	i p o k l o ɾ a ˈd o ɾ
enherbolar	e n e ɾ b o ˈl a ɾ
aminopeptidasa	a m i n o p e b t i ˈd a s a
propendida	p ɾ o p e n ˈd i d a
recurvadas	r e k u ɾ ˈb a d a s
égloga	ˈe ɡ l o ɡ a
acholados	a t͡ʃ o ˈl a d o s
aculados	a k u ˈl a d o s
debámosla	d e ˈb a m o s l a
polígloto	p o ˈl i ɡ l o t o
respiré	r e s p i ˈɾ e
socarronería	s o k a r o n e ˈɾ i a
carpinteril	k a ɾ p i n t e ˈɾ i l
chip	ˈt͡ʃ i p
destituidos	d e s t i ˈt w i d o s
bregue	ˈb ɾ e ɡ e
bohrio	ˈb o ɾ j o
metra	ˈm e t ɾ a
angloamericanas	a n ɡ l o a m e ɾ i ˈk a n a s
intentada	i n t e n ˈt a d a
michoacanos	m i t͡ʃ o a ˈk a n o s
audible	a u ˈd i b l e
pedorreadas	p e d o r e ˈa d a s
multitudinaria	m u l t i t u d i ˈn a ɾ j a
igualado	i ɡ w a ˈl a d o
fonsadera	f o n s a ˈd e ɾ a
paremos	p a ˈɾ e m o s
minicomponente	m i n i k o m p o ˈn e n t e
substitutivo	s u b s t i t u ˈt i b o
cantándoles	k a n ˈt a n d o l e s
piados	ˈp j a d o s
pinball	ˈp i m b a l
voltaicos	b o l ˈt a i k o s
amariconado	a m a ɾ i k o ˈn a d o
cantarlos	k a n ˈt a ɾ l o s
tajantemente	t a ˌx a n t e ˈm e n t e
ánsara	ˈa n s a ɾ a
alumbre	a ˈl u m b ɾ e
pedrisco	p e ˈd ɾ i s k o
general	x e n e ˈɾ a l
flojo	ˈf l o x o
grande	ˈɡ ɾ a n d e
perfume	p e ɾ ˈf u m e
Ximena	x i ˈm e n a
conuco	k o ˈn u k o
fosforilaríamos	f o s f o ɾ i l a ˈɾ i a m o s
mangoneada	m a n ɡ o n e ˈa d a
régimen	ˈr e x i m e n
abacoraremos	a b a k o ɾ a ˈɾ e m o s
calibrada	k a l i ˈb ɾ a d a
sangra	ˈs a n ɡ ɾ a
autoantónimo	a u t o a n ˈt o n i m o
pendejeadas	p e n d e x e ˈa d a s
tests	ˈt e s t s
bala	ˈb a l a
carintia	k a ˈɾ i n t j a
Alexópulos	a l e ɡ ˈs o p u l o s
caudillo	k a u ˈd i ʝ o
corte	ˈk o ɾ t e
nasosinusales	n a s o s i n u ˈs a l e s
metronómico	m e t ɾ o ˈn o m i k o
vestido	b e s ˈt i d o
animosas	a n i ˈm o s a s
contestatario	k o n t e s t a ˈt a ɾ j o
cromatográficos	k ɾ o m a t o ˈɡ ɾ a f i k o s
conecte	k o ˈn e ɡ t e
inaudible	i n a u ˈd i b l e
mironeo	m i ɾ o ˈn e o
superares	s u p e ˈɾ a ɾ e s
Pegaso	p e ˈɡ a s o
escudriñadores	e s k u d ɾ i ɲ a ˈd o ɾ e s
abnegamos	a b n e ˈɡ a m o s
valentona	b a l e n ˈt o n a
prístinas	ˈp ɾ i s t i n a s
subsumido	s u b s u ˈm i d o
ejemplo	e ˈx e m p l o
desordenar	d e s o ɾ d e ˈn a ɾ
pavonearse	p a b o n e ˈa ɾ s e
hasta	ˈa s t a
germanísticos	x e ɾ m a ˈn i s t i k o s
enemistar	e n e m i s ˈt a ɾ
trofoblasto	t ɾ o f o ˈb l a s t o
regalada	r e ɡ a ˈl a d a
patovica	p a t o ˈb i k a
Lisandro	l i ˈs a n d ɾ o
jeringadas	x e ɾ i n ˈɡ a d a s
afectaste	a f e ɡ ˈt a s t e
arlequinado	a ɾ l e k i ˈn a d o
seríamos	s e ˈɾ i a m o s
islandeses	i s l a n ˈd e s e s
oviraptorosaurio	o b i ɾ a b t o ɾ o ˈs a u ɾ j o
abrupto	a ˈb ɾ u b t o
trianguladas	t ɾ j a n ɡ u ˈl a d a s
transcurrido	t ɾ a n s k u ˈr i d o
dríade	ˈd ɾ i a d e
envión	e m ˈb j o n
amén	a ˈm e n
camarín	k a m a ˈɾ i n
mara	ˈm a ɾ a
abjurando	a b x u ˈɾ a n d o
carroñero	k a r o ˈɲ e ɾ o
eufemísticas	e u f e ˈm i s t i k a s
laudo	ˈl a u d o
ansiada	a n ˈs j a d a
semblar	s e m ˈb l a ɾ
incautadas	i n k a u ˈt a d a s
pacará	p a k a ˈɾ a
falafel	f a l a ˈf e l
acunados	a k u ˈn a d o s
cosido	k o ˈs i d o
poderío	p o d e ˈɾ i o
relojería	r e l o x e ˈɾ i a
pornificar	p o ɾ n i f i ˈk a ɾ
Tarso	ˈt a ɾ s o
fichados	f i ˈt͡ʃ a d o s
Merino	m e ˈɾ i n o
usuluteca	u s u l u ˈt e k a
campar	k a m ˈp a ɾ
Inesita	i n e ˈs i t a
afroestadounidenses	a f ɾ o e s t a d o u n i ˈd e n s e s
barriera	b a ˈr j e ɾ a
contento	k o n ˈt e n t o
glicosídico	ɡ l i k o ˈs i d i k o
utrera	u ˈt ɾ e ɾ a
aojada	a o ˈx a d a
admire	a d ˈm i ɾ e
acuanautas	a k w a ˈn a u t a s
embrujada	e m b ɾ u ˈx a d a
listado	l i s ˈt a d o
lacaya	l a ˈk a ʝ a
dañados	d a ˈɲ a d o s
titiladas	t i t i ˈl a d a s
terral	t e ˈr a l
carteadas	k a ɾ t e ˈa d a s
correísmo	k o r e ˈi s m o
Remigio	r e ˈm i x j o
mandril	m a n ˈd ɾ i l
cuatribanda	k w a t ɾ i ˈb a n d a
vivada	b i ˈb a d a
muerteabas	m w e ɾ t e ˈa b a s
llevar	ʝ e ˈb a ɾ
linkbuilding	l i n ɡ ˈb i l d i n
incorpóreos	i n k o ɾ ˈp o ɾ e o s
titiriteadlo	t i t i ɾ i t e ˈa d l o
malentendida	m a l e n t e n ˈd i d a
lúbrico	ˈl u b ɾ i k o
carlinga	k a ɾ ˈl i n ɡ a
constatable	k o n s t a ˈt a b l e
leído	l e ˈi d o
edentado	e d e n ˈt a d o
baremado	b a ɾ e ˈm a d o
perpetrador	p e ɾ p e t ɾ a ˈd o ɾ
deslustrada	d e s l u s ˈt ɾ a d a
consellera	k o n s e ˈʝ e ɾ a
nosología	n o s o l o ˈx i a
afectaras	a f e ɡ ˈt a ɾ a s
acatados	a k a ˈt a d o s
banqueteadas	b a n k e t e ˈa d a s
arbusto	a ɾ ˈb u s t o
inventes	i m ˈb e n t e s
legitimando	l e x i t i ˈm a n d o
empatada	e m p a ˈt a d a
quimioterápico	k i m j o t e ˈɾ a p i k o
aviando	a ˈb j a n d o
forradito	f o r a ˈd i t o
profanidad	p ɾ o f a n i ˈd a d
ludido	l u ˈd i d o
supracondílea	s u p ɾ a k o n ˈd i l e a
simplificareis	s i m p l i f i ˈk a ɾ e i s
locutivo	l o k u ˈt i b o
torturadas	t o ɾ t u ˈɾ a d a s
muerte	ˈm w e ɾ t e
engelamiento	e n x e l a ˈm j e n t o
paniaguado	p a n j a ˈɡ w a d o
palindrómico	p a l i n ˈd ɾ o m i k o
pinillos	p i ˈn i ʝ o s
charquito	t͡ʃ a ɾ ˈk i t o
temerá	t e m e ˈɾ a
hablaste	a ˈb l a s t e
gantés	ɡ a n ˈt e s
cloroalquino	k l o ɾ o a l ˈk i n o
quitadas	k i ˈt a d a s
virareis	b i ˈɾ a ɾ e i s
espíritu	e s ˈp i ɾ i t u
yuracaré	ʝ u ɾ a k a ˈɾ e
hemorragia	e m o ˈr a x j a
pulcros	ˈp u l k ɾ o s
fiques	ˈf i k e s
avíape	a ˈb i a p e
consejera	k o n s e ˈx e ɾ a
santeros	s a n ˈt e ɾ o s
glosásemos	ɡ l o ˈs a s e m o s
bestseller	b e s t ˈs e l e ɾ
nefríticos	n e ˈf ɾ i t i k o s
erosionable	e ɾ o s j o ˈn a b l e
dominiquesa	d o m i n i ˈk e s a
descarboxiladas	d e s k a ɾ b o ɡ s i ˈl a d a s
anfipática	a n f i ˈp a t i k a
neoyorquino	n e o ʝ o ɾ ˈk i n o
fenomenológica	f e n o m e n o ˈl o x i k a
alienante	a l j e ˈn a n t e
colegida	k o l e ˈx i d a
flan	ˈf l a n
tenías	t e ˈn i a s
condene	k o n ˈd e n e
habiéndoos	a ˈb j e n d o o s
mortificado	m o ɾ t i f i ˈk a d o
sondeados	s o n d e ˈa d o s
globalismos	ɡ l o b a ˈl i s m o s
Radulescu	r a d u ˈl e s k u
rictus	ˈr i ɡ t u s
tirrena	t i ˈr e n a
punibilidad	p u n i b i l i ˈd a d
Salaverria	s a l a ˈb e r j a
skyline	e s ˈk a i l a i n
reprogramados	r e p ɾ o ɡ ɾ a ˈm a d o s
odontológicas	o d o n t o ˈl o x i k a s
nativos	n a ˈt i b o s
travestidos	t ɾ a b e s ˈt i d o s
planeada	p l a n e ˈa d a
esteparia	e s t e ˈp a ɾ j a
junte	ˈx u n t e
asperjados	a s p e ɾ ˈx a d o s
fagosoma	f a ɡ o ˈs o m a
soros	ˈs o ɾ o s
pésimo	ˈp e s i m o
desbaratadas	d e s b a ɾ a ˈt a d a s
acompañada	a k o m p a ˈɲ a d a
respuesta	r e s ˈp w e s t a
quisiste	k i ˈs i s t e
rebuscado	r e b u s ˈk a d o
complicadas	k o m p l i ˈk a d a s
disgustado	d i s ɡ u s ˈt a d o
deludir	d e l u ˈd i ɾ
hablándoles	a ˈb l a n d o l e s
modificativas	m o d i f i k a ˈt i b a s
tañedora	t a ɲ e ˈd o ɾ a
vendimiados	b e n d i ˈm j a d o s
destacados	d e s t a ˈk a d o s
ñera	ˈɲ e ɾ a
orladas	o ɾ ˈl a d a s
animada	a n i ˈm a d a
residente	r e s i ˈd e n t e
evitar	e b i ˈt a ɾ
cochambre	k o ˈt͡ʃ a m b ɾ e
Carbajal	k a ɾ b a ˈx a l
naturalidad	n a t u ɾ a l i ˈd a d
paliatorio	p a l j a ˈt o ɾ j o
fitomorfa	f i t o ˈm o ɾ f a
hermeneútica	e ɾ m e n e ˈu t i k a
encharcado	e n t͡ʃ a ɾ ˈk a d o
árbol	ˈa ɾ b o l
narval	n a ɾ ˈb a l
seamos	s e ˈa m o s
ricos	ˈr i k o s
aplicable	a p l i ˈk a b l e
algometría	a l ɡ o m e ˈt ɾ i a
argüiríais	a ɾ ɡ w i ˈɾ i a i s
hiperpotasemias	i p e ɾ p o t a ˈs e m j a s
abreviadas	a b ɾ e ˈb j a d a s
carpetana	k a ɾ p e ˈt a n a
vagues	ˈb a ɡ e s
vallada	b a ˈʝ a d a
expresados	e ɡ s p ɾ e ˈs a d o s
consenso	k o n ˈs e n s o
mefistofélico	m e f i s t o ˈf e l i k o
tartamudeada	t a ɾ t a m u d e ˈa d a
rotular	r o t u ˈl a ɾ
psicopompo	s i k o ˈp o m p o
chisporroteado	t͡ʃ i s p o r o t e ˈa d o
gerontología	x e ɾ o n t o l o ˈx i a
nefarias	n e ˈf a ɾ j a s
arromo	a ˈr o m o
fastidiosas	f a s t i ˈd j o s a s
anacarado	a n a k a ˈɾ a d o
pergeñado	p e ɾ x e ˈɲ a d o
unir	u ˈn i ɾ
prometida	p ɾ o m e ˈt i d a
develado	d e b e ˈl a d o
desprendida	d e s p ɾ e n ˈd i d a
antiindustrial	a n t i i n d u s ˈt ɾ j a l
adiabático	a d j a ˈb a t i k o
mediodía	m e d j o ˈd i a
medallita	m e d a ˈʝ i t a
aditividad	a d i t i b i ˈd a d
aniquilar	a n i k i ˈl a ɾ
tardar	t a ɾ ˈd a ɾ
pterodactiloide	t e ɾ o d a ɡ t i ˈl o i d e
Carreño	k a ˈr e ɲ o
desayunada	d e s a ʝ u ˈn a d a
pelirrojo	p e l i ˈr o x o
Montellano	m o n t e ˈʝ a n o
misionero	m i s j o ˈn e ɾ o
empoderante	e m p o d e ˈɾ a n t e
rehusados	r e u ˈs a d o s
menoscabadas	m e n o s k a ˈb a d a s
recua	ˈr e k w a
derretida	d e r e ˈt i d a
trasparentadas	t ɾ a s p a ɾ e n ˈt a d a s
soberbia	s o ˈb e ɾ b j a
desintegrativos	d e s i n t e ɡ ɾ a ˈt i b o s
silfo	ˈs i l f o
tamboril	t a m b o ˈɾ i l
escoltada	e s k o l ˈt a d a
despeinado	d e s p e i ˈn a d o
implementadas	i m p l e m e n ˈt a d a s
igualadas	i ɡ w a ˈl a d a s
filfa	ˈf i l f a
polisintéticos	p o l i s i n ˈt e t i k o s
desbandá	d e s b a n ˈd a
proamericanas	p ɾ o a m e ɾ i ˈk a n a s
acojonada	a k o x o ˈn a d a
Turín	t u ˈɾ i n
resguardo	r e s ˈɡ w a ɾ d o
martinelli	m a ɾ t i ˈn e l i
horado	o ˈɾ a d o
fútil	ˈf u t i l
lamelar	l a m e ˈl a ɾ
fincares	f i n ˈk a ɾ e s
abogades	a b o ˈɡ a d e s
aerocubierta	a e ɾ o k u ˈb j e ɾ t a
equilibrador	e k i l i b ɾ a ˈd o ɾ
gotita	ɡ o ˈt i t a
sobrepeso	s o b ɾ e ˈp e s o
heroica	e ˈɾ o i k a
desgana	d e s ˈɡ a n a
banquetear	b a n k e t e ˈa ɾ
sensibilidad	s e n s i b i l i ˈd a d
desamparar	d e s a m p a ˈɾ a ɾ
íncola	ˈi n k o l a
comarca	k o ˈm a ɾ k a
cronométrico	k ɾ o n o ˈm e t ɾ i k o
tansé	t a n ˈs e
cadaverina	k a d a b e ˈɾ i n a
personadas	p e ɾ s o ˈn a d a s
banco	ˈb a n k o
psicoactivo	s i k o a ɡ ˈt i b o
deslustrar	d e s l u s ˈt ɾ a ɾ
manométricas	m a n o ˈm e t ɾ i k a s
depurando	d e p u ˈɾ a n d o
espingarda	e s p i n ˈɡ a ɾ d a
tópico	ˈt o p i k o
resfriamos	r e s ˈf ɾ j a m o s
miasma	ˈm j a s m a
adestrará	a d e s t ɾ a ˈɾ a
endospora	e n d o s ˈp o ɾ a
ininteligibilidad	i n i n t e l i x i b i l i ˈd a d
diosa	ˈd j o s a
solarás	s o l a ˈɾ a s
acabás	a k a ˈb a s
chapoteados	t͡ʃ a p o t e ˈa d o s
hablémoslos	a ˈb l e m o s l o s
gravísimas	ɡ ɾ a ˈb i s i m a s
jarana	x a ˈɾ a n a
parduscas	p a ɾ ˈd u s k a s
butacón	b u t a ˈk o n
dijeren	d i ˈx e ɾ e n
pentavalente	p e n t a b a ˈl e n t e
portadas	p o ɾ ˈt a d a s
ser	ˈs e ɾ
sustantiva	s u s t a n ˈt i b a
baldado	b a l ˈd a d o
despierta	d e s ˈp j e ɾ t a
limados	l i ˈm a d o s
cutrona	k u ˈt ɾ o n a
acontentar	a k o n t e n ˈt a ɾ
workshop	ˈw o ɾ ɡ ʃ o p
degradada	d e ɡ ɾ a ˈd a d a
despabilado	d e s p a b i ˈl a d o
conservadorismo	k o n s e ɾ b a d o ˈɾ i s m o
Aruba	a ˈɾ u b a
impactada	i m p a ɡ ˈt a d a
sagrado	s a ˈɡ ɾ a d o
ganjifa	ɡ a n ˈx i f a
tristura	t ɾ i s ˈt u ɾ a
disfemia	d i s ˈf e m j a
antenal	a n t e ˈn a l
anden	ˈa n d e n
polonesas	p o l o ˈn e s a s
genuino	x e ˈn w i n o
significamos	s i ɡ n i f i ˈk a m o s
personalmente	p e ɾ ˌs o n a l ˈm e n t e
menudeados	m e n u d e ˈa d o s
guíes	ˈɡ i e s
dieron	ˈd j e ɾ o n
tuiteados	t w i t e ˈa d o s
guijarro	ɡ i ˈx a r o
caros	ˈk a ɾ o s
mitin	ˈm i t i n
profanadas	p ɾ o f a ˈn a d a s
alfaque	a l ˈf a k e
metonimia	m e t o ˈn i m j a
bisemanal	b i s e m a ˈn a l
despeñados	d e s p e ˈɲ a d o s
ventilada	b e n t i ˈl a d a
despistado	d e s p i s ˈt a d o
puerquita	p w e ɾ ˈk i t a
sincopar	s i n k o ˈp a ɾ
bucólico	b u ˈk o l i k o
garrapiñado	ɡ a r a p i ˈɲ a d o
percute	p e ɾ ˈk u t e
sustentar	s u s t e n ˈt a ɾ
aventada	a b e n ˈt a d a
matoneadas	m a t o n e ˈa d a s
congelar	k o n x e ˈl a ɾ
Gamba	ˈɡ a m b a
xerofítico	s e ɾ o ˈf i t i k o
incrementada	i n k ɾ e m e n ˈt a d a
peraltadas	p e ɾ a l ˈt a d a s
desencabestrado	d e s e n k a b e s ˈt ɾ a d o
bailotear	b a i l o t e ˈa ɾ
amillaráremos	a m i ʝ a ˈɾ a ɾ e m o s
cuchuchear	k u t͡ʃ u t͡ʃ e ˈa ɾ
comámosles	k o ˈm a m o s l e s
meloso	m e ˈl o s o
coexistidos	k o e ɡ s i s ˈt i d o s
argayar	a ɾ ɡ a ˈʝ a ɾ
santaneco	s a n t a ˈn e k o
pertrechados	p e ɾ t ɾ e ˈt͡ʃ a d o s
demente	d e ˈm e n t e
pulsado	p u l ˈs a d o
proveídos	p ɾ o b e ˈi d o s
enganchadas	e n ɡ a n ˈt͡ʃ a d a s
sufragados	s u f ɾ a ˈɡ a d o s
rastrojo	r a s ˈt ɾ o x o
impracticabilidad	i m p ɾ a ɡ t i k a b i l i ˈd a d
gravitada	ɡ ɾ a b i ˈt a d a
cuadril	k w a ˈd ɾ i l
sobrevaluado	s o b ɾ e b a ˈl w a d o
expectorados	e ɡ s p e ɡ t o ˈɾ a d o s
machadiana	m a t͡ʃ a ˈd j a n a
alcana	a l ˈk a n a
humanas	u ˈm a n a s
deliradas	d e l i ˈɾ a d a s
lechuguero	l e t͡ʃ u ˈɡ e ɾ o
diminutos	d i m i ˈn u t o s
neofobia	n e o ˈf o b j a
sí	ˈs i
estambulita	e s t a m b u ˈl i t a
derribo	d e ˈr i b o
cocodrila	k o k o ˈd ɾ i l a
posdoctoral	p o s d o ɡ t o ˈɾ a l
marinado	m a ɾ i ˈn a d o
guasón	ɡ w a ˈs o n
serigrafiado	s e ɾ i ɡ ɾ a ˈf j a d o
bloguear	b l o ɡ e ˈa ɾ
yodurar	ʝ o d u ˈɾ a ɾ
odre	ˈo d ɾ e
siamesas	s j a ˈm e s a s
Parodi	p a ˈɾ o d i
fantasmagóricos	f a n t a s m a ˈɡ o ɾ i k o s
ojeado	o x e ˈa d o
amurallada	a m u ɾ a ˈʝ a d a
frustres	ˈf ɾ u s t ɾ e s
autoaislarse	a u t o a i s ˈl a ɾ s e
encasquillada	e n k a s k i ˈʝ a d a
partido	p a ɾ ˈt i d o
hoyoso	o ˈʝ o s o
cromosoma	k ɾ o m o ˈs o m a
arramblados	a r a m ˈb l a d o s
trascrita	t ɾ a s ˈk ɾ i t a
amarteladas	a m a ɾ t e ˈl a d a s
jocosamente	x o ˌk o s a ˈm e n t e
incoar	i n k o ˈa ɾ
moribunda	m o ɾ i ˈb u n d a
auditivos	a u d i ˈt i b o s
cabás	k a ˈb a s
sapa	ˈs a p a
genitales	x e n i ˈt a l e s
apachurrada	a p a t͡ʃ u ˈr a d a
sindical	s i n d i ˈk a l
apenaréis	a p e n a ˈɾ e i s
sextina	s e s ˈt i n a
raigrás	r a i ˈɡ ɾ a s
subependimomas	s u b e p e n d i ˈm o m a s
deltana	d e l ˈt a n a
contraatacar	k o n t ɾ a a t a ˈk a ɾ
novelístico	n o b e ˈl i s t i k o
urbano	u ɾ ˈb a n o
pluralidades	p l u ɾ a l i ˈd a d e s
cabe	ˈk a b e
maracuyá	m a ɾ a k u ˈʝ a
enfriadero	e n f ɾ j a ˈd e ɾ o
sudadas	s u ˈd a d a s
audión	a u ˈd j o n
avarienta	a b a ˈɾ j e n t a
recontadas	r e k o n ˈt a d a s
multidispositivo	m u l t i d i s p o s i ˈt i b o
aleteadas	a l e t e ˈa d a s
pelillo	p e ˈl i ʝ o
panhelénico	p a n e ˈl e n i k o
achacoso	a t͡ʃ a ˈk o s o
medianil	m e d j a ˈn i l
chapó	t͡ʃ a ˈp o
catecúmena	k a t e ˈk u m e n a
impala	i m ˈp a l a
nítidas	ˈn i t i d a s
gasas	ˈɡ a s a s
ovejera	o b e ˈx e ɾ a
autoalimentados	a u t o a l i m e n ˈt a d o s
amnésica	a m ˈn e s i k a
güiña	ˈɡ w i ɲ a
chistorra	t͡ʃ i s ˈt o r a
retractados	r e t ɾ a ɡ ˈt a d o s
patriótico	p a ˈt ɾ j o t i k o
banfileños	b a n f i ˈl e ɲ o s
estaré	e s t a ˈɾ e
panal	p a ˈn a l
sobrerrepresentaría	s o b ɾ e r e p ɾ e s e n t a ˈɾ i a
chorrillana	t͡ʃ o r i ˈʝ a n a
desbancada	d e s b a n ˈk a d a
segurados	s e ɡ u ˈɾ a d o s
beldar	b e l ˈd a ɾ
oxidaras	o ɡ s i ˈd a ɾ a s
aumentadas	a u m e n ˈt a d a s
blando	ˈb l a n d o
malherida	m a l e ˈɾ i d a
hinchar	i n ˈt͡ʃ a ɾ
totopo	t o ˈt o p o
fanfarrones	f a n f a ˈr o n e s
prevaricadoras	p ɾ e b a ɾ i k a ˈd o ɾ a s
acudí	a k u ˈd i
vidriero	b i ˈd ɾ j e ɾ o
jamelga	x a ˈm e l ɡ a
abductor	a b d u ɡ ˈt o ɾ
perdigón	p e ɾ d i ˈɡ o n
glorificares	ɡ l o ɾ i f i ˈk a ɾ e s
casuales	k a ˈs w a l e s
compensaras	k o m p e n ˈs a ɾ a s
sajado	s a ˈx a d o
birminghense	b i ɾ m i n ˈɡ e n s e
maltratar	m a l t ɾ a ˈt a ɾ
fotografiado	f o t o ɡ ɾ a ˈf j a d o
Nebraska	n e ˈb ɾ a s k a
dinerario	d i n e ˈɾ a ɾ j o
jacobita	x a k o ˈb i t a
desmontados	d e s m o n ˈt a d o s
boyero	b o ˈʝ e ɾ o
envalentonadas	e m b a l e n t o ˈn a d a s
arponados	a ɾ p o ˈn a d o s
desaprovechada	d e s a p ɾ o b e ˈt͡ʃ a d a
chinicuil	t͡ʃ i n i ˈk w i l
acopla	a ˈk o p l a
ruido	ˈr w i d o
vasca	ˈb a s k a
reme	ˈr e m e
abejorro	a b e ˈx o r o
troquelar	t ɾ o k e ˈl a ɾ
caballeresco	k a b a ʝ e ˈɾ e s k o
seriaremos	s e ɾ j a ˈɾ e m o s
buró	b u ˈɾ o
inconcreto	i n k o n ˈk ɾ e t o
culminado	k u l m i ˈn a d o
antineutrino	a n t i n e u ˈt ɾ i n o
llegue	ˈʝ e ɡ e
sistemáticas	s i s t e ˈm a t i k a s
alfaques	a l ˈf a k e s
florales	f l o ˈɾ a l e s
golpeteasen	ɡ o l p e t e ˈa s e n
catuaba	k a ˈt w a b a
obstruidos	o b s ˈt ɾ w i d o s
idolatrados	i d o l a ˈt ɾ a d o s
irritadas	i r i ˈt a d a s
cuidando	k w i ˈd a n d o
codón	k o ˈd o n
transfeminismo	t ɾ a n s f e m i ˈn i s m o
leoninos	l e o ˈn i n o s
mineróloga	m i n e ˈɾ o l o ɡ a
badalonesa	b a d a l o ˈn e s a
iglesita	i ɡ l e ˈs i t a
Nursultán	n u ɾ s u l ˈt a n
caucásico	k a u ˈk a s i k o
incruenta	i n ˈk ɾ w e n t a
rutina	r u ˈt i n a
taco	ˈt a k o
premiaríamos	p ɾ e m j a ˈɾ i a m o s
diabólicos	d j a ˈb o l i k o s
fermentaríamos	f e ɾ m e n t a ˈɾ i a m o s
sangría	s a n ˈɡ ɾ i a
usulutecas	u s u l u ˈt e k a s
empleador	e m p l e a ˈd o ɾ
rescatadas	r e s k a ˈt a d a s
conejillo	k o n e ˈx i ʝ o
conmutados	k o m m u ˈt a d o s
barda	ˈb a ɾ d a
androide	a n ˈd ɾ o i d e
mandatoria	m a n d a ˈt o ɾ j a
codificado	k o d i f i ˈk a d o
becarias	b e ˈk a ɾ j a s
suplementado	s u p l e m e n ˈt a d o
acopiada	a k o ˈp j a d a
enología	e n o l o ˈx i a
ordeno	o ɾ ˈd e n o
galés	ɡ a ˈl e s
viudita	b j u ˈd i t a
desinteresado	d e s i n t e ɾ e ˈs a d o
fiestones	f j e s ˈt o n e s
belfo	ˈb e l f o
ultrajados	u l t ɾ a ˈx a d o s
trol	ˈt ɾ o l
védate	ˈb e d a t e
irradiante	i r a ˈd j a n t e
pituco	p i ˈt u k o
degradados	d e ɡ ɾ a ˈd a d o s
opaca	o ˈp a k a
eslabonamiento	e s l a b o n a ˈm j e n t o
sobrevalorada	s o b ɾ e b a l o ˈɾ a d a
transparentada	t ɾ a n s p a ɾ e n ˈt a d a
fincados	f i n ˈk a d o s
estrechas	e s ˈt ɾ e t͡ʃ a s
monocromáticas	m o n o k ɾ o ˈm a t i k a s
identificada	i d e n t i f i ˈk a d a
byte	ˈb a i t
agremiados	a ɡ ɾ e ˈm j a d o s
refulgidas	r e f u l ˈx i d a s
canoero	k a n o ˈe ɾ o
miráculo	m i ˈɾ a k u l o
ubérrimos	u ˈb e r i m o s
termine	t e ɾ ˈm i n e
liberar	l i b e ˈɾ a ɾ
chompa	ˈt͡ʃ o m p a
topónimo	t o ˈp o n i m o
tacleado	t a k l e ˈa d o
semimeridiano	s e m i m e ɾ i ˈd j a n o
desatendidas	d e s a t e n ˈd i d a s
sobrevalorados	s o b ɾ e b a l o ˈɾ a d o s
tautología	t a u t o l o ˈx i a
miositis	m j o ˈs i t i s
obsequiada	o b s e ˈk j a d a
atenuantes	a t e ˈn w a n t e s
cagarse	k a ˈɡ a ɾ s e
decano	d e ˈk a n o
smoking	e s ˈm o k i n
henchida	e n ˈt͡ʃ i d a
cablegrafiadas	k a b l e ɡ ɾ a ˈf j a d a s
terraplenados	t e r a p l e ˈn a d o s
sarga	ˈs a ɾ ɡ a
frustrando	f ɾ u s ˈt ɾ a n d o
yokut	ʝ o ˈk u t
parsec	p a ɾ ˈs e k
estarles	e s ˈt a ɾ l e s
verija	b e ˈɾ i x a
destupir	d e s t u ˈp i ɾ
seísmo	s e ˈi s m o
arará	a ɾ a ˈɾ a
abundas	a ˈb u n d a s
chinchilla	t͡ʃ i n ˈt͡ʃ i ʝ a
grapo	ˈɡ ɾ a p o
compulsivas	k o m p u l ˈs i b a s
fufada	f u ˈf a d a
Espinal	e s p i ˈn a l
revestí	r e b e s ˈt i
normoevolutivo	n o ɾ m o e b o l u ˈt i b o
apelas	a ˈp e l a s
distensible	d i s t e n ˈs i b l e
patotero	p a t o ˈt e ɾ o
hollejo	o ˈʝ e x o
auscultares	a u s k u l ˈt a ɾ e s
primate	p ɾ i ˈm a t e
ubérrimo	u ˈb e r i m o
fenaquistoscopio	f e n a k i s t o s ˈk o p j o
sonados	s o ˈn a d o s
catán	k a ˈt a n
improvisar	i m p ɾ o b i ˈs a ɾ
opositora	o p o s i ˈt o ɾ a
mucho	ˈm u t͡ʃ o
anfíbol	a n ˈf i b o l
alcaide	a l ˈk a i d e
estallable	e s t a ˈʝ a b l e
endeudado	e n d e u ˈd a d o
abaldonaros	a b a l d o ˈn a ɾ o s
redargüidas	r e d a ɾ ˈɡ w i d a s
rabel	r a ˈb e l
atusadas	a t u ˈs a d a s
pesquise	p e s ˈk i s e
extensas	e ɡ s ˈt e n s a s
vosotras	b o ˈs o t ɾ a s
bastir	b a s ˈt i ɾ
resaltar	r e s a l ˈt a ɾ
alquitranados	a l k i t ɾ a ˈn a d o s
tribanda	t ɾ i ˈb a n d a
errarás	e r a ˈɾ a s
trancares	t ɾ a n ˈk a ɾ e s
candelabro	k a n d e ˈl a b ɾ o
épicorreligioso	ˈe p i k o r e l i x j o s o
sofisticares	s o f i s t i ˈk a ɾ e s
tirón	t i ˈɾ o n
generado	x e n e ˈɾ a d o
adquirida	a d k i ˈɾ i d a
tomografía	t o m o ɡ ɾ a ˈf i a
contenidos	k o n t e ˈn i d o s
oncogénesis	o n k o ˈx e n e s i s
aspectada	a s p e ɡ ˈt a d a
Higüey	i ˈɡ w e i
envidioso	e m b i ˈd j o s o
dividimos	d i b i ˈd i m o s
abdicará	a b d i k a ˈɾ a
prosterná	p ɾ o s t e ɾ ˈn a
nativa	n a ˈt i b a
arrecostar	a r e k o s ˈt a ɾ
llamaremos	ʝ a m a ˈɾ e m o s
opulento	o p u ˈl e n t o
competidor	k o m p e t i ˈd o ɾ
rumbeados	r u m b e ˈa d o s
tímalo	ˈt i m a l o
comiéndolo	k o ˈm j e n d o l o
buriláramos	b u ɾ i ˈl a ɾ a m o s
blanqueados	b l a n k e ˈa d o s
anidados	a n i ˈd a d o s
desgarradas	d e s ɡ a ˈr a d a s
detergidos	d e t e ɾ ˈx i d o s
copilota	k o p i ˈl o t a
habiéndole	a ˈb j e n d o l e
paulino	p a u ˈl i n o
rafagueados	r a f a ɡ e ˈa d o s
polimorfa	p o l i ˈm o ɾ f a
Emanuel	e m a ˈn w e l
aperadora	a p e ɾ a ˈd o ɾ a
aligerados	a l i x e ˈɾ a d o s
afirmativo	a f i ɾ m a ˈt i b o
lanchero	l a n ˈt͡ʃ e ɾ o
redescubierto	r e d e s k u ˈb j e ɾ t o
vertida	b e ɾ ˈt i d a
don	ˈd o n
ondina	o n ˈd i n a
tolteca	t o l ˈt e k a
estudio	e s ˈt u d j o
prendidos	p ɾ e n ˈd i d o s
vertedor	b e ɾ t e ˈd o ɾ
petrológico	p e t ɾ o ˈl o x i k o
Hipnos	ˈi b n o s
amblados	a m ˈb l a d o s
chasqueado	t͡ʃ a s k e ˈa d o
supervalorada	s u p e ɾ b a l o ˈɾ a d a
reverberar	r e b e ɾ b e ˈɾ a ɾ
bulón	b u ˈl o n
rasgueado	r a s ɡ e ˈa d o
triangula	t ɾ j a n ˈɡ u l a
dominicas	d o m i ˈn i k a s
babor	b a ˈb o ɾ
secretada	s e k ɾ e ˈt a d a
reelegido	r e e l e ˈx i d o
andáis	a n ˈd a i s
ska	ˈs k a
cosmovisión	k o s m o b i ˈs j o n
tituláramos	t i t u ˈl a ɾ a m o s
superpotente	s u p e ɾ p o ˈt e n t e
marchadas	m a ɾ ˈt͡ʃ a d a s
pasota	p a ˈs o t a
ola	ˈo l a
monda	ˈm o n d a
pop	ˈp o p
admitir	a d m i ˈt i ɾ
asamblea	a s a m ˈb l e a
desgarres	d e s ˈɡ a r e s
fisgoneo	f i s ɡ o ˈn e o
emigrados	e m i ˈɡ ɾ a d o s
sobrevolada	s o b ɾ e b o ˈl a d a
estaque	e s ˈt a k e
abstuvieren	a b s t u ˈb j e ɾ e n
quintacolumnista	k i n t a k o l u m ˈn i s t a
ova	ˈo b a
talego	t a ˈl e ɡ o
aclimata	a k l i ˈm a t a
veneraremos	b e n e ɾ a ˈɾ e m o s
embragadas	e m b ɾ a ˈɡ a d a s
obliterareis	o b l i t e ˈɾ a ɾ e i s
babeado	b a b e ˈa d o
estereotípicos	e s t e ɾ e o ˈt i p i k o s
deprisa	d e ˈp ɾ i s a
aparatología	a p a ɾ a t o l o ˈx i a
guitarristas	ɡ i t a ˈr i s t a s
demoremos	d e m o ˈɾ e m o s
futuro	f u ˈt u ɾ o
Borja	ˈb o ɾ x a
poli	ˈp o l i
habláramos	a ˈb l a ɾ a m o s
otosclerosis	o t o s k l e ˈɾ o s i s
váyanla	ˈb a ʝ a n l a
abisagrado	a b i s a ˈɡ ɾ a d o
yaresaní	ʝ a ɾ e s a ˈn i
discordada	d i s k o ɾ ˈd a d a
programa	p ɾ o ˈɡ ɾ a m a
lentificado	l e n t i f i ˈk a d o
perpetua	p e ɾ ˈp e t w a
guío	ˈɡ i o
Brayan	ˈb ɾ a ʝ a n
Kosovo	k o ˈs o b o
xenófobo	s e ˈn o f o b o
resquebrar	r e s k e ˈb ɾ a ɾ
espantoso	e s p a n ˈt o s o
tirémoslo	t i ˈɾ e m o s l o
enfangados	e n f a n ˈɡ a d o s
verberada	b e ɾ b e ˈɾ a d a
administraste	a d m i n i s ˈt ɾ a s t e
sobretensión	s o b ɾ e t e n ˈs j o n
sutilidad	s u t i l i ˈd a d
Guáimaro	ˈɡ w a i m a ɾ o
levitado	l e b i ˈt a d o
elamita	e l a ˈm i t a
convocados	k o m b o ˈk a d o s
exportaste	e ɡ s p o ɾ ˈt a s t e
autenticadas	a u t e n t i ˈk a d a s
sopetón	s o p e ˈt o n
desbotonar	d e s b o t o ˈn a ɾ
gavetero	ɡ a b e ˈt e ɾ o
escaparate	e s k a p a ˈɾ a t e
tetradimensionales	t e t ɾ a d i m e n s j o ˈn a l e s
austera	a u s ˈt e ɾ a
desmesurada	d e s m e s u ˈɾ a d a
soleada	s o l e ˈa d a
heredar	e ɾ e ˈd a ɾ
ruteo	r u ˈt e o
borrega	b o ˈr e ɡ a
tajante	t a ˈx a n t e
maquinistas	m a k i ˈn i s t a s
rayo	ˈr a ʝ o
usuaria	u ˈs w a ɾ j a
rogará	r o ɡ a ˈɾ a
casto	ˈk a s t o
definimos	d e f i ˈn i m o s
ufanadas	u f a ˈn a d a s
galvánico	ɡ a l ˈb a n i k o
pernoctar	p e ɾ n o ɡ ˈt a ɾ
colocado	k o l o ˈk a d o
fauna	ˈf a u n a
interétnicos	i n t e ˈɾ e d n i k o s
cautiva	k a u ˈt i b a
masturbador	m a s t u ɾ b a ˈd o ɾ
grupo	ˈɡ ɾ u p o
eufemísticos	e u f e ˈm i s t i k o s
administrareis	a d m i n i s ˈt ɾ a ɾ e i s
botil	b o ˈt i l
geranio	x e ˈɾ a n j o
titulaste	t i t u ˈl a s t e
Septuaginta	s e b t w a ˈx i n t a
asesora	a s e ˈs o ɾ a
soma	ˈs o m a
colapso	k o ˈl a b s o
cuatrimestral	k w a t ɾ i m e s ˈt ɾ a l
rehogar	r e o ˈɡ a ɾ
transplantada	t ɾ a n s p l a n ˈt a d a
honrilla	o n ˈr i ʝ a
ambivalente	a m b i b a ˈl e n t e
bordillo	b o ɾ ˈd i ʝ o
motilón	m o t i ˈl o n
forramos	f o ˈr a m o s
nalidíxico	n a l i ˈd i ɡ s i k o
reverendo	r e b e ˈɾ e n d o
legalidad	l e ɡ a l i ˈd a d
desosada	d e s o ˈs a d a
comentados	k o m e n ˈt a d o s
oncología	o n k o l o ˈx i a
salidora	s a l i ˈd o ɾ a
gernikarra	x e ɾ n i ˈk a r a
estampa	e s ˈt a m p a
inesperado	i n e s p e ˈɾ a d o
camerístico	k a m e ˈɾ i s t i k o
derecho	d e ˈɾ e t͡ʃ o
acabémosla	a k a ˈb e m o s l a
lerdo	ˈl e ɾ d o
acústicas	a ˈk u s t i k a s
catadióptrico	k a t a ˈd j o b t ɾ i k o
Batlle	ˈb a ʝ e
nerviosamente	n e ɾ ˌb j o s a ˈm e n t e
precavido	p ɾ e k a ˈb i d o
oportuno	o p o ɾ ˈt u n o
recalculamos	r e k a l k u ˈl a m o s
hipersexualidad	i p e ɾ s e ɡ s w a l i ˈd a d
anatomía	a n a t o ˈm i a
estenos	e s ˈt e n o s
muertitas	m w e ɾ ˈt i t a s
suegra	ˈs w e ɡ ɾ a
hevea	e ˈb e a
esgrimidor	e s ɡ ɾ i m i ˈd o ɾ
hipocomplementemia	i p o k o m p l e m e n ˈt e m j a
malherido	m a l e ˈɾ i d o
abaratados	a b a ɾ a ˈt a d o s
arropado	a r o ˈp a d o
comidilla	k o m i ˈd i ʝ a
neumoconiosis	n e u m o k o ˈn j o s i s
batistianas	b a t i s ˈt j a n a s
atresia	a ˈt ɾ e s j a
antinomia	a n t i ˈn o m j a
pseudohistoria	s e u d o i s ˈt o ɾ j a
cantante	k a n ˈt a n t e
mesentérico	m e s e n ˈt e ɾ i k o
arrollados	a r o ˈʝ a d o s
tonadilla	t o n a ˈd i ʝ a
gratinaste	ɡ ɾ a t i ˈn a s t e
trasmutados	t ɾ a s m u ˈt a d o s
yago	ˈʝ a ɡ o
despercudir	d e s p e ɾ k u ˈd i ɾ
emisión	e m i ˈs j o n
goleadas	ɡ o l e ˈa d a s
encontraras	e n k o n ˈt ɾ a ɾ a s
potasemia	p o t a ˈs e m j a
tuberosidad	t u b e ɾ o s i ˈd a d
musicología	m u s i k o l o ˈx i a
aventurares	a b e n t u ˈɾ a ɾ e s
purgado	p u ɾ ˈɡ a d o
prohibitorios	p ɾ o i b i ˈt o ɾ j o s
ventriloquia	b e n t ɾ i ˈl o k j a
cumplimentados	k u m p l i m e n ˈt a d o s
respeto	r e s ˈp e t o
trincadas	t ɾ i n ˈk a d a s
pantalones	p a n t a ˈl o n e s
romboide	r o m ˈb o i d e
aldónico	a l ˈd o n i k o
modelando	m o d e ˈl a n d o
abaldónense	a b a l ˈd o n e n s e
empatados	e m p a ˈt a d o s
fechemos	f e ˈt͡ʃ e m o s
acabareis	a k a ˈb a ɾ e i s
ambientadores	a m b j e n t a ˈd o ɾ e s
piquito	p i ˈk i t o
habladla	a ˈb l a d l a
rebobinar	r e b o b i ˈn a ɾ
quebradita	k e b ɾ a ˈd i t a
comprador	k o m p ɾ a ˈd o ɾ
Bretaña	b ɾ e ˈt a ɲ a
eclipsará	e k l i b s a ˈɾ a
autonomista	a u t o n o ˈm i s t a
abastardé	a b a s t a ɾ ˈd e
sofocamiento	s o f o k a ˈm j e n t o
postobligatorios	p o s t o b l i ɡ a ˈt o ɾ j o s
orlará	o ɾ l a ˈɾ a
distinto	d i s ˈt i n t o
tascas	ˈt a s k a s
golpismo	ɡ o l ˈp i s m o
pelador	p e l a ˈd o ɾ
abocar	a b o ˈk a ɾ
cartesianos	k a ɾ t e ˈs j a n o s
porrito	p o ˈr i t o
atrevimiento	a t ɾ e b i ˈm j e n t o
sopor	s o ˈp o ɾ
fincado	f i n ˈk a d o
triangulará	t ɾ j a n ɡ u l a ˈɾ a
espejado	e s p e ˈx a d o
gilipollas	x i l i ˈp o ʝ a s
notadas	n o ˈt a d a s
ostión	o s ˈt j o n
perturbados	p e ɾ t u ɾ ˈb a d o s
hidroeléctrico	i d ɾ o e ˈl e ɡ t ɾ i k o
diablita	d j a ˈb l i t a
ruines	ˈr w i n e s
Antón	a n ˈt o n
coartados	k o a ɾ ˈt a d o s
augurada	a u ɡ u ˈɾ a d a
crie	ˈk ɾ j e
agotado	a ɡ o ˈt a d o
sed	ˈs e d
arponeadas	a ɾ p o n e ˈa d a s
lechoso	l e ˈt͡ʃ o s o
endocraneano	e n d o k ɾ a n e ˈa n o
desenchufadas	d e s e n t͡ʃ u ˈf a d a s
suplicamos	s u p l i ˈk a m o s
trombina	t ɾ o m ˈb i n a
bolardo	b o ˈl a ɾ d o
imantadas	i m a n ˈt a d a s
titiritéele	t i t i ɾ i ˈt e e l e
conmutatividad	k o m m u t a t i b i ˈd a d
caballera	k a b a ˈʝ e ɾ a
absolveríais	a b s o l b e ˈɾ i a i s
endovascular	e n d o b a s k u ˈl a ɾ
cavador	k a b a ˈd o ɾ
bosar	b o ˈs a ɾ
paleáramos	p a l e ˈa ɾ a m o s
vetaste	b e ˈt a s t e
tranqui	ˈt ɾ a n k i
premonitoria	p ɾ e m o n i ˈt o ɾ j a
contractualista	k o n t ɾ a ɡ t w a ˈl i s t a
Irenea	i ɾ e ˈn e a
prospectora	p ɾ o s p e ɡ ˈt o ɾ a
psíquico	ˈs i k i k o
periné	p e ɾ i ˈn e
desgranada	d e s ɡ ɾ a ˈn a d a
toltecas	t o l ˈt e k a s
algodonadas	a l ɡ o d o ˈn a d a s
cleriguito	k l e ɾ i ˈɡ i t o
poso	ˈp o s o
peloteado	p e l o t e ˈa d o
meditareis	m e d i ˈt a ɾ e i s
suélenla	ˈs w e l e n l a
Vaupés	b a u ˈp e s
tonificadas	t o n i f i ˈk a d a s
acobardara	a k o b a ɾ ˈd a ɾ a
predictibilidad	p ɾ e d i ɡ t i b i l i ˈd a d
oh	ˈo
cuartito	k w a ɾ ˈt i t o
gusto	ˈɡ u s t o
denotara	d e n o ˈt a ɾ a
extrasistólicos	e ɡ s t ɾ a s i s ˈt o l i k o s
hables	ˈa b l e s
fermentaras	f e ɾ m e n ˈt a ɾ a s
voleo	b o ˈl e o
neologismo	n e o l o ˈx i s m o
jamelgo	x a ˈm e l ɡ o
anuario	a ˈn w a ɾ j o
bastitanas	b a s t i ˈt a n a s
xerografiados	s e ɾ o ɡ ɾ a ˈf j a d o s
baremados	b a ɾ e ˈm a d o s
coventículo	k o b e n ˈt i k u l o
higüero	i ˈɡ w e ɾ o
crónica	ˈk ɾ o n i k a
rabanito	r a b a ˈn i t o
débil	ˈd e b i l
oliente	o ˈl j e n t e
temeos	t e ˈm e o s
relampaguee	r e l a m p a ˈɡ e e
enroca	e n ˈr o k a
diseminar	d i s e m i ˈn a ɾ
discrepadas	d i s k ɾ e ˈp a d a s
linfoides	l i n ˈf o i d e s
reposados	r e p o ˈs a d o s
indexar	i n d e ɡ ˈs a ɾ
necrólisis	n e ˈk ɾ o l i s i s
Góngora	ˈɡ o n ɡ o ɾ a
empinemos	e m p i ˈn e m o s
almarrá	a l m a ˈr a
posromántico	p o s r o ˈm a n t i k o
saudade	s a u ˈd a d e
oiréis	o i ˈɾ e i s
remojadas	r e m o ˈx a d a s
ladrones	l a ˈd ɾ o n e s
guadaña	ɡ w a ˈd a ɲ a
cunques	ˈk u n k e s
balasto	b a ˈl a s t o
desajustada	d e s a x u s ˈt a d a
jachapuri	x a t͡ʃ a ˈp u ɾ i
blusón	b l u ˈs o n
ornitólogo	o ɾ n i ˈt o l o ɡ o
austral	a u s ˈt ɾ a l
Valdemar	b a l d e ˈm a ɾ
hervida	e ɾ ˈb i d a
vidriadas	b i ˈd ɾ j a d a s
axiológico	a ɡ s j o ˈl o x i k o
recopilador	r e k o p i l a ˈd o ɾ
apuntillado	a p u n t i ˈʝ a d o
apeles	a ˈp e l e s
afecta	a ˈf e ɡ t a
ternero	t e ɾ ˈn e ɾ o
comprensible	k o m p ɾ e n ˈs i b l e
granada	ɡ ɾ a ˈn a d a
buscando	b u s ˈk a n d o
estrelladas	e s t ɾ e ˈʝ a d a s
afiladera	a f i l a ˈd e ɾ a
exagera	e ɡ s a ˈx e ɾ a
anómalo	a ˈn o m a l o
adúltera	a ˈd u l t e ɾ a
traedora	t ɾ a e ˈd o ɾ a
humilladero	u m i ʝ a ˈd e ɾ o
sobrepujaremos	s o b ɾ e p u x a ˈɾ e m o s
entrevistadores	e n t ɾ e b i s t a ˈd o ɾ e s
velaste	b e ˈl a s t e
Mantua	ˈm a n t w a
sorpresita	s o ɾ p ɾ e ˈs i t a
antigua	a n ˈt i ɡ w a
pretendida	p ɾ e t e n ˈd i d a
monocromo	m o n o ˈk ɾ o m o
rayuela	r a ˈʝ w e l a
abarrotado	a b a r o ˈt a d o
enterrares	e n t e ˈr a ɾ e s
abajar	a b a ˈx a ɾ
blanquillo	b l a n ˈk i ʝ o
escuincle	e s ˈk w i n k l e
suma	ˈs u m a
declarares	d e k l a ˈɾ a ɾ e s
elabora	e l a ˈb o ɾ a
cohetón	k o e ˈt o n
fomentémoste	f o m e n ˈt e m o s t e
poliamoroso	p o l i a m o ˈɾ o s o
desembolsadas	d e s e m b o l ˈs a d a s
Chile	ˈt͡ʃ i l e
litronas	l i ˈt ɾ o n a s
cracoviano	k ɾ a k o ˈb j a n o
peneanos	p e n e ˈa n o s
Lavapiés	ˌl a b a ˈp j e s
ilinoisiano	i l i n o i ˈs j a n o
latino	l a ˈt i n o
esgrimir	e s ɡ ɾ i ˈm i ɾ
abatatada	a b a t a ˈt a d a
lídar	ˈl i d a ɾ
eludes	e ˈl u d e s
distintiva	d i s t i n ˈt i b a
rumorados	r u m o ˈɾ a d o s
finco	ˈf i n k o
vituperar	b i t u p e ˈɾ a ɾ
litio	ˈl i t j o
expansivo	e ɡ s p a n ˈs i b o
desmorir	d e s m o ˈɾ i ɾ
chufado	t͡ʃ u ˈf a d o
reconfiguradas	r e k o n f i ɡ u ˈɾ a d a s
enjugador	e n x u ɡ a ˈd o ɾ
deltoidal	d e l t o i ˈd a l
cacahuete	k a k a ˈw e t e
propano	p ɾ o ˈp a n o
retrucaste	r e t ɾ u ˈk a s t e
lalada	l a ˈl a d a
reparas	r e ˈp a ɾ a s
confluir	k o n ˈf l w i ɾ
motito	m o ˈt i t o
márfega	ˈm a ɾ f e ɡ a
falsarios	f a l ˈs a ɾ j o s
virará	b i ɾ a ˈɾ a
desportillar	d e s p o ɾ t i ˈʝ a ɾ
encasquetado	e n k a s k e ˈt a d o
Escobar	e s k o ˈb a ɾ
comierais	k o ˈm j e ɾ a i s
cansada	k a n ˈs a d a
tener	t e ˈn e ɾ
mostraste	m o s ˈt ɾ a s t e
ecología	e k o l o ˈx i a
chachapoya	t͡ʃ a t͡ʃ a ˈp o ʝ a
anticucho	a n t i ˈk u t͡ʃ o
viable	ˈb j a b l e
suntuosidad	s u n t w o s i ˈd a d
escaladas	e s k a ˈl a d a s
habitadora	a b i t a ˈd o ɾ a
vetustense	b e t u s ˈt e n s e
predestinado	p ɾ e d e s t i ˈn a d o
limitadora	l i m i t a ˈd o ɾ a
jalapeño	x a l a ˈp e ɲ o
pajarera	p a x a ˈɾ e ɾ a
pélvica	ˈp e l b i k a
membranoproliferativo	m e m b ɾ a n o p ɾ o l i f e ɾ a ˈt i b o
tentativa	t e n t a ˈt i b a
actividades	a ɡ t i b i ˈd a d e s
chutaríamos	t͡ʃ u t a ˈɾ i a m o s
enripiadas	e n r i ˈp j a d a s
agolpado	a ɡ o l ˈp a d o
tumor	t u ˈm o ɾ
quinario	k i ˈn a ɾ j o
jimia	ˈx i m j a
capirote	k a p i ˈɾ o t e
estudiado	e s t u ˈd j a d o
televisor	t e l e b i ˈs o ɾ
dictaminadora	d i ɡ t a m i n a ˈd o ɾ a
puntilloso	p u n t i ˈʝ o s o
amputado	a m p u ˈt a d o
resanar	r e s a ˈn a ɾ
suscrito	s u s ˈk ɾ i t o
usurero	u s u ˈɾ e ɾ o
lentillo	l e n ˈt i ʝ o
altivo	a l ˈt i b o
dictablanda	d i ɡ t a ˈb l a n d a
aduláramos	a d u ˈl a ɾ a m o s
sorpresivo	s o ɾ p ɾ e ˈs i b o
achicopalaos	a t͡ʃ i k o p a ˈl a o s
coqueteado	k o k e t e ˈa d o
morir	m o ˈɾ i ɾ
suinos	ˈs w i n o s
dimisionar	d i m i s j o ˈn a ɾ
septiembre	s e b ˈt j e m b ɾ e
derrochador	d e r o t͡ʃ a ˈd o ɾ
escamocha	e s k a ˈm o t͡ʃ a
enramada	e n r a ˈm a d a
autótrofo	a u ˈt o t ɾ o f o
anestesiaremos	a n e s t e s j a ˈɾ e m o s
epodo	e ˈp o d o
focal	f o ˈk a l
absuelto	a b ˈs w e l t o
pegar	p e ˈɡ a ɾ
caben	ˈk a b e n
tejita	t e ˈx i t a
extrasistólica	e ɡ s t ɾ a s i s ˈt o l i k a
burdeos	b u ɾ ˈd e o s
alcachofera	a l k a t͡ʃ o ˈf e ɾ a
alijaste	a l i ˈx a s t e
elequeme	e l e ˈk e m e
extracapilares	e ɡ s t ɾ a k a p i ˈl a ɾ e s
oportunísimo	o p o ɾ t u ˈn i s i m o
cocotes	k o ˈk o t e s
pekinesas	p e k i ˈn e s a s
autodestruidas	a u t o d e s ˈt ɾ w i d a s
autocorregido	a u t o k o r e ˈx i d o
grillar	ɡ ɾ i ˈʝ a ɾ
emulsionada	e m u l s j o ˈn a d a
aparo	a ˈp a ɾ o
Reye	ˈr e ʝ e
partamos	p a ɾ ˈt a m o s
reintensificada	r e i n t e n s i f i ˈk a d a
ofrenda	o ˈf ɾ e n d a
husmeada	u s m e ˈa d a
embargadas	e m b a ɾ ˈɡ a d a s
diseñar	d i s e ˈɲ a ɾ
tirará	t i ɾ a ˈɾ a
autoconvocarse	a u t o k o m b o ˈk a ɾ s e
botáramos	b o ˈt a ɾ a m o s
domareis	d o ˈm a ɾ e i s
peleados	p e l e ˈa d o s
palmita	p a l ˈm i t a
trastabilleadas	t ɾ a s t a b i ʝ e ˈa d a s
duche	ˈd u t͡ʃ e
sorpresivamente	s o ɾ p ɾ e ˌs i b a ˈm e n t e
amañada	a m a ˈɲ a d a
andándoles	a n ˈd a n d o l e s
entallador	e n t a ʝ a ˈd o ɾ
jauría	x a u ˈɾ i a
regrabados	r e ɡ ɾ a ˈb a d o s
arquitecto	a ɾ k i ˈt e ɡ t o
onagro	o ˈn a ɡ ɾ o
reprochamos	r e p ɾ o ˈt͡ʃ a m o s
regresadas	r e ɡ ɾ e ˈs a d a s
Boluarte	b o ˈl w a ɾ t e
farmacológico	f a ɾ m a k o ˈl o x i k o
combinare	k o m b i ˈn a ɾ e
languor	l a n ˈɡ w o ɾ
colombina	k o l o m ˈb i n a
columbradas	k o l u m ˈb ɾ a d a s
esponjosos	e s p o n ˈx o s o s
nacatamal	n a k a t a ˈm a l
lampasados	l a m p a ˈs a d o s
mandacaru	m a n d a ˈk a ɾ u
ficado	f i ˈk a d o
guerrilla	ɡ e ˈr i ʝ a
degenerativa	d e x e n e ɾ a ˈt i b a
satisfechísimo	s a t i s f e ˈt͡ʃ i s i m o
premedita	p ɾ e m e ˈd i t a
escolar	e s k o ˈl a ɾ
herbolarias	e ɾ b o ˈl a ɾ j a s
panadería	p a n a d e ˈɾ i a
mamoneá	m a m o n e ˈa
pisón	p i ˈs o n
declamado	d e k l a ˈm a d o
simulado	s i m u ˈl a d o
calafateados	k a l a f a t e ˈa d o s
desproveyera	d e s p ɾ o b e ˈʝ e ɾ a
calor	k a ˈl o ɾ
organismo	o ɾ ɡ a ˈn i s m o
grieta	ˈɡ ɾ j e t a
mosaicos	m o ˈs a i k o s
lisonjero	l i s o n ˈx e ɾ o
estaño	e s ˈt a ɲ o
autolesionada	a u t o l e s j o ˈn a d a
colicorto	k o l i ˈk o ɾ t o
tachada	t a ˈt͡ʃ a d a
parador	p a ɾ a ˈd o ɾ
núcleo	ˈn u k l e o
banderita	b a n d e ˈɾ i t a
carrero	k a ˈr e ɾ o
frecuentadora	f ɾ e k w e n t a ˈd o ɾ a
magenta	m a ˈx e n t a
voleada	b o l e ˈa d a
Vito	ˈb i t o
adelitas	a d e ˈl i t a s
guineoecuatorial	ɡ i n e o e k w a t o ˈɾ j a l
incumbidas	i n k u m ˈb i d a s
desensillar	d e s e n s i ˈʝ a ɾ
desprestigiado	d e s p ɾ e s t i ˈx j a d o
convulsivo	k o m b u l ˈs i b o
miocarditis	m j o k a ɾ ˈd i t i s
leudo	ˈl e u d o
Choy	ˈt͡ʃ o i
dentudo	d e n ˈt u d o
cofre	ˈk o f ɾ e
replanteados	r e p l a n t e ˈa d o s
guapo	ˈɡ w a p o
jamaicanos	x a m a i ˈk a n o s
estaquillas	e s t a ˈk i ʝ a s
superpremiado	s u p e ɾ p ɾ e ˈm j a d o
comilonas	k o m i ˈl o n a s
asará	a s a ˈɾ a
disculpa	d i s ˈk u l p a
ministrado	m i n i s ˈt ɾ a d o
soláis	s o ˈl a i s
oaxaqueño	w̝ a x a ˈk e ɲ o
prevaricadora	p ɾ e b a ɾ i k a ˈd o ɾ a
ninguneada	n i n ɡ u n e ˈa d a
surfeados	s u ɾ f e ˈa d o s
mongolito	m o n ɡ o ˈl i t o
regule	r e ˈɡ u l e
escarda	e s ˈk a ɾ d a
seguradas	s e ɡ u ˈɾ a d a s
lloriqueados	ʝ o ɾ i k e ˈa d o s
tipológicos	t i p o ˈl o x i k o s
cantanos	k a n ˈt a n o s
pellín	p e ˈʝ i n
atreveríamos	a t ɾ e b e ˈɾ i a m o s
aquitano	a k i ˈt a n o
soler	s o ˈl e ɾ
corcho	ˈk o ɾ t͡ʃ o
sicológicas	s i k o ˈl o x i k a s
conversara	k o m b e ɾ ˈs a ɾ a
apocopa	a p o ˈk o p a
balleneras	b a ʝ e ˈn e ɾ a s
queísmo	k e ˈi s m o
fosforilaremos	f o s f o ɾ i l a ˈɾ e m o s
elegantes	e l e ˈɡ a n t e s
aguará	a ɡ w a ˈɾ a
olimpiada	o l i m ˈp j a d a
becuadro	b e ˈk w a d ɾ o
rédito	ˈr e d i t o
tolina	t o ˈl i n a
resoluto	r e s o ˈl u t o
llamémosla	ʝ a ˈm e m o s l a
compurgamos	k o m p u ɾ ˈɡ a m o s
comuniques	k o m u ˈn i k e s
profundamente	p ɾ o ˌf u n d a ˈm e n t e
ameba	a ˈm e b a
filmar	f i l ˈm a ɾ
leías	l e ˈi a s
inmunocomprometidos	i m m u n o k o m p ɾ o m e ˈt i d o s
hablándome	a ˈb l a n d o m e
atrofiará	a t ɾ o f j a ˈɾ a
ultrarreligiosa	u l t ɾ a r e l i ˈx j o s a
canela	k a ˈn e l a
Piamonte	p j a ˈm o n t e
veámoslos	b e ˈa m o s l o s
pluripatológico	p l u ɾ i p a t o ˈl o x i k o
marmota	m a ɾ ˈm o t a
aventures	a b e n ˈt u ɾ e s
salvaguardamos	s a l b a ɡ w a ɾ ˈd a m o s
fibrinosos	f i b ɾ i ˈn o s o s
colorada	k o l o ˈɾ a d a
hierosolimitano	ʝ e ɾ o s o l i m i ˈt a n o
acompañamiento	a k o m p a ɲ a ˈm j e n t o
abstendríamos	a b s t e n ˈd ɾ i a m o s
calda	ˈk a l d a
trilineal	t ɾ i l i n e ˈa l
daríamos	d a ˈɾ i a m o s
et	ˈe t
godo	ˈɡ o d o
abajadlo	a b a ˈx a d l o
remunerativo	r e m u n e ɾ a ˈt i b o
emperrar	e m p e ˈr a ɾ
hayámoos	a ˈʝ a m o o s
atas	ˈa t a s
desencadenador	d e s e n k a d e n a ˈd o ɾ
acuitados	a k w i ˈt a d o s
espesas	e s ˈp e s a s
tírenla	ˈt i ɾ e n l a
estacados	e s t a ˈk a d o s
acordándose	a k o ɾ ˈd a n d o s e
crac	ˈk ɾ a k
postulas	p o s ˈt u l a s
protamina	p ɾ o t a ˈm i n a
blocadas	b l o ˈk a d a s
acuminadas	a k u m i ˈn a d a s
Amarillo	a m a ˈɾ i ʝ o
rondeña	r o n ˈd e ɲ a
espachurrada	e s p a t͡ʃ u ˈr a d a
Mauro	ˈm a u ɾ o
polenta	p o ˈl e n t a
amargosa	a m a ɾ ˈɡ o s a
amistado	a m i s ˈt a d o
techados	t e ˈt͡ʃ a d o s
caxcana	k a ɡ s ˈk a n a
ratificamos	r a t i f i ˈk a m o s
secuestrador	s e k w e s t ɾ a ˈd o ɾ
petidina	p e t i ˈd i n a
trigarante	t ɾ i ɡ a ˈɾ a n t e
trasmontados	t ɾ a s m o n ˈt a d o s
putadita	p u t a ˈd i t a
vetaros	b e ˈt a ɾ o s
gerontóloga	x e ɾ o n ˈt o l o ɡ a
diptongada	d i b t o n ˈɡ a d a
divisadas	d i b i ˈs a d a s
andaban	a n ˈd a b a n
bandejita	b a n d e ˈx i t a
subveguería	s u b b e ɡ e ˈɾ i a
espinodal	e s p i n o ˈd a l
sidonia	s i ˈd o n j a
bayuca	b a ˈʝ u k a
testificar	t e s t i f i ˈk a ɾ
horroroso	o r o ˈɾ o s o
enredados	e n r e ˈd a d o s
mansega	m a n ˈs e ɡ a
parlamentarios	p a ɾ l a m e n ˈt a ɾ j o s
mandamiento	m a n d a ˈm j e n t o
bastoneadas	b a s t o n e ˈa d a s
puritanas	p u ɾ i ˈt a n a s
intemperante	i n t e m p e ˈɾ a n t e
lucaya	l u ˈk a ʝ a
abadernásemos	a b a d e ɾ ˈn a s e m o s
desternilladas	d e s t e ɾ n i ˈʝ a d a s
arbustiva	a ɾ b u s ˈt i b a
enlutar	e n l u ˈt a ɾ
saquear	s a k e ˈa ɾ
adenohipófisis	a d e n o i ˈp o f i s i s
ningunos	n i n ˈɡ u n o s
prearmar	p ɾ e a ɾ ˈm a ɾ
victimado	b i ɡ t i ˈm a d o
listillo	l i s ˈt i ʝ o
jadeados	x a d e ˈa d o s
estada	e s ˈt a d a
amarrete	a m a ˈr e t e
cómanle	ˈk o m a n l e
joderla	x o ˈd e ɾ l a
apanar	a p a ˈn a ɾ
sensatas	s e n ˈs a t a s
deteriorante	d e t e ɾ j o ˈɾ a n t e
rehén	r e ˈe n
cámping	ˈk a m p i n
puros	ˈp u ɾ o s
servil	s e ɾ ˈb i l
semiconductor	s e m i k o n d u ɡ ˈt o ɾ
discreteadas	d i s k ɾ e t e ˈa d a s
Cantórbery	k a n ˈt o ɾ b e ɾ i
restados	r e s ˈt a d o s
corsé	k o ɾ ˈs e
vetándoles	b e ˈt a n d o l e s
intrusadas	i n t ɾ u ˈs a d a s
cadaverosa	k a d a b e ˈɾ o s a
lubrifico	l u b ɾ i ˈf i k o
leyendo	l e ˈʝ e n d o
autogestionado	a u t o x e s t j o ˈn a d o
plebeyo	p l e ˈb e ʝ o
argumentar	a ɾ ɡ u m e n ˈt a ɾ
punalúa	p u n a ˈl u a
incluso	i n ˈk l u s o
frambueso	f ɾ a m ˈb w e s o
leoninas	l e o ˈn i n a s
definitivas	d e f i n i ˈt i b a s
cafeico	k a ˈf e i k o
oíble	o ˈi b l e
piemontés	p j e m o n ˈt e s
polbero	p o l ˈb e ɾ o
compendiado	k o m p e n ˈd j a d o
desarbolar	d e s a ɾ b o ˈl a ɾ
apetitosa	a p e t i ˈt o s a
sinostosis	s i n o s ˈt o s i s
arrullo	a ˈr u ʝ o
apagamos	a p a ˈɡ a m o s
cómanme	ˈk o m a m m e
vestibulococlear	b e s t i b u l o k o k l e ˈa ɾ
africada	a f ɾ i ˈk a d a
intransigentes	i n t ɾ a n s i ˈx e n t e s
vimos	ˈb i m o s
morfea	m o ɾ ˈf e a
fabrica	f a ˈb ɾ i k a
calumniosa	k a l u m ˈn j o s a
anaplásico	a n a ˈp l a s i k o
apocalipsis	a p o k a ˈl i b s i s
enastado	e n a s ˈt a d o
enrabietados	e n r a b j e ˈt a d o s
huno	ˈu n o
precapitalista	p ɾ e k a p i t a ˈl i s t a
retornado	r e t o ɾ ˈn a d o
huí	u ˈi
estaban	e s ˈt a b a n
reológico	r e o ˈl o x i k o
reproductivas	r e p ɾ o d u ɡ ˈt i b a s
cascajo	k a s ˈk a x o
sótano	ˈs o t a n o
Mercurio	m e ɾ ˈk u ɾ j o
alejada	a l e ˈx a d a
anteanoche	a n t e a ˈn o t͡ʃ e
bruñido	b ɾ u ˈɲ i d o
vetaríamos	b e t a ˈɾ i a m o s
deputaréis	d e p u t a ˈɾ e i s
faremos	f a ˈɾ e m o s
profusos	p ɾ o ˈf u s o s
ondulado	o n d u ˈl a d o
anadeadas	a n a d e ˈa d a s
perennifolio	p e ɾ e n n i ˈf o l j o
densificadas	d e n s i f i ˈk a d a s
alteo	a l ˈt e o
mericarpio	m e ɾ i ˈk a ɾ p j o
convergidos	k o m b e ɾ ˈx i d o s
esculturales	e s k u l t u ˈɾ a l e s
morfina	m o ɾ ˈf i n a
portuenses	p o ɾ ˈt w e n s e s
recostados	r e k o s ˈt a d o s
adoptando	a d o b ˈt a n d o
ampolla	a m ˈp o ʝ a
malditas	m a l ˈd i t a s
Angulo	a n ˈɡ u l o
juglaresco	x u ɡ l a ˈɾ e s k o
chulunca	t͡ʃ u ˈl u n k a
reproductiva	r e p ɾ o d u ɡ ˈt i b a
curvare	k u ɾ ˈb a ɾ e
Ledesma	l e ˈd e s m a
Marroquín	m a r o ˈk i n
burkinesa	b u ɾ k i ˈn e s a
inequívoca	i n e ˈk i b o k a
precavidas	p ɾ e k a ˈb i d a s
recolectadas	r e k o l e ɡ ˈt a d a s
sufragada	s u f ɾ a ˈɡ a d a
traficados	t ɾ a f i ˈk a d o s
intuir	i n ˈt w i ɾ
asuán	a ˈs w a n
cantarlas	k a n ˈt a ɾ l a s
Ramona	r a ˈm o n a
laboratorial	l a b o ɾ a t o ˈɾ j a l
testadas	t e s ˈt a d a s
moraríamos	m o ɾ a ˈɾ i a m o s
vial	ˈb j a l
ovil	o ˈb i l
reputar	r e p u ˈt a ɾ
contraatacados	k o n t ɾ a a t a ˈk a d o s
codesarrollado	k o d e s a r o ˈʝ a d o
heparina	e p a ˈɾ i n a
artesano	a ɾ t e ˈs a n o
subscriptos	s u b s ˈk ɾ i b t o s
forro	ˈf o r o
fructífero	f ɾ u ɡ ˈt i f e ɾ o
escapado	e s k a ˈp a d o
columnela	k o l u m ˈn e l a
enrocas	e n ˈr o k a s
sujetar	s u x e ˈt a ɾ
bagrátida	b a ˈɡ ɾ a t i d a
coliderar	k o l i d e ˈɾ a ɾ
sexar	s e ɡ ˈs a ɾ
defino	d e ˈf i n o
contestar	k o n t e s ˈt a ɾ
transfectar	t ɾ a n s f e ɡ ˈt a ɾ
deputemos	d e p u ˈt e m o s
entesitis	e n t e ˈs i t i s
expiado	e ɡ s ˈp j a d o
veneranda	b e n e ˈɾ a n d a
disyuntor	d i s ʝ u n ˈt o ɾ
ectópica	e ɡ ˈt o p i k a
funcar	f u n ˈk a ɾ
reputados	r e p u ˈt a d o s
butiá	b u ˈt j a
incolora	i n k o ˈl o ɾ a
florido	f l o ˈɾ i d o
gentilhombre	x e n t i ˈl o m b ɾ e
chupamiel	ˌt͡ʃ u p a ˈm j e l
mostraríamos	m o s t ɾ a ˈɾ i a m o s
lihueñe	l i ˈw e ɲ e
catinona	k a t i ˈn o n a
envestir	e m b e s ˈt i ɾ
pocotón	p o k o ˈt o n
autotrófico	a u t o ˈt ɾ o f i k o
abastos	a ˈb a s t o s
epigástrico	e p i ˈɡ a s t ɾ i k o
piquigualdo	p i k i ˈɡ w a l d o
Vichada	b i ˈt͡ʃ a d a
desrabotada	d e s r a b o ˈt a d a
acalorarse	a k a l o ˈɾ a ɾ s e
almodovarianos	a l m o d o b a ˈɾ j a n o s
saturaste	s a t u ˈɾ a s t e
latué	l a ˈt w e
escudriñamiento	e s k u d ɾ i ɲ a ˈm j e n t o
encuartelada	e n k w a ɾ t e ˈl a d a
ruinado	r w i ˈn a d o
predestinada	p ɾ e d e s t i ˈn a d a
espeso	e s ˈp e s o
rubéola	r u ˈb e o l a
conectaste	k o n e ɡ ˈt a s t e
unicameral	u n i k a m e ˈɾ a l
tándems	ˈt a n d e m s
mohínos	m o ˈi n o s
logísticas	l o ˈx i s t i k a s
quemador	k e m a ˈd o ɾ
calabriadas	k a l a ˈb ɾ j a d a s
optados	o b ˈt a d o s
bioéticas	b i o ˈe t i k a s
yiras	ˈʝ i ɾ a s
anchura	a n ˈt͡ʃ u ɾ a
criaturita	k ɾ j a t u ˈɾ i t a
vapeadas	b a p e ˈa d a s
rácano	ˈr a k a n o
alojativo	a l o x a ˈt i b o
quíntuplos	ˈk i n t u p l o s
Cartago	k a ɾ ˈt a ɡ o
endotérmicos	e n d o ˈt e ɾ m i k o s
trasquilado	t ɾ a s k i ˈl a d o
estuvieses	e s t u ˈb j e s e s
clamadas	k l a ˈm a d a s
microbiana	m i k ɾ o ˈb j a n a
traído	t ɾ a ˈi d o
manú	m a ˈn u
escarbador	e s k a ɾ b a ˈd o ɾ
cacheteada	k a t͡ʃ e t e ˈa d a
alardeados	a l a ɾ d e ˈa d o s
según	s e ˈɡ u n
indico	i n ˈd i k o
data	ˈd a t a
esponjoso	e s p o n ˈx o s o
minamos	m i ˈn a m o s
desdeñar	d e s d e ˈɲ a ɾ
pluripartidaria	p l u ɾ i p a ɾ t i ˈd a ɾ j a
anticarro	a n t i ˈk a r o
abrasaremos	a b ɾ a s a ˈɾ e m o s
sobrevoladas	s o b ɾ e b o ˈl a d a s
triángulos	ˈt ɾ j a n ɡ u l o s
puntilla	p u n ˈt i ʝ a
ligoteo	l i ɡ o ˈt e o
sacramento	s a k ɾ a ˈm e n t o
