фермер	f ɛ r m ɛ r
единайсет	ɛ d i n a j s ɛ t
движа	d v i ʒ ə
братле	b r ɐ t lʲ ɛ
дърва	d ə r v a
взривен	v z r i v ɛ n
лютив	lʲ u̟ t i f
седеф	s ɛ d ɛ f
зноен	z n ɔ ɛ n
наведе	n ɐ v ɛ d ɛ
магнетофон	m ə ɡ n ɛ t o f ɔ n
преда	p r ɛ d ɤ
плуг	p ɫ u k
възнасям	v ə z n a sʲ ə m
балкон	b ɐ ɫ k ɔ n
легион	lʲ ɛ ɡʲ i ɔ n
съблазнявам	s ə b ɫ ɐ z nʲ a̟ v ə m
тъкмо	t ɤ k m o
възлизалият	v ə z lʲ i z ə lʲ i j ə t
струва	s t r u v a
мегалитър	m ɛ ɡ ɐ lʲ i t ə r
тетрев	t ɛ t r ɛ f
мряхме	m rʲ a̟ x m ɛ
тръпчив	t r ə p t͡ʃ i f
узаконявало	ʊ z ə k o nʲ a̟ v ə ɫ o
румънец	r u m ɤ n ɛ t͡s
правя	p r a vʲ ə
че	t͡ʃ e
въстание	v ə s t a n i ɛ
жидък	ʒ i d ə k
села	s ɛ ɫ a
печален	p ɛ t͡ʃ a̟ lʲ ɛ n
груб	ɡ r u p
мощ	m ɔ ʃ t
домете	d o m ɛ t ɛ
стадион	s t ə d i ɔ n
мазен	m a z ɛ n
пасохме	p a s o x m ɛ
съединител	s ə ɛ d i n i t ɛ ɫ
щем	ʃ t ɛ m
население	n ə s ɛ lʲ ɛ n i ɛ
албатрос	ə ɫ b ɐ t r ɔ s
възхищение	v ə s xʲ i ʃ t ɛ n i ɛ
дайка	d a j k ə
пиво	p i v o
нежен	n ɛ ʒ e n
девойка	d ɛ v ɔ j k ə
улица	u lʲ i t͡s ə
нар	n a r
гигантски	ɡʲ i ɡ a n t s kʲ i
резба	r ɛ z b a
течение	t ɛ t͡ʃ e n i ɛ
противен	p r o t i v ɛ n
необходим	n ɛ o p x o d i m
щиглец	ʃ t i ɡ lʲ ɛ t͡s
измъкна	i z m ɤ k n ə
близък	b lʲ i z ə k
пренасям	p r ɛ n a sʲ ə m
мозък	m ɔ z ə k
чвор	t͡ʃ v ɔ r
павилион	p ə v i lʲ i ɔ n
агробиолог	a ɡ r o b i o ɫ ɔ k
нашето	n a ʃ e t o
декалитър	d ɛ k ɐ lʲ i t ə r
напластяване	n ə p ɫ ɐ s tʲ a̟ v ə n ɛ
завинаги	z ɐ v i n ə ɡʲ i
израстък	i z r a s t ə k
очилат	o t͡ʃ i ɫ a t
перилен	p ɛ r i lʲ ɛ n
аерогара	a ɛ r o ɡ a r ə
поради	p o r ɐ d i
аллах	ɐ ɫ ɫ a x
лопатар	ɫ o p ɐ t a r
строй	s t r ɔ j
началник	n ɐ t͡ʃ a̟ ɫ n i k
яд	j a̟ t
порядък	p o rʲ a̟ d ə k
ляво	lʲ a̟ v o
оцет	o t͡s ɛ t
дрехи	d r ɛ xʲ i
статистичен	s t ə t i s t i t͡ʃ e n
делфин	d ɛ ɫ f i n
блюя	b lʲ ʉ j ə
трезв	t r ɛ s f
ищах	i ʃ t a x
ухапете	u x a p ɛ t ɛ
кресло	k r ɛ s ɫ ɔ
градус	ɡ r a d ʊ s
движение	d v i ʒ e n i ɛ
особняк	o s o b nʲ a̟ k
предприемач	p r ɛ t p r i ɛ m a t͡ʃ
щене	ʃ t ɛ n ɛ
позлата	p o z ɫ a t ə
белоруски	b ɛ ɫ o r u s kʲ i
минус	m i n ʊ s
възкреся	v ə s k r ɛ sʲ ə
юбилей	j ʊ b i lʲ ɛ j
запали	z ɐ p a lʲ i
отвръщам	o t v r ɤ ʃ t ə m
подозра	p o d o z r ɤ
ваксина	v ɐ k s i n ə
тегло	t ɛ ɡ ɫ ɔ
дрозд	d r ɔ s t
разрушавам	r ə z r u ʃ a̟ v ə m
швейцарка	ʃ v ɛ j t͡s a r k ə
измисля	i z m i s lʲ ə
селен	s ɛ lʲ ɛ n
гробище	ɡ r ɔ b i ʃ t ɛ
ономува	o n o m u v ə
нашта	n a ʃ t ə
чивия	t͡ʃ i v i j ə
ходене	x ɔ d ɛ n ɛ
всъщност	f s ɤ ʃ n o s t
гърция	ɡ ɤ r t͡s i j ə
кълва	k ə ɫ v a
матерен	m a t ɛ r ɛ n
кърджалия	k ə r d ʒ a̟ lʲ i j ə
благодаря	b ɫ ə ɡ o d ɐ rʲ ɤ̟
читателка	t͡ʃ i t a t ɛ ɫ k ə
утка	u t k ə
спасявам	s p ɐ sʲ a̟ v ə m
веселие	v ɛ s ɛ lʲ i ɛ
охрид	o x r i t
веднага	v ɛ d n a ɡ ə
прекалявам	p r ɛ k ɐ lʲ a̟ v ə m
канара	k ə n ɐ r a
монголия	m o ŋ ɡ ɔ lʲ i j ə
биолог	b i o ɫ ɔ k
забраня	z ə b r ɐ nʲ ɤ̟
щелия	ʃ t ɛ lʲ i j ə
драгой	d r ɐ ɡ ɔ j
брегове	b r ɛ ɡ o v ɛ
рицар	r i t͡s ə r
нарече	n ɐ r ɛ t͡ʃ e
кръстат	k r ə s t a t
ситен	s i t ɛ n
ярък	j a̟ r ə k
абразия	ɐ b r a z i j ə
личба	lʲ i d͡ʒ b ə
именно	i m ɛ n n o
видра	v i d r ə
низина	n i z i n a
философия	f i ɫ o s ɔ f i j ə
лутеций	ɫ u t ɛ t͡s iː
връв	v r ɤ f
журналист	ʒ ʊ r n ɐ lʲ i s t
козел	k o z ɛ ɫ
спътник	s p ɤ t n i k
галба	ɡ ɐ ɫ b a
поличба	p o lʲ i d͡ʒ b ə
алиби	ɐ lʲ i b i
силиций	s i lʲ i t͡s iː
аз	a s
сеизмичен	s ɛ i z m i t͡ʃ e n
колата	k o ɫ a t ə
узаконявайте	ʊ z ə k o nʲ a̟ v ə j t ɛ
кабинет	k ə b i n ɛ t
загина	z ɐ ɡʲ i n ə
цупя	t͡s u pʲ ə
кротък	k r ɔ t ə k
мощност	m ɔ ʃ n o s t
затворен	z ɐ t v ɔ r ɛ n
сое	s ɔ ɛ
водород	v o d o r ɔ t
чие	t͡ʃ i ɛ
атометър	ə t o m ɛ t ə r
съзра	s ə z r ɤ
раста	r ɐ s t ɤ
сестричка	s ɛ s t r i t͡ʃ k ə
литература	lʲ i t ɛ r ɐ t u r ə
ами	ɐ m i
мафия	m a f i j ə
недоимък	n ɛ d o i m ə k
неодим	n ɛ o d i m
поред	p o r ɛ t
обед	ɔ b ɛ t
велосипед	v ɛ ɫ o s i p ɛ t
инстинкт	i n s t i ŋ k t
решим	r ɛ ʃ i m
каква	k ɐ k v a
мрящата	m rʲ a̟ ʃ t ə t ə
плен	p lʲ ɛ n
хор	x ɔ r
повеляем	p o v ɛ lʲ a̟ ɛ m
кубатура	k ʊ b ɐ t u r ə
разходи	r ɐ s x ɔ d i
бавно	b a v n o
вишна	v i ʃ n ə
нула	n u ɫ a
червеношийка	t͡ʃ e r v ɛ n o ʃ iː k ə
млак	m ɫ a k
узаконявалата	ʊ z ə k o nʲ a̟ v ə ɫ ə t ə
кроме	k r ɔ m ɛ
нахапя	n ɐ x a pʲ ə
скръбав	s k r ɤ b ə f
скръндза	s k r ɤ n d z ə
гневен	ɡ n ɛ v ɛ n
рожба	r ɔ ʒ b ə
противоречив	p r o t i v o r ɛ t͡ʃ i f
цупят	t͡s u pʲ ə t
членувам	t͡ʃ lʲ ɛ n u v ə m
великански	v ɛ lʲ i k a n s kʲ i
конгрес	k o ŋ ɡ r ɛ s
ме	m ɛ
имаш	i m ə ʃ
космополитен	k o s m o p o lʲ i t ɛ n
фотограф	f o t o ɡ r a f
благаш	b ɫ ɐ ɡ a ʃ
въртя	v ə r tʲ ɤ̟
фабрика	f a b r i k ə
абисински	ə b i s i n s kʲ i
супермаркет	s ʊ p ɛ r m a r kʲ ɛ t
слава	s ɫ a v ə
леджа	lʲ ɛ d ʒ ə
любим	lʲ u̟ b i m
социален	s o t͡s i a lʲ ɛ n
ддс	d ɤ d ɤ s ɤ
радиоцентър	r a d i o t͡s ɛ n t ə r
щастлив	ʃ t ɐ s lʲ i f
драгаш	d r ɐ ɡ a ʃ
уплашвам	u p ɫ a ʃ v ə m
жужел	ʒ u̟ ʒ e ɫ
пасящ	p ɐ sʲ a̟ ʃ t
розов	r ɔ z o f
крадла	k r a d ɫ ə
обсъдя	o p s ɤ dʲ ə
ищай	i ʃ t a j
овластителен	o v ɫ ɐ s t i t ɛ lʲ ɛ n
хопам	x ɔ p ə m
предложа	p r ɛ d ɫ ɔ ʒ ə
стихия	s t i xʲ i j ə
югоизток	j ʊ ɡ o i s t o k
шифър	ʃ i f ə r
узаконявах	ʊ z ə k o nʲ a̟ v ə x
североизток	s ɛ v ɛ r o i s t o k
град	ɡ r a t
имала	i m a ɫ ə
спанак	s p ɐ n a k
нещастие	n ɛ ʃ t a s t i ɛ
спорен	s p ɔ r ɛ n
бетонен	b ɛ t ɔ n ɛ n
кания	k ɐ n i j ə
торта	t ɔ r t ə
австралийски	ə f s t r ɐ lʲ iː s kʲ i
мрелият	m r ɛ lʲ i j ə t
киноцентрове	kʲ i n o t͡s ɛ n t r o v ɛ
приятен	p r i j a̟ t ɛ n
имания	i m ə n i j ə
развитие	r ɐ z v i t i ɛ
моля	m ɔ lʲ ə
сивкав	s i f k ə f
мюсюлмански	mʲ ʊ sʲ u̟ ɫ m a n s kʲ i
пръст	p r ɤ s t
прозорче	p r o z ɔ r t͡ʃ e
озаглавявам	o z ə ɡ ɫ ɐ vʲ a̟ v ə m
едновременен	ɛ d n o v r ɛ m ɛ n ɛ n
спогодба	s p o ɡ ɔ d b ə
алчба	a ɫ d͡ʒ b ə
ищца	i ʃ t͡s a
беся	b ɛ sʲ ə
шептя	ʃ e p tʲ ɤ̟
чет	t͡ʃ e t
спичам	s p i t͡ʃ ə m
бъчвар	b ə t͡ʃ v a r
бил	b i ɫ
церий	t͡s ɛ r iː
безпаричен	b ɛ s p ɐ r i t͡ʃ e n
горчив	ɡ o r t͡ʃ i f
варна	v a r n ə
беларус	b ɛ ɫ ɐ r u s
шебой	ʃ e b ɔ j
акумулатор	ə k ʊ m u ɫ a t o r
изопачен	i z o p ɐ t͡ʃ e n
твърд	t v ɤ r t
моя	m ɔ j ə
евакуационен	ɛ v ə k ʊ ə t͡s i ɔ n ɛ n
гемия	ɡʲ ɛ m i j ə
кислород	kʲ i s ɫ o r ɔ t
гръм	ɡ r ɤ m
достатък	d o s t a t ə k
сигурен	s i ɡ ʊ r ɛ n
равен	r a v ɛ n
въжен	v ɤ ʒ e n
редя	r ɛ dʲ a̟
усещам	u s ɛ ʃ t ə m
алчен	a ɫ t͡ʃ e n
възбял	v ə z bʲ a̟ ɫ
между	m ɛ ʒ d u
нивье	n i vʲ ɛ
узаконеният	ʊ z ə k o n ɛ n i j ə t
шестдесет	ʃ e z d ɛ s ɛ t
вея	v ɛ j ə
ала	a ɫ ə
нехая	n ɛ x a j ə
изминавам	i z m i n a v ə m
небесносин	n ɛ b ɛ s n o s i n
число	t͡ʃ i s ɫ ɔ
пристоен	p r i s t ɔ ɛ n
арестувах	a r ɛ s t u v a x
мамут	m ɐ m u t
вълнолюбка	v ə ɫ n o lʲ u̟ p k ə
чутура	t͡ʃ u̟ t ʊ r ə
изучаем	i z u t͡ʃ a̟ ɛ m
обятия	o bʲ a̟ t i j ə
етажерка	ɛ t ɐ ʒ e r k ə
артикулационен	ə r t i k ʊ ɫ ə t͡s i ɔ n ɛ n
селекционен	s ɛ lʲ ɛ k t͡s i ɔ n ɛ n
раздялба	r ɐ z dʲ a̟ ɫ b ə
хомосексуалистка	x ɔ m o s ɛ k s ʊ ɐ lʲ i s k ə
бахар	b ɐ x a r
те	t ɛ
стъпям	s t ɤ pʲ ə m
помпа	p ɔ m p ə
сретя	s r ɛ tʲ ə
гигаметър	ɡʲ i ɡ ɐ m ɛ t ə r
ягодов	j a̟ ɡ o d o f
хубавец	x ʊ b ɐ v ɛ t͡s
бележит	b ɛ lʲ ɛ ʒ i t
седна	s ɛ d n a
ровина	r o v i n ə
немец	n ɛ m ɛ t͡s
помислям	p o m i s lʲ ə m
ласка	ɫ a s k ə
косинус	k ɔ s i n ʊ s
безсмислен	b ɛ s s m i s lʲ ɛ n
авджия	ɐ v d ʒ i j ə
алигатор	ə lʲ i ɡ a t o r
чинка	t͡ʃ i ŋ k ə
иман	i m ə n
информация	i n f o r m a t͡s i j ə
дърво	d ə r v ɔ
величина	v ɛ lʲ i t͡ʃ i n a
къща	k ɤ ʃ t ə
поемам	p o ɛ m ə m
абанос	ə b ɐ n ɔ s
цад	t͡s a t
падало	p a d ə ɫ o
булка	b u ɫ k ə
го	ɡ o
непълен	n ɛ p ɤ lʲ ɛ n
желаещ	ʒ e ɫ a ɛ ʃ t
антре	ɐ n t r ɛ
съзвездие	s ə z v ɛ z d i ɛ
абдоминалния	ə b d o m i n a ɫ n i j ə
туй	t u j
череша	t͡ʃ e r ɛ ʃ ə
леща	lʲ ɛ ʃ t ə
научавам	n ə u t͡ʃ a̟ v ə m
ексалитър	ə t o lʲ i t ə r
ония	o n i j ə
бихте	b i x t ɛ
ютия	j u̟ t i j ə
сирене	s i r ɛ n ɛ
подпиша	p o t p i ʃ ə
бивам	b i v ə m
ревност	r ɛ v n o s t
тези	t ɛ z i
абсолютност	ə p s o lʲ u̟ t n o s t
мрене	m r ɛ n ɛ
допринасям	d o p r i n a sʲ ə m
врабей	v r a b ɛ j
цезий	t͡s ɛ z iː
бяхте	bʲ a̟ x t ɛ
почитаем	p o t͡ʃ i t a ɛ m
козле	k o z lʲ ɛ
навечерие	n ə v ɛ t͡ʃ e r i ɛ
сад	s a t
сочен	s ɔ t͡ʃ e n
арес	a r ɛ s
тимар	t i m a r
възсин	v ə s s i n
шантажирам	ʃ ə n t ɐ ʒ i r ə m
човешки	t͡ʃ o̟ v ɛ ʃ kʲ i
уви	u v i
корите	k o r i t ɛ
опаковчик	o p ɐ k ɔ f t͡ʃ i k
направя	n ɐ p r a vʲ ə
абсолютен	ɐ p s̪ o lʲ u t̪ ɛ n̪
абсорбирания	ə p s o r b i r ə n i j ə
пуст	p u s t
огорча	o ɡ o r t͡ʃ a̟
криптон	k r i p t ɔ n
швеция	ʃ v ɛ t͡s i j ə
анкара	ɐ ŋ k a r ə
танцувам	t ɐ n t͡s u v ə m
труп	t r u p
избягам	i z bʲ a̟ ɡ ə m
петдесет	p ɛ d d ɛ s ɛ t
разгърна	r ɐ z ɡ ɤ r n ə
брош	b r ɔ ʃ
взрив	v z r i f
къжлица	k ə ʒ lʲ i t͡s ə
безразсъден	b ɛ z r ɐ s s ɤ d ɛ n
обвиня	o b v i nʲ ɤ̟
поздрав	p ɔ z d r ə f
браташ	b r ɐ t a ʃ
мързел	m ɤ r z ɛ ɫ
видая	v i d a j ə
отговарям	o d ɡ o v a rʲ ə m
нобелий	n o b ɛ lʲ iː
рига	r i ɡ ə
пасох	p a s o x
тъмнина	t ə m n i n a
стъкленица	s t ə k lʲ ɛ n i t͡s ə
отред	o t r ɛ t
лале	ɫ ɐ lʲ ɛ
исландски	i s ɫ a n t s kʲ i
волан	v o ɫ a n
камшик	k ɐ m ʃ i k
езера	ɛ z ɛ r a
вършея	v ə r ʃ e j ə
алкохолен	ə ɫ k o x ɔ lʲ ɛ n
понеса	p o n ɛ s ɤ
бъбрица	b ə b r i t͡s ə
яденото	j a̟ d ɛ n o t o
свитък	s v i t ə k
страхливец	s t r ɐ x lʲ i v ɛ t͡s
котка	k ɔ t k ə
валог	v a ɫ o k
кисело	kʲ i s ɛ ɫ o
образован	o b r ɐ z ɔ v ə n
калугерица	k ɐ ɫ u ɡʲ ɛ r i t͡s ə
задача	z ɐ d a t͡ʃ ə
ядък	j a̟ d ə k
народен	n ɐ r ɔ d ɛ n
успокоявам	ʊ s p o k o j a̟ v ə m
столова	s t o ɫ ɔ v ə
вино	v i n o
благословия	b ɫ ə ɡ o s ɫ o v i j ə
щедър	ʃ t ɛ d ə r
благ	b ɫ a k
брания	b r a n i j ə
вид	v i t
люксембург	lʲ u̟ k s ɛ m b ʊ r k
именит	i m ɛ n i t
бавя	b a vʲ ə
лоуренсий	ɫ o u r ɛ n s iː
цялост	t͡sʲ a̟ ɫ o s t
допека	d o p ɛ k ɤ
много	m n ɔ ɡ o
ушивам	u ʃ i v ə m
физичен	f i z i t͡ʃ e n
проблема	p r o b lʲ ɛ m ə
празник	p r a z n i k
грузия	ɡ r u z i j ə
дреха	d r ɛ x ə
вадя	v a dʲ ə
онакова	o n ɐ k ɔ v ə
кубоподобен	k ʊ b o p o d ɔ b ɛ n
узаконяващите	ʊ z ə k o nʲ a̟ v ə ʃ t i t ɛ
шофьорка	ʃ o̟ fʲ ɔ r k ə
хващам	x v a ʃ t ə m
традиция	t r ɐ d i t͡s i j ə
почивам	p o t͡ʃ i v a m
онакъв	o n ɐ k ɤ f
лъч	ɫ ɤ t͡ʃ
отдел	o d d ɛ ɫ
устат	u s t a t
позволя	p o z v o lʲ a̟
археолог	ə r xʲ ɛ o ɫ ɔ k
после	p ɔ s lʲ ɛ
забранявам	z ə b r ɐ nʲ a̟ v ə m
от	o̝ t̪
дръвце	d r ə f t͡s ɛ
камък	k a m ə k
поща	p ɔ ʃ t ə
тревога	t r ɛ v ɔ ɡ ə
дали	d a lʲ i
иней	i n ɛ j
кръсточовка	k r ə s t o t͡ʃ ɔ f k ə
късам	k ɤ s ə m
декларация	d ɛ k ɫ ɐ r a t͡s i j ə
грапав	ɡ r a p ə f
изслушам	i s ɫ u ʃ ə m
спасяем	s p ɐ sʲ a̟ ɛ m
пърдя	p ə r dʲ a̟
свободен	s v o b ɔ d ɛ n
нито	n i t o
три	t r i
лют	lʲ u̟ t
таквъз	t ɐ k v ɤ s
осип	ɔ s i p
доверие	d o v ɛ r i ɛ
арама	ɐ r a m ə
правилник	p r a v i ɫ n i k
за	z a
узаконява	ʊ z ə k o nʲ a̟ v ə
индикативен	i n d i k ɐ t i v ɛ n
божи	b ɔ ʒ i
кроя	k r o j ɤ̟
бъдеще	b ɤ d ɛ ʃ t ɛ
кожа	k ɔ ʒ ə
накаже	n ɐ k a ʒ e
ватикана	v ə t i k a n ə
смущение	s m u ʃ t ɛ n i ɛ
оръжие	o r ɤ ʒ i ɛ
цица	t͡s i t͡s ə
узаконения	ʊ z ə k o n ɛ n i j ə
каменарка	k ə m ɛ n a r k ə
небеса	n ɛ b ɛ s a
зала	z a ɫ ə
комар	k o m a r
подкупя	p o t k u pʲ ə
липък	lʲ i p ə k
ангина	ɐ ŋ ɡʲ i n ə
апологет	ə p o ɫ o ɡʲ ɛ t
венера	v ɛ n ɛ r ə
пижек	p i ʒ e k
мръсен	m r ɤ s ɛ n
панталон	p ə n t ɐ ɫ ɔ n
енклитичен	ɛ ŋ k lʲ i t i t͡ʃ e n
анатомичен	ə n ə t o m i t͡ʃ e n
въдя	v ɤ dʲ ə
представям	p r ɛ t s t a vʲ ə m
никоя	n i k o j ə
тайван	t ɐ j v a n
медовина	m ɛ d o v i n ə
брънка	b r ɤ ŋ k ə
баба	b a b ə
осмий	ɔ s m iː
елате	ɛ ɫ a t ɛ
апсида	ɐ p s i d ə
носител	n o s i t ɛ ɫ
свързан	s v ɤ r z ə n
снощи	s n ɔ ʃ t i
добре	d o b r ɛ
скуа	s k u ə
оставя	o s t a vʲ ə
фрегата	f r ɛ ɡ a t ə
бол	b ɔ ɫ
зърнен	z ɤ r n ɛ n
изчистя	i ʃ t͡ʃ i s tʲ ə
онакава	o n ɐ k a v ə
неделя	n ɛ d ɛ lʲ ə
започна	z ɐ p ɔ t͡ʃ n ə
приближа	p r i b lʲ i ʒ a̟
тук	t u k
кланица	k ɫ a n i t͡s ə
корем	k o r ɛ m
сматрям	s m a t rʲ ə m
турци	t u r t͡s i
премяна	p r ɛ mʲ a̟ n ə
обущарница	o b u ʃ t a r n i t͡s ə
въздух	v ɤ z d ʊ x
пукот	p u k o t
подялба	p o dʲ a̟ ɫ b ə
мартеница	m a r t ɛ n i t͡s ə
легален	lʲ ɛ ɡ a lʲ ɛ n
рис	r i s
различие	r ɐ z lʲ i t͡ʃ i ɛ
брадва	b r a d v ə
узаконилите	ʊ z ə k o n i lʲ i t ɛ
бида	b i d ə
билата	b i ɫ a t ə
мърляв	m ɤ r lʲ ə f
следвам	s lʲ ɛ d v ə m
еврейка	ɛ v r ɛ j k ə
солен	s o lʲ ɛ n
озаглавя	o z ə ɡ ɫ ɐ vʲ ɤ̟
автогара	a f t o ɡ a r ə
агония	ɐ ɡ ɔ n i j ə
поема	p o ɛ m ə
бисмут	b i s m u t
свойство	s v ɔ j s t v o
офис	ɔ f i s
имахте	i m a x t ɛ
един	ɛ d i n
президент	p r ɛ z i d ɛ n t
ориентационен	o r i ɛ n t ə t͡s i ɔ n ɛ n
трудно	t r u d n o
разум	r a z ʊ m
аблан	ɐ b ɫ a n
простак	p r o s t a k
сънища	s ɤ n i ʃ t ə
версия	v ɛ r s i j ə
македонски	m ə kʲ ɛ d ɔ n s kʲ i
българка	b ɤ ɫ ɡ ə r k ə
пошъл	p ɔ ʃ ə ɫ
ганимед	ɡ ə n i m ɛ t
термин	t ɛ r m i n
коледа	k ɔ lʲ ɛ d ə
хвала	x v ɐ ɫ a
хидроелектричен	xʲ i d r o ɛ lʲ ɛ k t r i t͡ʃ e n
молитва	m o lʲ i t v ə
термит	t ɛ r m i t
мезе	m ɛ z ɛ
бръмбар	b r ɤ m b ə r
погреба	p o ɡ r ɛ b ə
наште	n a ʃ t ɛ
капак	k ɐ p a k
бандит	b ɐ n d i t
иск	i s k
допрочета	d o p r o t͡ʃ e t ɤ
усорлица	u s ɔ r lʲ i t͡s ə
рафт	r a f t
буляк	b u lʲ ə k
сечко	s ɛ t͡ʃ k o
довеждам	d o v ɛ ʒ d ə m
власт	v ɫ a s t
телевизия	t ɛ lʲ ɛ v i z i j ə
мерзавец	m ɛ r z a v ɛ t͡s
зърна	z ɤ r n ə
аглика	ɐ ɡ lʲ i k ə
край	k r a j
дървен	d ɤ r v ɛ n
узаконяванета	ʊ z ə k o nʲ a̟ v ə n ɛ t ə
бая	b ɐ j a̟
турна	t u r n a
бразилски	b r ɐ z i ɫ s kʲ i
лелек	lʲ ɛ lʲ ɛ k
прочут	p r o t͡ʃ u̟ t
паткан	p ɐ t k a n
двусмислица	d v u s m i s lʲ i t͡s ə
среда	s r ɛ d a
минута	m i n u t ə
създавам	s ə z d a v ə m
опера	ɔ p ɛ r ə
странноприемница	s t r ə n n o p r i ɛ m n i t͡s ə
пасат	p ɐ s ɤ t
телур	t ɛ ɫ u r
бихме	b i x m ɛ
старина	s t ə r i n a
щипалка	ʃ t i p a ɫ k ə
места	m ɛ s t a
разсипия	r ə s s i p i j ə
предвестие	p r ɛ d v ɛ s t i ɛ
долина	d o lʲ i n a
вървите	v ə r v i t ɛ
какъвто	k ɐ k ɤ f t o
месечина	m ɛ s ɛ t͡ʃ i n ə
петрол	p ɛ t r ɔ ɫ
щрих	ʃ t r i x
хала	x a ɫ ə
гневлив	ɡ n ɛ v lʲ i f
глутница	ɡ ɫ u t n i t͡s ə
духов	d u x o f
реша	r ɛ ʃ ɤ̟
прилеп	p r i lʲ ɛ p
държава	d ə r ʒ a̟ v ə
сприхав	s p r i x ə f
абортивен	ə b o r t i v ɛ n
християнин	x r i s t i j a̟ n i n
звучен	z v u t͡ʃ e n
леко	lʲ ɛ k o
познавам	p o z n a v ə m
любопитен	lʲ ʊ b o p i t ɛ n
жълтък	ʒ ə ɫ t ɤ k
роля	r ɔ lʲ ə
започвам	z ɐ p ɔ t͡ʃ v ə m
абатския	ɐ b a t s kʲ i j ə
карам	k a r ə m
превъзхождам	p r ɛ v ə s x ɔ ʒ d ə m
продавам	p r o d a v ə m
звънарка	z v ə n a r k ə
станой	s t ɐ n ɔ j
магаре	m ɐ ɡ a r ɛ
дори	d o r i
кукам	k u k ə m
страница	s t r a n i t͡s ə
щелите	ʃ t ɛ lʲ i t ɛ
висш	v i ʃ ʃ
желаещо	ʒ e ɫ a ɛ ʃ t o
частен	t͡ʃ a̟ s t ɛ n
юлски	j u̟ ɫ s kʲ i
сирийка	s i r iː k ə
калинка	k ɐ lʲ i ŋ k ə
тайна	t a j n ə
бангладеш	b a ŋ ɡ ɫ ə d ɛ ʃ
любопитство	lʲ ʊ b o p i t s t v o
падна	p a d n ə
просба	p r ɔ z b ə
носия	n o s i j ə
мишка	m i ʃ k ə
тука	t u k ə
международен	m ɛ ʒ d ʊ n ɐ r ɔ d ɛ n
лекарствен	lʲ ɛ k a r s t v ɛ n
мъгла	m ə ɡ ɫ a
превозен	p r ɛ v o z ɛ n
дряновец	d rʲ a̟ n o v ɛ t͡s
прах	p r a x
похват	p o x v a t
говорех	ɡ o v ɔ r ɛ x
атолитър	ə t o lʲ i t ə r
пищен	p i ʃ t ɛ n
сладост	s ɫ a d o s t
надонеса	n ə d o n ɛ s ɤ
зелен	z ɛ lʲ ɛ n
депонентен	d ɛ p o n ɛ n t ɛ n
по	p ɔ
работа	r a b o t ə
обстоятелство	o p s t o j a̟ t ɛ ɫ s t v o
театър	t ɛ a t ə r
витег	v i t ɛ k
билет	b i lʲ ɛ t
хлявав	x lʲ ɐ v a f
изпълнителен	i s p ə ɫ n i t ɛ lʲ ɛ n
изтребя	i s t r ɛ bʲ ə
повтор	p o f t ɔ r
пасохте	p a s o x t ɛ
координационен	k o o r d i n ə t͡s i ɔ n ɛ n
трофей	t r o f ɛ j
червив	t͡ʃ e r v i f
куя	k u j ə
учителски	u t͡ʃ i t ɛ ɫ s kʲ i
ако	a k o
имащи	i m ə ʃ t i
резка	r ɛ s k a
кайгана	k ə j ɡ ɐ n a
миризма	m i r i z m a
обесвам	o b ɛ s v ə m
работилница	r ə b o t i ɫ n i t͡s ə
привнеса	p r i v n ɛ s ɤ
къделя	k ə d ɛ lʲ ə
предполагам	p r ɛ t p o ɫ a ɡ ə m
гълъб	ɡ ɤ ɫ ə p
роднина	r o d n i n ə
светулка	s v ɛ t u ɫ k ə
ограничителен	o ɡ r ə n i t͡ʃ i t ɛ lʲ ɛ n
проклитичен	p r o k lʲ i t i t͡ʃ e n
иванов	i v a n o f
ирландски	i r ɫ a n t s kʲ i
основател	o s n o v a t ɛ ɫ
великан	v ɛ lʲ i k a n
горица	ɡ o r i t͡s ə
глупачка	ɡ ɫ u p a t͡ʃ k ə
малайзийо	m ɐ ɫ a j z i j o̟
оберон	ɔ b ɛ r o n
зри	z r i
краче	k r ɐ t͡ʃ e
щя	ʃ tʲ a̟
вероятно	v ɛ r o j a̟ t n o
бърне	b ə r n ɛ
автостоп	a f t o s t ɔ p
царица	t͡s ɐ r i t͡s ə
говорихте	ɡ o v o r i x t ɛ
сияхте	s i j a̟ x t ɛ
дойда	d ɔ j d ə
або	a b o
коприварче	k o p r i v a r t͡ʃ e
деца	d ɛ t͡s a
септември	s ɛ p t ɛ ɱ v r i
петънце	p ɛ t ə n t͡s ɛ
цинк	t͡s i ŋ k
мостик	m ɔ s t i k
авиационен	a v i ə t͡s i ɔ n ɛ n
аромат	ə r o m a t
височина	v i s o t͡ʃ i n a
щирица	ʃ t i r i t͡s ə
цент	t͡s ɛ n t
директор	d i r ɛ k t o r
кукла	k u k ɫ ə
гърне	ɡ ə r n ɛ
актиний	ɐ k t i n iː
припадна	p r i p a d n ə
доведа	d o v ɛ d ɤ
тънък	t ɤ n ə k
гулия	ɡ u lʲ i j ə
ароматен	ə r o m a t ɛ n
определен	o p r ɛ d ɛ lʲ ɛ n
тежък	t ɛ ʒ ə k
убивам	u b i v ə m
вкаменен	f k ə m ɛ n ɛ n
лъжица	ɫ ə ʒ i t͡s ə
фикус	f i k ʊ s
вяра	vʲ a̟ r ə
ядяхте	j æ dʲ a̟ x t ɛ
вземам	v z ɛ m ə m
богат	b o ɡ a t
бургас	b u r ɡ a s
очен	ɔ t͡ʃ e n
долар	d ɔ ɫ ə r
назад	n ɐ z a t
монах	m o n a x
пощаджия	p ɔ ʃ t ə d ʒ i j ə
казерна	k ɐ z ɛ r n ə
подлог	p ɔ d ɫ o k
ялите	j a̟ lʲ i t ɛ
сея	s ɛ j ə
мрем	m r ɛ m
гадина	ɡ ɐ d i n ə
загивам	z ɐ ɡʲ i v ə m
рай	r a j
онези	o n ɛ z i
бухал	b u x ə ɫ
кост	k ɔ s t
ноември	n o ɛ ɱ v r i
гнилоч	ɡ n i ɫ ɔ t͡ʃ
мрейки	m r ɛ j kʲ i
на	n a
ангелина	ə ŋ ɡʲ ɛ lʲ i n ə
завирушка	z ə v i r u ʃ k ə
фокус	f ɔ k ʊ s
германий	ɡʲ ɛ r m a n iː
логан	ɫ ɔ ɡ ə n
коридор	k o r i d ɔ r
гидия	ɡʲ i d i j ə
оногова	o n o ɡ ɔ v ə
отведа	o t v ɛ d ɤ
наблюдавам	n ə b lʲ u̟ d a v ə m
често	t͡ʃ e s t o
инакво	i n a k v o
работя	r ɐ b ɔ tʲ ə
подвързия	p o d v ə r z i j ə
говедо	ɡ o v ɛ d o
авантюристически	ə v ə n tʲ ʊ r i s t i t͡ʃ e s kʲ i
хълм	x ɤ ɫ m
пуйка	p u j k ə
чифлик	t͡ʃ i f lʲ i k
безплатен	b ɛ s p ɫ a t ɛ n
дружба	d r u ʒ b ə
членувана	t͡ʃ lʲ ɛ n u v ə n ə
сърпоклюн	s ə r p o k lʲ u̟ n
фиорд	f i ɔ r t
любовник	lʲ u̟ b ɔ v n i k
плевен	p lʲ ɛ v ɛ n
бледен	b lʲ ɛ d ɛ n
рак	r a k
дърволазка	d ə r v o ɫ a s k ə
реч	r ɛ t͡ʃ
щяла	ʃ tʲ a̟ ɫ ə
дългуч	d ə ɫ ɡ u t͡ʃ
двигател	d v i ɡ ə t ɛ ɫ
вашто	v a ʃ t o
грузински	ɡ r u z i n s kʲ i
мренета	m r ɛ n ɛ t ə
татко	t a t k o
парещ	p a r ɛ ʃ t
арка	a r k ə
корея	k o r ɛ j ə
вуйчо	v u j t͡ʃ o̟
успех	u s p ɛ x
всякога	f sʲ a̟ k o ɡ ə
скроб	s k r ɔ p
гургулица	ɡ ʊ r ɡ u lʲ i t͡s ə
топлик	t o p lʲ i k
африкански	ə f r i k a n s kʲ i
член	t͡ʃ lʲ ɛ n
почвам	p ɔ t͡ʃ v ə m
сиях	s i j a̟ x
репортер	r ɛ p o r t ɛ r
шугав	ʃ u̟ ɡ ə f
стефан	s t ɛ f ə n
почувствам	p o t͡ʃ u̟ s t v ə m
творя	t v o rʲ a̟
принуждавам	p r i n u ʒ d a v ə m
радио	r a d i o
крехък	k r ɛ x ə k
извиквам	i z v i k v ə m
глобя	ɡ ɫ o bʲ ɤ̟
култура	k u ɫ t u r ə
изнесе	i z n ɛ s ɛ
бавноходка	b ə v n o x ɔ t k ə
изгреба	i z ɡ r ɛ b ə
автодрезина	a f t o d r ɛ z i n ə
постоянен	p o s t o j a̟ n ɛ n
откажа	o t k a ʒ ə
литий	lʲ i t iː
заслужено	z ɐ s ɫ u ʒ e n o
завлека	z ə v lʲ ɛ k ɤ
изгубя	i z ɡ u bʲ ə
вашия	v a ʃ i j ə
разлат	r ɐ z ɫ a t
мътен	m ɤ t ɛ n
сервитьор	s ɛ r v i tʲ ɔ r
снасям	s n a sʲ ə m
играя	i ɡ r a j ə
господи	ɡ ɔ s p o d i
абсолютно	ɐ p s̪ o lʲ u t̪ n̪ o
ясмин	j ɐ s m i n
ветрило	v ɛ t r i ɫ o
загуба	z a ɡ ʊ b ə
имал	i m a ɫ
борий	b ɔ r iː
слон	s ɫ ɔ n
стипца	s t i p t͡s ə
модел	m o d ɛ ɫ
гавед	ɡ a v ɛ t
светлик	s v ɛ t lʲ i k
маниак	m ə n i a k
роса	r o s a
борба	b o r b a
етика	ɛ t i k ə
ландшафт	ɫ a n t ʃ ə f t
къртичи	k ə r t i t͡ʃ i
оцветявам	o t͡s v ɛ tʲ a̟ v ə m
хлапе	x ɫ ɐ p ɛ
мирта	m i r t ə
въоръжа	v ə o r ə ʒ ɤ̟
продавач	p r o d ɐ v a t͡ʃ
сладко	s ɫ a t k o
гав	ɡ a f
каквото	k ɐ k v ɔ t o
чуждица	t͡ʃ u̟ ʒ d i t͡s ə
понапека	p o n ə p ɛ k ɤ
авлига	ɐ v lʲ i ɡ ə
чао	t͡ʃ a̟ o
единия	ɛ d i n i j ə
палав	p a ɫ ə f
дърча	d ɤ r t͡ʃ ə
самун	s ɐ m u n
труден	t r u d ɛ n
тежест	t ɛ ʒ e s t
паслия	p a s lʲ i j ə
лакей	ɫ ɐ kʲ ɛ j
безсмъртен	b ɛ s s m ɤ r t ɛ n
цървул	t͡s ə r v u ɫ
адаптационен	ə d ə p t ə t͡s i ɔ n ɛ n
отсянка	o t sʲ a̟ ŋ k ə
изведнъж	i z v ɛ d n ɤ ʃ
оса	o s a
женски	ʒ e n s kʲ i
изправя	i s p r a vʲ ə
мреше	m r ɛ ʃ e
седемнадесет	s ɛ d ɛ m n a d ɛ s ɛ t
чай	t͡ʃ a̟ j
австралия	ɐ f s t r a lʲ i j ə
чукундур	t͡ʃ ʊ k u n d u r
двоичен	d v o i t͡ʃ e n
стърчиопашка	s t ə r t͡ʃ i o p a ʃ k ə
слагам	s ɫ a ɡ ə m
багер	b a ɡʲ ɛ r
имаща	i m ə ʃ t ə
откъслек	o t k ɤ s lʲ ɛ k
швейцарски	ʃ v ɛ j t͡s a r s kʲ i
възрастта	v ə z r ɐ s t a
стреж	s t r ɛ ʃ
буренак	b ʊ r ɛ n a k
дилянка	d i lʲ a̟ ŋ k ə
посетител	p o s ɛ t i t ɛ ɫ
тлъст	t ɫ ɤ s t
гира	ɡʲ i r ə
старец	s t a r ɛ t͡s
моден	m ɔ d ɛ n
ваш	v a ʃ
пшеница	p ʃ e n i t͡s ə
блудкав	b ɫ u t k ə f
имана	i m ə n ə
строг	s t r ɔ k
подбел	p ɔ d b ɛ ɫ
къщо	k ɤ ʃ t o
леля	lʲ ɛ lʲ ə
творец	t v o r ɛ t͡s
пя	pʲ a̟
информационен	i n f o r m ə t͡s i ɔ n ɛ n
лош	ɫ ɔ ʃ
въртошийка	v ə r t o ʃ iː k ə
биче	b i t͡ʃ e
стилистичен	s t i lʲ i s t i t͡ʃ e n
жрея	ʒ r ɛ j ə
юли	j u̟ lʲ i
повярвам	p o vʲ a̟ r v ə m
почивш	p o t͡ʃ i f ʃ
доведе	d o v ɛ d ɛ
породист	p o r o d i s t
тежа	t ɛ ʒ ɤ̟
петле	p ɛ t lʲ ɛ
коря	k o rʲ ɤ̟
числителен	t͡ʃ i s lʲ i t ɛ lʲ ɛ n
прекарам	p r ɛ k a r ə m
увал	u v a ɫ
плосък	p ɫ ɔ s ə k
знатен	z n a t ɛ n
прекаля	p r ɛ k ɐ lʲ ɤ̟
стръмнина	s t r ə m n i n a
хирургически	xʲ i r u r ɡʲ i t͡ʃ e s kʲ i
трескав	t r ɛ s k ə f
надолу	n ɐ d ɔ ɫ ʊ
изпявам	i s pʲ a̟ v ə m
хасий	x a s iː
стъпало	s t ə p a ɫ o
автобус	ə f t o b u s
зло	z ɫ ɔ
сърце	s ə r t͡s ɛ
история	i s t ɔ r i j ə
тербий	t ɛ r b iː
превъзнеса	p r ɛ v ə z n ɛ s ɤ
мраченик	m r a t͡ʃ e n i k
скарабей	s k ə r ɐ b ɛ j
канап	k ɐ n a p
вожд	v ɔ ʃ t
заявя	z ə j æ vʲ a̟
лава	ɫ a v ə
диня	d i nʲ ə
светиня	s v ɛ t i nʲ ə
грохот	ɡ r ɔ x o t
челяд	t͡ʃ e lʲ ə t
протоме	p r o t ɔ m ɛ
кафенета	k ə f ɛ n ɛ t ə
въглен	v ɤ ɡ lʲ ɛ n
стръмно	s t r ɤ m n o
черешарка	t͡ʃ e r ɛ ʃ a̟ r k ə
синхронизационен	s i n x r o n i z ə t͡s i ɔ n ɛ n
начален	n ɐ t͡ʃ a̟ lʲ ɛ n
узаконяваше	ʊ z ə k o nʲ a̟ v ə ʃ e
гаяче	ɡ ɐ j a̟ t͡ʃ e
участие	u t͡ʃ a̟ s t i ɛ
тилтия	t i ɫ t i j ə
едно	ɛ d n ɔ
здание	z d a n i ɛ
джамия	d ʒ ɐ m i j ə
миши	m i ʃ i
ама	a m ə
войска	v o j s k a
въвра	v ə v r ɤ
храм	x r a m
оправдавам	o p r ɐ v d a v ə m
обещавам	o b ɛ ʃ t a v ə m
ядящата	j æ dʲ a̟ ʃ t ə t ə
поляна	p o lʲ a̟ n ə
единица	ɛ d i n i t͡s ə
джийн	d ʒ iː n
прадеди	p r a d ɛ d i
количество	k o lʲ i t͡ʃ e s t v o
любов	lʲ u̟ b ɔ f
изплашвам	i s p ɫ a ʃ v ə m
сив	s i f
озадача	o z ə d ɐ t͡ʃ ɤ̟
инфантилен	i n f ɐ n t i lʲ ɛ n
толкоз	t ɔ ɫ k o s
арестувахме	a r ɛ s t u v a x m ɛ
спра	s p r ɤ
редица	r ɛ d i t͡s ə
кубирам	k u b i r ə m
бруя	b r u j ə
моето	m ɔ ɛ t o
напръстник	n a p r ə s n i k
завивка	z ɐ v i f k ə
отрови	o t r o v i
пожар	p o ʒ a̟ r
довлея	d o v lʲ ɛ j ə
институт	i n s t i t u t
ямбичен	j ɐ m b i t͡ʃ e n
галата	ɡ a ɫ ə t ə
славянски	s ɫ ɐ vʲ a̟ n s kʲ i
узаконявай	ʊ z ə k o nʲ a̟ v ə j
лъх	ɫ ɤ x
животи	ʒ i v ɔ t i
предупредя	p r ɛ d ʊ p r ɛ dʲ ɤ̟
ваште	v a ʃ t ɛ
глупост	ɡ ɫ u p o s t
сноп	s n ɔ p
авиотакси	a v i o t ɐ k s i
видим	v i d i m
заплитам	z ɐ p lʲ i t ə m
разболявам	r ə z b o lʲ a̟ v ə m
лабилен	ɫ ɐ b i lʲ ɛ n
любима	lʲ u̟ b i m ə
афера	ɐ f ɛ r ə
съчка	s ɤ t͡ʃ k ə
експедиция	ɛ k s p ɛ d i t͡s i j ə
патърдия	p ə t ə r d i j ə
гоблин	ɡ ɔ b lʲ i n
изковавам	i s k o v a v ə m
щир	ʃ t i r
свят	s vʲ a̟ t
вар	v a r
техничен	t ɛ x n i t͡ʃ e n
гълъбица	ɡ ə ɫ ə b i t͡s ə
юрган	j u̟ r ɡ a n
чедо	t͡ʃ e d o
тъкан	t ə k a n
телесен	t ɛ lʲ ɛ s ɛ n
дъщеря	d ə ʃ t ɛ rʲ a̟
смъртник	s m ɤ r t n i k
робот	r ɔ b o t
слузест	s ɫ u z ɛ s t
резлив	r ɛ z lʲ i f
глобявам	ɡ ɫ o bʲ a̟ v ə m
десет	d ɛ s ɛ t
барок	b ɐ r ɔ k
зърнест	z ɤ r n ɛ s t
радвам	r a d v ə m
герасим	ɡʲ ɛ r a s i m
изправям	i s p r a vʲ ə m
слуга	s ɫ u ɡ a
слой	s ɫ ɔ j
закупи	z ɐ k u p i
кораб	k ɔ r ə p
катерица	k a t ɛ r i t͡s ə
тиква	t i k v ə
пропаст	p r ɔ p ə s t
причастие	p r i t͡ʃ a̟ s t i ɛ
пролет	p r ɔ lʲ ɛ t
ужасно	u ʒ a̟ s n o
отпущам	o t p u ʃ t ə m
явен	j a̟ v ɛ n
адет	ɐ d ɛ t
имащия	i m ə ʃ t i j ə
вътре	v ɤ t r ɛ
щом	ʃ t ɔ m
плъх	p ɫ ɤ x
узаконяването	ʊ z ə k o nʲ a̟ v ə n ɛ t o
син	s i n
рив	r i f
езда	ɛ z d ɤ
аджемилък	ə d ʒ e m i ɫ ɤ k
фобос	f ɔ b o s
нанасям	n ɐ n a sʲ ə m
католичка	k ə t o lʲ i t͡ʃ k ə
невярващ	n ɛ vʲ a̟ r v ə ʃ t
убеждавам	ʊ b ɛ ʒ d a v ə m
доктор	d ɔ k t o r
плащам	p ɫ a ʃ t ə m
скришом	s k r i ʃ o̟ m
знаме	z n a m ɛ
млечнобял	m lʲ ɛ t͡ʃ n o bʲ a̟ ɫ
наш	n a ʃ
явя	j æ vʲ a̟
едноличен	ɛ d n o lʲ i t͡ʃ e n
стратегически	s t r ə t ɛ ɡʲ i t͡ʃ e s kʲ i
стикс	s t i k s
сляза	s lʲ a̟ z ə
надуваем	n ə d u v a ɛ m
лихва	lʲ i x v ə
авторитетен	a f t o r i t ɛ t ɛ n
стил	s t i ɫ
изключение	i s k lʲ u̟ t͡ʃ e n i ɛ
билото	b i ɫ o t o
щяло	ʃ tʲ a̟ ɫ o
абревиатура	a b r ɛ v i ɐ t u r ə
агрегатен	ə ɡ r ɛ ɡ a t ɛ n
филолог	f i ɫ o ɫ ɔ k
получавам	p o ɫ u t͡ʃ a̟ v ə m
мобилизационен	m o b i lʲ i z ə t͡s i ɔ n ɛ n
узаконяваха	ʊ z ə k o nʲ a̟ v ə x ə
шум	ʃ u̟ m
януари	j ə n u a r i
реклама	r ɛ k ɫ a m ə
вестник	v ɛ s n i k
буля	b u lʲ ə
пеганка	p ɛ ɡ a ŋ k ə
пухест	p u xʲ ɛ s t
белезници	b ɛ lʲ ɛ z n i t͡s i
право	p r a v o
гърлица	ɡ ɤ r lʲ i t͡s ə
бъдейки	b ɤ d ɛ j kʲ i
касационен	k ə s ə t͡s i ɔ n ɛ n
черногорски	t͡ʃ e r n o ɡ ɔ r s kʲ i
безпрецедентен	b ɛ s p r ɛ t͡s ɛ d ɛ n t ɛ n
орле	o r lʲ ɛ
ида	i d ə
узаконена	ʊ z ə k o n ɛ n ə
късно	k ɤ s n o
ой	ɔ j
кур	k u r
подлец	p o d lʲ ɛ t͡s
дотичам	d o t i t͡ʃ ə m
падишах	p ə d i ʃ a̟ x
смядов	s mʲ a̟ d o f
век	v ɛ k
пловдив	p ɫ ɔ v d i f
кино	kʲ i n o
румен	r u m ɛ n
атентат	ə t ɛ n t a t
валя	v ɐ lʲ ɤ̟
избода	i z b o d ɤ
пряк	p rʲ a̟ k
влез	v lʲ ɛ s
коронясвам	k o r o nʲ a̟ s v ə m
хокам	x ɔ k ə m
кимна	kʲ i m n ə
узаконявахте	ʊ z ə k o nʲ a̟ v ə x t ɛ
половина	p o ɫ o v i n ə
пътник	p ɤ t n i k
дьо	dʲ ɔ
европеец	ɛ v r o p ɛ ɛ t͡s
харамия	x ə r ɐ m i j ə
чужденец	t͡ʃ ʊ ʒ d ɛ n ɛ t͡s
аксиома	a k s i ɔ m ə
пасене	p ɐ s ɛ n ɛ
издател	i z d a t ɛ ɫ
нога	n o ɡ a
възкръсна	v ə s k r ɤ s n ə
иманите	i m ə n i t ɛ
пигментен	p i ɡ m ɛ n t ɛ n
синкав	s i ŋ k ə f
града	ɡ r a d ə
говно	ɡ o v n ɔ
преперец	p r ɛ p ɛ r ɛ t͡s
узаконявалия	ʊ z ə k o nʲ a̟ v ə lʲ i j ə
граждански	ɡ r a ʒ d ə n s kʲ i
абсциса	ɐ p s t͡s i s ə
загреб	z a ɡ r ɛ p
как	k a k
рехабилитационен	r ɛ x ə b i lʲ i t ə t͡s i ɔ n ɛ n
кюфте	kʲ o̟ f t ɛ
изпитвам	i s p i t v ə m
икона	i k ɔ n ə
нужда	n u ʒ d a
имайте	i m ə j t ɛ
раня	r ɐ nʲ ɤ̟
лакът	ɫ a k ə t
пръч	p r ɤ t͡ʃ
стрела	s t r ɛ ɫ a
участък	u t͡ʃ a̟ s t ə k
победител	p o b ɛ d i t ɛ ɫ
друг	d r u k
храня	x r a nʲ ə
всуе	f s u ɛ
какаду	k ə k ɐ d u
байно	b a j n o
творба	t v o r b a
окръжен	o k r ɤ ʒ e n
авторитарен	ə f t o r i t a r ɛ n
следобед	s lʲ ɛ d ɔ b ɛ t
алкохол	ə ɫ k o x ɔ ɫ
килолитър	kʲ i ɫ o lʲ i t ə r
гледка	ɡ lʲ ɛ t k ə
ананас	ə n ɐ n a s
висшист	v i ʃ ʃ i s t
дебелея	d ɛ b ɛ lʲ ɛ j ə
който	k ɔ j t o
о	ɔ
кале	k ɐ lʲ ɛ
хавлия	x ɐ v lʲ i j ə
пирон	p i r ɔ n
китайка	kʲ i t a j k ə
щете	ʃ t ɛ t ɛ
възпитание	v ə s p i t a n i ɛ
стратегичен	s t r ə t ɛ ɡʲ i t͡ʃ e n
забременея	z ə b r ɛ m ɛ n ɛ j ə
водоизпускател	v ɔ d o i s p u s k a t ɛ ɫ
тревист	t r ɛ v i s t
азе	a z ɛ
хирургичен	xʲ i r u r ɡʲ i t͡ʃ e n
рунтав	r u n t ə f
пушене	p u ʃ e n ɛ
вън	v ɤ n
мързелан	m ə r z ɛ ɫ a n
очи	o t͡ʃ i
мляко	m lʲ a̟ k o
пъргав	p ɤ r ɡ ə f
лък	ɫ ɤ k
страх	s t r a x
април	ɐ p r i ɫ
стерилен	s t ɛ r i lʲ ɛ n
скакавица	s k ɐ k a v i t͡s ə
гайда	ɡ a j d ə
бутилирам	b ʊ t i lʲ i r ə m
българийо	b ə ɫ ɡ a r i j o̟
личинкоядка	lʲ i t͡ʃ i ŋ k o j a̟ t k ə
имащото	i m ə ʃ t o t o
бодил	b o d i ɫ
смятам	s mʲ a̟ t ə m
ерудиция	ɛ r u d i t͡s i j ə
сабя	s a bʲ ə
майтнерий	m ɐ j t n ɛ r iː
пафкам	p a f k ə m
приема	p r i ɛ m ə
сън	s ɤ n
имахме	i m a x m ɛ
силно	s i ɫ n o
двоеточие	d v o ɛ t ɔ t͡ʃ i ɛ
трева	t r ɛ v a
орехче	ɔ r ɛ x t͡ʃ e
тръне	t r ɤ n ɛ
благоевград	b ɫ ɐ ɡ ɔ ɛ v ɡ r ə t
живак	ʒ i v a k
шапито	ʃ ə p i t ɔ
изляза	i z lʲ a̟ z ə
корейски	k o r ɛ j s kʲ i
тон	t ɔ n
стяг	s tʲ a̟ k
стрепет	s t r ɛ p ɛ t
копаница	k ɔ p ə n i t͡s ə
окажа	o k a ʒ ə
начало	n ɐ t͡ʃ a̟ ɫ o
варя	v a rʲ ə
извлека	i z v lʲ ɛ k ɤ
парченце	p ɐ r t͡ʃ e n t͡s ɛ
съседен	s ə s ɛ d ɛ n
неутрален	n ɛ u t r a lʲ ɛ n
августовски	a v ɡ ʊ s t o f s kʲ i
университет	ʊ n i v ɛ r s i t ɛ t
мерзък	m ɛ r z ə k
мързелив	m ə r z ɛ lʲ i f
обучение	o b u t͡ʃ e n i ɛ
хвърля	x v ɤ r lʲ ə
скверен	s k v ɛ r ɛ n
съветвам	s ə v ɛ t v ə m
главоного	ɡ ɫ ə v o n ɔ ɡ o
течен	t ɛ t͡ʃ e n
багър	b a ɡ ə r
лук	ɫ u k
бозайник	b o z a j n i k
аквариум	ɐ k v a r i ʊ m
сладък	s ɫ a d ə k
листо	lʲ i s t ɔ
нож	n ɔ ʃ
пистолет	p i s t o lʲ ɛ t
абдикиралия	ə b d i kʲ i r ə lʲ i j ə
боязън	b o j a̟ z ə n
пия	p i j ə
единадесет	ɛ d i n a d ɛ s ɛ t
предвиждам	p r ɛ d v i ʒ d ə m
милостиня	m i ɫ o s t i nʲ ə
почти	p o t͡ʃ t i
холмий	x ɔ ɫ m iː
карти	k a r t i
кражба	k r a ʒ b ə
козодой	k o z o d ɔ j
прегръщам	p r ɛ ɡ r ɤ ʃ t ə m
рибар	r i b a r
ерида	ɛ r i d ə
дневен	d n ɛ v ɛ n
слушам	s ɫ u ʃ ə m
седемдесет	s ɛ d ɛ m d ɛ s ɛ t
олово	o ɫ ɔ v o
охлюв	ɔ x lʲ ʊ f
железария	ʒ e lʲ ɛ z ɐ r i j ə
стилист	s t i lʲ i s t
списание	s p i s a n i ɛ
скорошен	s k ɔ r o ʃ e n
защо	z ɐ ʃ t ɔ
клъвка	k ɫ ɤ f k ə
глаголе	ɡ ɫ ɐ ɡ ɔ lʲ ɛ
съчетавам	s ə t͡ʃ e t a v ə m
хлебарка	x lʲ ɛ b a r k ə
господарство	ɡ o s p o d a r s t v o
пренасяне	p r ɛ n a sʲ ə n ɛ
чуващият	t͡ʃ u̟ v ə ʃ t i j ə t
срака	s r a k ə
съвсем	s ə f s ɛ m
поклатя	p o k ɫ a tʲ ə
синьо	s i nʲ o̟
любеница	lʲ ʊ b ɛ n i t͡s ə
напека	n ə p ɛ k ɤ
азот	ɐ z ɔ t
хуй	x u j
извън	i z v ɤ n
чуя	t͡ʃ u̟ j ə
енцелад	ɛ n t͡s ɛ ɫ a t
месо	m ɛ s ɔ
хелий	xʲ ɛ lʲ iː
магнезий	m ɐ ɡ n ɛ z iː
земноводно	z ɛ m n o v ɔ d n o
съд	s ɤ t
зрян	z rʲ a̟ n
шествие	ʃ e s t v i ɛ
цикламен	t͡s i k ɫ a m ɛ n
клуб	k ɫ u p
авантюристичен	ə v ə n tʲ ʊ r i s t i t͡ʃ e n
ограничен	o ɡ r ə n i t͡ʃ e n
каня	k a nʲ ə
възглавница	v ə z ɡ ɫ a v n i t͡s ə
значимост	z n ɐ t͡ʃ i m o s t
ям	j a̟ m
ледина	lʲ ɛ d i n ə
аджаба	a d ʒ ə b ə
пубер	p u b ɛ r
вести	v ɛ s t i
живот	ʒ i v ɔ t
кавал	k ɐ v a ɫ
осмивам	o s m i v ə m
кампус	k a m p ʊ s
някакви	nʲ ə k ɐ k v i
сияехте	s i j a̟ ɛ x t ɛ
коларница	k o ɫ a r n i t͡s ə
болница	b o ɫ n i t͡s ə
злъч	z ɫ ɤ t͡ʃ
дюля	dʲ ʉ lʲ ə
величавост	v ɛ lʲ i t͡ʃ a̟ v o s t
пасящия	p ɐ sʲ a̟ ʃ t i j ə
харон	x ɐ r ɔ n
мисъл	m i s ə ɫ
искря	i s k rʲ ɤ̟
раница	r a n i t͡s ə
хидра	xʲ i d r ə
чавка	t͡ʃ a̟ f k ə
черта	t͡ʃ e r t a
сияеше	s i j a̟ ɛ ʃ e
кадифе	k ə d i f ɛ
ръка	r ə k a
узаконяващият	ʊ z ə k o nʲ a̟ v ə ʃ t i j ə t
чудо	t͡ʃ u̟ d o
юфки	j u̟ f kʲ i
нагриза	n ɐ ɡ r i z ə
наредя	n ə r ɛ dʲ a̟
кулминационен	k ʊ ɫ m i n ə t͡s i ɔ n ɛ n
глина	ɡ lʲ i n ə
ладия	ɫ ɐ d i j ə
изтребвам	i s t r ɛ b v ə m
говориш	ɡ o v ɔ r i ʃ
ядящо	j æ dʲ a̟ ʃ t o
белград	b ɛ ɫ ɡ r ə t
разчитам	r ɐ ʃ t͡ʃ i t ə m
купи	k u p i
уикипедия	ʊ̯ i kʲ i p ɛ d i j ə
колело	k o lʲ ɛ ɫ ɔ
зареждам	z ɐ r ɛ ʒ d ə m
престъпник	p r ɛ s t ɤ p n i k
занимая	z ə n i m a j ə
крагуй	k r ɐ ɡ u j
одринлия	ɔ d r i n lʲ i j ə
невъзможно	n ɛ v ə z m ɔ ʒ n o
помолвам	p o m ɔ ɫ v ə m
касация	k ɐ s a t͡s i j ə
приемам	p r i ɛ m ə m
робия	r o b i j ə
крастел	k r a s t ɛ ɫ
веда	v ɛ d ə
серен	s ɛ r ɛ n
суровина	s ʊ r o v i n a
господарски	ɡ o s p o d a r s kʲ i
лижете	lʲ i ʒ e t ɛ
глупец	ɡ ɫ u p ɛ t͡s
щяха	ʃ tʲ a̟ x ə
артист	ɐ r t i s t
резултат	r ɛ z u ɫ t a t
шибой	ʃ i b ɔ j
казан	k ɐ z a n
миров	m i r o f
диалект	d i ɐ lʲ ɛ k t
музей	m u z ɛ j
втечня	f t ɛ t͡ʃ nʲ ɤ̟
губи	ɡ u b i
чул	t͡ʃ u̟ ɫ
аби	ɐ b i
мрат	m r ɤ t
морелетник	m o r ɛ lʲ ɛ t n i k
извикам	i z v i k ə m
антарктида	ə n t ɐ r k t i d ə
трети	t r ɛ t i
изведа	i z v ɛ d ɤ
било	b i ɫ o
откриваем	o t k r i v a ɛ m
бабанка	b ɐ b a ŋ k ə
метна	m ɛ t n ə
бяг	bʲ a̟ k
узаконял	ʊ z ə k o nʲ a̟ ɫ
мишца	m i ʃ t͡s ə
отнасям	o t n a sʲ ə m
припра	p r i p r ɤ
иманета	i m ə n ɛ t ə
индийски	i n d iː s kʲ i
ваше	v a ʃ e
гърбав	ɡ ə r b a f
щял	ʃ tʲ a̟ ɫ
пола	p o ɫ a
технически	t ɛ x n i t͡ʃ e s kʲ i
зряхте	z rʲ a̟ x t ɛ
смрад	s m r a t
четирите	t͡ʃ e t i r i t ɛ
падина	p ə d i n a
основа	o s n ɔ v ə
енциклопедия	ɛ n t͡s i k ɫ o p ɛ d i j ə
договор	d ɔ ɡ o v o r
тогова	t o ɡ ɔ v ə
вътрешност	v ɤ t r ɛ ʃ n o s t
абатски	ɐ b a t s kʲ i
революция	r ɛ v o lʲ u̟ t͡s i j ə
балюстрада	b ə lʲ u̟ s t r a d ə
джудже	d ʒ u̟ d ʒ e
руснаци	r u s n a t͡s i
пасени	p a s ɛ n i
бруней	b r u n ɛ j
ейприл	ɛ j p r i ɫ
милионер	m i lʲ i o n ɛ r
убийство	u b iː s t v o
бром	b r ɔ m
материя	m ɐ t ɛ r i j ə
улулица	ʊ ɫ u lʲ i t͡s ə
основно	o s n ɔ v n o
прям	p rʲ a̟ m
тъмница	t ə m n i t͡s ə
зъб	z ɤ p
оногози	o n o ɡ ɔ z i
гъркиня	ɡ ə r kʲ i nʲ ə
сви	s v i
подслушам	p o t s ɫ u ʃ ə m
лактационен	ɫ ə k t ə t͡s i ɔ n ɛ n
художник	x u d ɔ ʒ n i k
ездачка	ɛ z d a t͡ʃ k ə
жътва	ʒ ɤ̟ t v ə
воденица	v o d ɛ n i t͡s ə
зрител	z r i t ɛ ɫ
спомня	s p ɔ m nʲ ə
вярно	vʲ a̟ r n o
липса	lʲ i p s ə
срам	s r a m
павлака	p a v ɫ ə k ə
звяр	z vʲ a̟ r
мече	m ɛ t͡ʃ e
пчелояд	p t͡ʃ e ɫ o j a̟ t
свра	s v r ɤ
кубичен	k u b i t͡ʃ e n
наша	n a ʃ ə
оженя	o ʒ e nʲ ə
обяснявам	o bʲ æ s nʲ a̟ v ə m
тепе	t ɛ p ɛ
месец	m ɛ s ɛ t͡s
дрипав	d r i p ə f
ухапя	u x a pʲ ə
тъмен	t ɤ m ɛ n
лантан	ɫ ɐ n t a n
епос	ɛ p o s
кофа	k ɔ f ə
светлосянката	s v ɛ t ɫ o sʲ a̟ ŋ k ə t ə
пристъп	p r i s t ə p
отказвам	o t k a z v ə m
езиков	ɛ z i k o f
огромен	o ɡ r ɔ m ɛ n
пасящото	p ɐ sʲ a̟ ʃ t o t o
въвеждам	v ə v ɛ ʒ d ə m
езически	ɛ z i t͡ʃ e s kʲ i
ръждав	r ə ʒ d a f
зарист	z ɐ r i s t
хоризонтален	x o r i z o n t a lʲ ɛ n
кочи	k ɔ t͡ʃ i
мекотело	m ɛ k o t ɛ ɫ o
средище	s r ɛ d i ʃ t ɛ
врагове	v r a ɡ o v ɛ
лавка	ɫ a f k ə
лимони	lʲ i m ɔ n i
неопределен	n ɛ o p r ɛ d ɛ lʲ ɛ n
токачка	t o k a t͡ʃ k ə
туткав	t u t k ə f
присое	p r i s ɔ ɛ
учебник	u t͡ʃ e b n i k
запра	z ɐ p r ɤ
анархия	ɐ n a r xʲ i j ə
яз	j a̟ s
става	s t a v ə
вой	v ɔ j
мрели	m r ɛ lʲ i
наредба	n ɐ r ɛ d b ə
ядящото	j æ dʲ a̟ ʃ t o t o
пека	p ɛ k ɤ
господин	ɡ o s p o d i n
освен	o s v ɛ n
писмо	p i s m ɔ
август	a v ɡ ʊ s t
щръклица	ʃ t r ə k lʲ i t͡s ə
крякот	k rʲ a̟ k o t
абитуриент	ə b i t ʊ r i ɛ n t
мушитрънка	m ʊ ʃ i t r ɤ ŋ k ə
аерофлот	ə ɛ r o f ɫ ɔ t
икономически	i k o n o m i t͡ʃ e s kʲ i
елит	ɛ lʲ i t
самоличност	s ə m o lʲ i t͡ʃ n o s t
набожен	n ɐ b ɔ ʒ e n
съжалявам	s ə ʒ ɐ lʲ a̟ v ə m
полуостров	p o ɫ u ɔ s t r o f
разговор	r a z ɡ o v o r
орех	ɔ r ɛ x
годинак	ɡ o d i n a k
лъжи	ɫ ə ʒ i
корпорация	k o r p o r a t͡s i j ə
градски	ɡ r a t s kʲ i
япет	j ɐ p ɛ t
обходим	o p x o d i m
огорчен	o ɡ o r t͡ʃ e n
риж	r i ʃ
събитие	s ə b i t i ɛ
твоята	t v ɔ j ə t ə
принцеса	p r i n t͡s ɛ s ə
буца	b u t͡s ə
бръзгам	b r ɤ z ɡ ə m
разшифровам	r ə ʃ ʃ i f r ɔ v ə m
хвърлям	x v ɤ r lʲ ə m
мухоловка	m ʊ x o ɫ ɔ f k ə
говореха	ɡ o v ɔ r ɛ x ə
издутина	i z d ʊ t i n a
върша	v ə r ʃ a̟
шок	ʃ ɔ k
седалка	s ɛ d a ɫ k ə
продам	p r o d a m
шибам	ʃ i b ə m
мюезин	mʲ ʊ ɛ z i n
агне	a ɡ n ɛ
принеса	p r i n ɛ s ɤ
йод	j ɔ t
ядено	j a̟ d ɛ n o
отвес	o t v ɛ s
орден	ɔ r d ɛ n
чинно	t͡ʃ i n n o
убедя	ʊ b ɛ dʲ ɤ̟
означавам	o z n ɐ t͡ʃ a̟ v ə m
круша	k r u ʃ ə
пасинок	p a s i n o k
недалечен	n ɛ d ɐ lʲ ɛ t͡ʃ e n
сипкав	s i p k ə f
нелеп	n ɛ lʲ ɛ p
южняшки	j ʉ ʒ nʲ a̟ ʃ kʲ i
сричка	s r i t͡ʃ k ə
проповедник	p r o p o v ɛ d n i k
диван	d i v a n
стилистка	s t i lʲ i s k ə
азербайджански	ə z ɛ r b ɐ j d͡ʒ a̟ n s kʲ i
работодател	r ə b o t o d a t ɛ ɫ
ловец	ɫ o v ɛ t͡s
намака	n ɐ m a k ə
невъзможен	o o o o o
плавей	p ɫ a v ɛ j
гламав	ɡ ɫ a m ə f
негово	n ɛ ɡ o v o
кое	k o ɛ
щърбав	ʃ t ɤ r b ə f
горист	ɡ o r i s t
патица	p a t i t͡s ə
младоженец	m ɫ ə d o ʒ e n ɛ t͡s
вирус	v i r ʊ s
деветнадесет	d ɛ v ɛ t n a d ɛ s ɛ t
непорочност	n ɛ p o r ɔ t͡ʃ n o s t
специален	s p ɛ t͡s i a lʲ ɛ n
мъж	m ɤ ʃ
дявол	dʲ a̟ v o ɫ
литовски	lʲ i t ɔ f s kʲ i
повторим	p o f t o r i m
узаконях	ʊ z ə k o nʲ a̟ x
сияй	s i j æ j
чопка	t͡ʃ ɔ p k ə
основателно	o s n o v a t ɛ ɫ n o
напредна	n ɐ p r ɛ d n ə
бастилия	b ɐ s t i lʲ i j ə
мярка	mʲ a̟ r k ə
чист	t͡ʃ i s t
мечта	m ɛ t͡ʃ t a
ѝ	i
китайски	kʲ i t a j s kʲ i
жегавица	ʒ e ɡ a v i t͡s ə
то	t ɔ
липа	lʲ i p a
книжен	k n i ʒ e n
боже	b ɔ ʒ e
прекарвам	p r ɛ k a r v ə m
полицай	p o lʲ i t͡s a j
вашият	v a ʃ i j ə t
мацка	m a t͡s k ə
ноже	n o ʒ e
овци	o f t͡s i
отличим	o t lʲ i t͡ʃ i m
четка	t͡ʃ e t k ə
богиня	b o ɡʲ i nʲ ə
тъмносин	t ɤ m n o s i n
нивя	n i vʲ a̟
будилник	b u d i ɫ n i k
абсурдност	ɐ p s u r d n o s t
минск	m i n s k
повторно	p o f t ɔ r n o
мряща	m rʲ a̟ ʃ t ə
диспросий	d i s p r ɔ s iː
ударя	u d a rʲ ə
щука	ʃ t u k ə
тералитър	t ɛ r ɐ lʲ i t ə r
юрод	j u̟ r o t
спор	s p ɔ r
изпълвам	i s p ɤ ɫ v ə m
зъл	z ɤ ɫ
кола	k o ɫ a
глуж	ɡ ɫ u ʃ
туркменистан	t ʊ r k m ɛ n i s t a n
плешив	p lʲ ɛ ʃ i f
ледовит	lʲ ɛ d o v i t
авариен	a v ɐ r i ɛ n
странен	s t r a n ɛ n
пасели	p ɐ s ɛ lʲ i
имаше	i m ə ʃ e
позитрон	p o z i t r ɔ n
върволяк	v ə r v o lʲ a̟ k
падам	p a d ə m
запреда	z ə p r ɛ d ɤ
ядох	j a̟ d o x
плюто	p lʲ u̟ t o
клиент	k lʲ i ɛ n t
апология	ə p o ɫ ɔ ɡʲ i j ə
хладно	x ɫ a d n o
цвете	t͡s v ɛ t ɛ
заповед	z a p o v ɛ t
биха	b i x ə
смрадливец	s m r ɐ d lʲ i v ɛ t͡s
водолюбив	v o d o lʲ u̟ b i f
лачен	ɫ a t͡ʃ e n
никое	n i k o ɛ
восхищение	v o s xʲ i ʃ t ɛ n i ɛ
прахоляк	p r ə x o lʲ a̟ k
зъболекар	z ə b o lʲ ɛ k ə r
мама	m a m ə
владичица	v ɫ ɐ d i t͡ʃ i t͡s ə
пакет	p ɐ kʲ ɛ t
германски	ɡʲ ɛ r m a n s kʲ i
ракия	r a kʲ i j a
димитър	d i m i t ə r
забоде	z ɐ b ɔ d ɛ
шоколад	ʃ o̟ k o ɫ a t
данъчен	d a n ə t͡ʃ e n
ват	v a t
ядената	j a̟ d ɛ n ə t ə
чичопей	t͡ʃ i t͡ʃ o̟ p ɛ j
пиша	p i ʃ ə
чук	t͡ʃ u̟ k
дърводелец	d ə r v o d ɛ lʲ ɛ t͡s
тъща	t ɤ ʃ t ə
управител	u p r a v i t ɛ ɫ
чутя	t͡ʃ u̟ tʲ ə
глезен	ɡ lʲ ɛ z ɛ n
запъртък	z a p ə r t ə k
акушерка	ə k u ʃ e r k ə
турция	t u r t͡s i j ə
вертикален	v ɛ r t i k a lʲ ɛ n
свръхякане	s v r ə xʲ a̟ k ə n ɛ
пари	p a r i
знам	z n a m
честит	t͡ʃ e s t i t
пащърнак	p ə ʃ t ə r n a k
бей	b ɛ j
възмущение	v ə z m u ʃ t ɛ n i ɛ
запека	z ə p ɛ k ɤ
модален	m o d a lʲ ɛ n
ималите	i m a lʲ i t ɛ
другаде	d r u ɡ ə d ɛ
томува	t o m u v ə
император	i m p ɛ r a t o r
пасем	p ɐ s ɛ m
пък	p ɤ k
неголям	n ɛ ɡ o lʲ ə m
арамия	ə r ɐ m i j ə
спя	s pʲ ɤ̟
стигна	s t i ɡ n ə
вертолет	v ɛ r t o lʲ ɛ t
прилика	p r i lʲ i k ə
владика	v ɫ ɐ d i k ə
газ	ɡ a s
интернационален	i n t ɛ r n ə t͡s i o n a lʲ ɛ n
престол	p r ɛ s t ɔ ɫ
невеж	n ɛ v ɛ ʃ
панпсихизъм	p ə n p s i xʲ i z ə m
момиче	m o m i t͡ʃ e
хроничен	x r o n i t͡ʃ e n
бразилия	b r ɐ z i lʲ i j ə
сковранец	s k o v r a n ɛ t͡s
безформен	b ɛ s f ɔ r m ɛ n
войски	v o j s kʲ i
победя	p o b ɛ dʲ ɤ̟
рода	r o d a
зъболекарски	z ə b o lʲ ɛ k ə r s kʲ i
сляп	s lʲ a̟ p
ягне	j a̟ ɡ n ɛ
пиколитър	p i k o lʲ i t ə r
чък	t͡ʃ ɤ̟ k
благой	b ɫ ɐ ɡ ɔ j
упреквам	u p r ɛ k v ə m
издутък	i z d u t ə k
алка	a ɫ k ə
мас	m a s
тоалет	t o ɐ lʲ ɛ t
безопасност	b ɛ z o p a s n o s t
пихтия	p i x t i j ə
халост	x a ɫ o s t
покруса	p o k r u s ə
гъз	ɡ ɤ s
огнище	o ɡ n i ʃ t ɛ
хербарий	xʲ ɛ r b a r iː
климатик	k lʲ i m ɐ t i k
потурнак	p o t u r n a k
небесен	n ɛ b ɛ s ɛ n
черногорка	t͡ʃ e r n o ɡ ɔ r k ə
крава	k r a v ə
боец	b o ɛ t͡s
служа	s ɫ u ʒ ə
към	k ɤ m
науча	n ɐ u t͡ʃ ə
стисна	s t i s n ə
оставка	o s t a f k ə
платя	p ɫ ɐ tʲ ɤ̟
токсичност	t o k s i t͡ʃ n o s t
пенис	p ɛ n i s
операция	o p ɛ r a t͡s i j ə
узаконило	ʊ z ə k o n i ɫ o
лесовик	lʲ ɛ s o v i k
сера	s ɛ r ɤ
прага	p r a ɡ ə
трактор	t r a k t o r
разгръщам	r ɐ z ɡ r ɤ ʃ t ə m
разлюбвам	r ɐ z lʲ u̟ b v ə m
кошница	k ɔ ʃ n i t͡s ə
дебна	d ɛ b n a
петалитър	p ɛ t ɐ lʲ i t ə r
строя	s t r o j ɤ̟
парфюм	p ɐ r fʲ u̟ m
отговорност	o d ɡ o v ɔ r n o s t
треса	t r ɛ s ɤ
юпитер	j u̟ p i t ɛ r
гагарка	ɡ ɐ ɡ a r k ə
шатка	ʃ a̟ t k ə
грозев	ɡ r ɔ z ɛ f
зестра	z ɛ s t r ə
сянка	sʲ a̟ ŋ k ə
юнакиня	j ʊ n ɐ kʲ i nʲ ə
ястребов	j a̟ s t r ɛ b o f
сой	s ɔ j
тях	tʲ a̟ x
гибел	ɡʲ i b ɛ ɫ
нашествие	n ɐ ʃ e s t v i ɛ
местност	m ɛ s n o s t
софиянка	s o f i j a̟ ŋ k ə
патладжан	p ə t ɫ ɐ d ʒ a̟ n
зашивам	z ɐ ʃ i v ə m
градовете	ɡ r ə d o v ɛ t ɛ
анкетен	ɐ ŋ kʲ ɛ t ɛ n
ниобий	n i ɔ b iː
членестоного	t͡ʃ lʲ ɛ n ɛ s t o n ɔ ɡ o
мрялото	m rʲ a̟ ɫ o t o
план	p ɫ a n
килим	kʲ i lʲ i m
дий	d iː
говорих	ɡ o v o r i x
хардуер	x a r d ʊ ɛ r
парите	p ɐ r i t ɛ
бекасина	b ɛ k ɐ s i n ə
ужасено	ʊ ʒ ɐ s ɛ n o
плесен	p lʲ ɛ s ɛ n
жалък	ʒ a̟ ɫ ə k
брада	b r ɐ d a
заема	z ɐ ɛ m ə
шейна	ʃ e j n a
лоуис	ɫ ɔ ʊ i s
болниците	b o ɫ n i t͡s i t ɛ
далече	d ɐ lʲ ɛ t͡ʃ e
смяна	s mʲ a̟ n ə
високо	v i s ɔ k o
гангстер	ɡ a ŋ k s t ɛ r
полза	p ɔ ɫ z ə
автомотриса	a f t o m o t r i s ə
зра	z r ɤ
изток	i s t o k
русе	r u s ɛ
никта	n i k t ə
онакива	o n ɐ kʲ i v ə
гара	ɡ a r ə
домашно	d o m a ʃ n o
абсолютизъм	ə p s o lʲ u̟ t i z ə m
битпазар	b i t p ɐ z a r
върло	v ə r ɫ ɔ
ядените	j a̟ d ɛ n i t ɛ
абсолвентски	a p s o ɫ v ɛ n t s kʲ i
топъл	t ɔ p ə ɫ
плавен	p ɫ a v ɛ n
аметистов	ə m ɛ t i s t o f
жертва	ʒ e r t v ə
желаещият	ʒ e ɫ a ɛ ʃ t i j ə t
ужасия	ʊ ʒ ɐ s i j ə
дроб	d r ɔ p
стоя	s t o j ɤ̟
гриза	ɡ r i z a
докторка	d ɔ k t o r k ə
узаконявала	ʊ z ə k o nʲ a̟ v ə ɫ ə
човек	t͡ʃ o̟ v ɛ k
адютант	ə dʲ u̟ t a n t
тухла	t u x ɫ ə
беси	b ɛ s i
рудник	r u d n i k
мистър	m i s t ə r
подозирам	p o d o z i r ə m
клоун	k ɫ ɔ ʊ n
хамбар	x ɐ m b a r
превзема	p r ɛ v z ɛ m ə
узаконим	ʊ z ə k o n i m
изкуство	i s k u s t v o
мултикултурализъм	m u ɫ t i k ʊ ɫ t ʊ r ɐ lʲ i z ə m
кучи	k u t͡ʃ i
гигант	ɡʲ i ɡ a n t
абонат	a b o n a t
мраз	m r a s
какви	k ɐ k v i
аерометър	a ɛ r o m ɛ t ə r
неща	n ɛ ʃ t a
ръст	r ɤ s t
ушия	u ʃ i j ə
замра	z ɐ m r ɤ
парк	p a r k
сияехме	s i j a̟ ɛ x m ɛ
мускулен	m u s k ʊ lʲ ɛ n
амин	ɐ m i n
ням	nʲ a̟ m
абдоминалната	ə b d o m i n a ɫ n ə t ə
наложа	n ɐ ɫ ɔ ʒ ə
ему	ɛ m u
дебляци	d ɛ b lʲ ə t͡s i
средновековие	s r ɛ d n o v ɛ k ɔ v i ɛ
гъделичкам	ɡ ə d ɛ lʲ i t͡ʃ k ə m
заведа	z ə v ɛ d ɤ
виждам	v i ʒ d ə m
рухо	r u x o
заспя	z ɐ s pʲ ɤ̟
такива	t ɐ kʲ i v ə
кърнак	k ə r n a k
примирам	p r i m i r ə m
видеоускорител	v i d ɛ o ʊ s k o r i t ɛ ɫ
вляза	v lʲ a̟ z ə
нетопир	n ɛ t o p i r
братче	b r a t t͡ʃ e
чия	t͡ʃ i j a̟
провлак	p r ɔ v ɫ ə k
елементарен	ɛ lʲ ɛ m ɛ n t a r ɛ n
антитяло	a n t i tʲ a̟ ɫ o
контакт	k o n t a k t
одежда	o d ɛ ʒ d ə
целувка	t͡s ɛ ɫ u f k ə
буди	b u d i
попичам	p o p i t͡ʃ ə m
длан	d ɫ a n
нов	n ɔ f
спален	s p a lʲ ɛ n
технеций	t ɛ x n ɛ t͡s iː
ясминов	j ɐ s m i n o f
лиляк	lʲ i lʲ ə k
щелият	ʃ t ɛ lʲ i j ə t
дома	d o m a
усмихвам	u s m i x v ə m
щастие	ʃ t a s t i ɛ
принудя	p r i n u dʲ ə
чернодробен	t͡ʃ e r n o d r ɔ b ɛ n
почивка	p o t͡ʃ i f k ə
апс	a p s
легла	lʲ ɛ ɡ ɫ a
яка	j ɐ k a
определено	o p r ɛ d ɛ lʲ ɛ n o
река	r ɛ k a
зреше	z r ɛ ʃ e
къщи	k ɤ ʃ t i
тояга	t o j a̟ ɡ ə
дизя	d i zʲ ə
узаконели	ʊ z ə k o n ɛ lʲ i
немощ	n ɛ m o ʃ t
проститутка	p r o s t i t u t k ə
плитък	p lʲ i t ə k
събирам	s ə b i r ə m
огранича	o ɡ r ə n i t͡ʃ ɤ̟
властен	v ɫ a s t ɛ n
естонски	ɛ s t ɔ n s kʲ i
изтънчен	i s t ɤ n t͡ʃ e n
вест	v ɛ s t
боя	b o j a̟
властник	v ɫ a s n i k
пречупя	p r ɛ t͡ʃ u̟ pʲ ə
софийски	s o f iː s kʲ i
предприятие	p r ɛ t p r i j a̟ t i ɛ
сврачи	s v r a t͡ʃ i
абразивен	ə b r ɐ z i v ɛ n
бъдете	b ə d ɛ t ɛ
предишен	p r ɛ d i ʃ e n
деймос	d ɛ j m o s
автентичен	a f t ɛ n t i t͡ʃ e n
московий	m o s k ɔ v iː
кат	k a t
брега	b r ɛ ɡ a
абстрактен	ɐ p s t r a k t ɛ n
пернат	p ɛ r n a t
инстинктивен	i n s t i ŋ k t i v ɛ n
ветрилник	v ɛ t r i ɫ n i k
ден	d ɛ n
балнеолечение	b a ɫ n ɛ o lʲ ɛ t͡ʃ e n i ɛ
местоимение	m ɛ s t o i m ɛ n i ɛ
обществен	o p ʃ t ɛ s t v ɛ n
мях	mʲ a̟ x
лидер	lʲ i d ɛ r
драка	d r a k ə
рубидий	r u b i d iː
възголям	v ə z ɡ o lʲ a̟ m
здравеняк	z d r ə v ɛ nʲ a̟ k
лис	lʲ i s
влагалище	v ɫ ɐ ɡ a lʲ i ʃ t ɛ
бидейки	b i d ɛ j kʲ i
закова	z ə k o v a
хладък	x ɫ a d ə k
негов	n ɛ ɡ o f
чиито	t͡ʃ i i t o
малки	m a ɫ kʲ i
положение	p o ɫ o ʒ e n i ɛ
сърбин	s ɤ r b i n
пръчица	p r ɤ t͡ʃ i t͡s ə
любознателен	lʲ ʊ b o z n a t ɛ lʲ ɛ n
обичай	o b i t͡ʃ a̟ j
туристка	t u r i s k ə
дъх	d ɤ x
бръглеш	b r ɤ ɡ lʲ ɛ ʃ
дискусия	d i s k u s i j ə
плаша	p ɫ a ʃ ə
внимателно	v n i m a t ɛ ɫ n o
стеля	s t ɛ lʲ ə
запридам	z ɐ p r i d ə m
плащ	p ɫ a ʃ t
имали	i m a lʲ i
бекон	b ɛ k ɔ n
варен	v a r ɛ n
джунгла	d ʒ u̟ ŋ ɡ ɫ ə
каменарче	k ə m ɛ n a r t͡ʃ e
преживям	p r ɛ ʒ i vʲ ə m
барий	b a r iː
мюре	mʲ u̟ r ɛ
гордо	ɡ ɔ r d o
тромав	t r ɔ m ə f
стъпка	s t ɤ p k ə
сестрински	s ɛ s t r i n s kʲ i
лед	lʲ ɛ t
сказуемо	s k ɐ z u ɛ m o
хиляда	xʲ i lʲ a̟ d ə
сребрист	s r ɛ b r i s t
яйчен	j æ j t͡ʃ e n
острие	o s t r i ɛ
съгласен	s ə ɡ ɫ a s ɛ n
остана	o s t a n ə
алармен	ɐ ɫ a r m ɛ n
лъскав	ɫ ɤ s k ə f
пивък	p i v ə k
континент	k o n t i n ɛ n t
бръндза	b r ɤ n d z ə
бързолет	b ə r z o lʲ ɛ t
алчност	a ɫ t͡ʃ n o s t
кълвач	k ə ɫ v a t͡ʃ
север	s ɛ v ɛ r
ален	a lʲ ɛ n
париж	p ɐ r i ʃ
дъхна	d ɤ x n ə
мишница	m i ʃ n i t͡s ə
молба	m o ɫ b a
автобаза	a f t o b a z ə
арестувахте	a r ɛ s t u v a x t ɛ
узаконяванетата	ʊ z ə k o nʲ a̟ v ə n ɛ t ə t ə
андора	ɐ n d ɔ r ə
медник	m ɛ d n i k
дон	d ɔ n
тогавашен	t o ɡ a v ə ʃ e n
идентификационен	i d ɛ n t i f i k ə t͡s i ɔ n ɛ n
зашия	z ɐ ʃ i j ə
хамбургер	x a m b ʊ r ɡʲ ɛ r
тихо	t i x o
стреме	s t r ɛ m ɛ
скърчав	s k ɤ r t͡ʃ ə f
блато	b ɫ a t o
зрете	z r ɛ t ɛ
враговете	v r a ɡ o v ɛ t ɛ
глас	ɡ ɫ a s
мъка	m ɤ k ə
езерце	ɛ z ɛ r t͡s ɛ
наводнявам	n ə v o d nʲ a̟ v ə m
теле	t ɛ lʲ ɛ
берилий	b ɛ r i lʲ iː
лястовичи	lʲ a̟ s t o v i t͡ʃ i
сега	s ɛ ɡ a
отнеса	o t n ɛ s ɤ
фазан	f ɐ z a n
костница	k ɔ s n i t͡s ə
архитектура	ə r xʲ i t ɛ k t u r ə
говорихме	ɡ o v o r i x m ɛ
поопичам	p o o p i t͡ʃ ə m
френски	f r ɛ n s kʲ i
жарък	ʒ a̟ r ə k
лев	lʲ ɛ f
глобус	ɡ ɫ ɔ b ʊ s
бях	bʲ a̟ x
техни	t ɛ x n i
саксия	s ɐ k s i j ə
джин	d ʒ i n
мода	m ɔ d ə
извличам	i z v lʲ i t͡ʃ ə m
безчестя	b ɛ ʃ t͡ʃ e s tʲ a̟
смъртница	s m ɤ r t n i t͡s ə
сатрап	s ɐ t r a p
обоснова	o b o s n o v a
ужасявам	ʊ ʒ ɐ sʲ a̟ v ə m
забрани	z ɐ b r a n i
трепетлика	t r ɛ p ɛ t lʲ i k ə
авлия	ɐ v lʲ i j ə
парче	p ɐ r t͡ʃ e
колбас	k o ɫ b a s
тлъстина	t ɫ ə s t i n a
юфка	j u̟ f k ə
отново	o t n ɔ v o
електронен	ɛ lʲ ɛ k t r ɔ n ɛ n
сингапур	s i ŋ ɡ ɐ p u r
авиобомба	a v i o b ɔ m b ə
западняк	z ə p ɐ d nʲ a̟ k
словения	s ɫ o v ɛ n i j ə
холандски	x o ɫ a n t s kʲ i
ратификационен	r ə t i f i k ə t͡s i ɔ n ɛ n
як	j a̟ k
братя	b r a tʲ ə
общ	ɔ p ʃ t
цял	t͡sʲ a̟ ɫ
облак	ɔ b ɫ ə k
адамов	ɐ d a m o f
кралица	k r ɐ lʲ i t͡s ə
изобщо	i z ɔ p ʃ t o
храсте	x r a s t ɛ
нека	n ɛ k ə
определителен	o p r ɛ d ɛ lʲ i t ɛ lʲ ɛ n
въпреки	v ɤ p r ɛ kʲ i
избия	i z b i j ə
физически	f i z i t͡ʃ e s kʲ i
тигър	t i ɡ ə r
внезапен	v n ɛ z a p ɛ n
февруари	f ɛ v r u a r i
променя	p r o m ɛ nʲ a̟
пижо	p i ʒ o̟
зрящ	z rʲ a̟ ʃ t
забождам	z ɐ b ɔ ʒ d ə m
против	p r o t i f
нектаринка	n ɛ k t ɐ r i ŋ k ə
бъбрек	b ɤ b r ɛ k
тяло	tʲ a̟ ɫ o
уолдо	u ɔ ɫ d o
препека	p r ɛ p ɛ k ɤ
завоевател	z ə v o ɛ v a t ɛ ɫ
въшка	v ɤ ʃ k ə
брегобегач	b r ɛ ɡ o b ɛ ɡ a t͡ʃ
луча	ɫ u t͡ʃ ə
панкреас	p a ŋ k r ɛ ə s
епископите	ɛ p i s k o p i t ɛ
нейния	n ɛ j n i j ə
здравей	z d r ɐ v ɛ j
основателност	o s n o v a t ɛ ɫ n o s t
ванадий	v ɐ n a d iː
тения	t ɛ n i j ə
гибелен	ɡʲ i b ɛ lʲ ɛ n
жъна	ʒ ɤ̟ n ə
хлабав	x ɫ ɐ b a f
саламандър	s ə ɫ ɐ m a n d ə r
селище	s ɛ lʲ i ʃ t ɛ
твойто	t v ɔ j t o
иглика	i ɡ lʲ i k ə
пита	p i t a
клей	k lʲ ɛ j
тъпочовка	t ə p o t͡ʃ ɔ f k ə
водоскок	v o d o s k ɔ k
шунка	ʃ u̟ ŋ k ə
премиерен	p r ɛ m i ɛ r ɛ n
върна	v ɤ r n ə
древен	d r ɛ v ɛ n
нет	n ɛ t
начин	n a t͡ʃ i n
поддръжка	p o d d r ɤ ʃ k ə
управителен	u p r a v i t ɛ lʲ ɛ n
предмет	p r ɛ d m ɛ t
март	m a r t
аргатин	ɐ r ɡ a t i n
ром	r ɔ m
състояние	s ə s t o j a̟ n i ɛ
изслушвам	i s ɫ u ʃ v ə m
бонус	b ɔ n ʊ s
екран	ɛ k r a n
съглася	s ə ɡ ɫ ɐ sʲ a̟
чуждестранен	t͡ʃ ʊ ʒ d ɛ s t r a n ɛ n
настояще	n ə s t o j a̟ ʃ t ɛ
неговите	n ɛ ɡ o v i t ɛ
хава	x a v ə
говорете	ɡ o v o r ɛ t ɛ
сръбски	s r ɤ p s kʲ i
чуващ	t͡ʃ u̟ v ə ʃ t
окрада	o k r ɐ d ɤ
тарос	t a r o s
узаконяващия	ʊ z ə k o nʲ a̟ v ə ʃ t i j ə
греша	ɡ r ɛ ʃ ɤ̟
упова	ʊ p o v a
пепелник	p ɛ p ɛ ɫ n i k
тръгна	t r ə ɡ n a
доза	d ɔ z ə
картал	k ɐ r t a ɫ
полковник	p o ɫ k ɔ v n i k
масло	m a s ɫ o
сура	s u r ə
надежден	n ɐ d ɛ ʒ d ɛ n
сърцат	s ə r t͡s a t
родител	r o d i t ɛ ɫ
повтором	p o f t ɔ r o m
адмирал	ə d m i r a ɫ
немощност	n ɛ m o ʃ n o s t
интернет	i n t ɛ r n ɛ t
неон	n ɛ ɔ n
управителка	u p r a v i t ɛ ɫ k ə
рог	r ɔ k
оръдие	o r ɤ d i ɛ
забелязвам	z ə b ɛ lʲ a̟ z v ə m
куфар	k u f ə r
гяурин	ɡʲ ɐ u r i n
негър	n ɛ ɡ ə r
забитък	z ɐ b i i t ə k
образование	o b r ə z o v a n i ɛ
струга	s t r u ɡ ə
членувано	t͡ʃ lʲ ɛ n u v ə n o
гадолиний	ɡ ə d o lʲ i n iː
мироточив	m i r o t o t͡ʃ i f
поглеждам	p o ɡ lʲ ɛ ʒ d ə m
католически	k ə t o lʲ i t͡ʃ e s kʲ i
оди	ɔ d i
навестявам	n ə v ɛ s tʲ a̟ v ə m
регистрационен	r ɛ ɡʲ i s t r ə t͡s i ɔ n ɛ n
същ	s ɤ ʃ t
уплаши	u p ɫ a ʃ i
зрак	z r a k
вашта	v a ʃ t ə
нескромен	n ɛ s k r ɔ m ɛ n
буболечка	b ʊ b o lʲ ɛ t͡ʃ k ə
надебелявам	n ə d ɛ b ɛ lʲ a̟ v ə m
подривен	p o d r i v ɛ n
производство	p r o i z v ɔ t s t v o
татба	t a d b ə
тресавище	t r ɛ s a v i ʃ t ɛ
тишина	t i ʃ i n a
годеница	ɡ o d ɛ n i t͡s ə
кукувица	k u k ʊ v i t͡s ə
да	d a
мастит	m ɐ s t i t
извлече	i z v lʲ ɛ t͡ʃ e
лесно	lʲ ɛ s n o
аршин	ɐ r ʃ i n
къжел	k ɤ ʒ e ɫ
глагол	ɡ ɫ ɐ ɡ ɔ ɫ
мечок	m ɛ t͡ʃ ɔ k
върху	v ə r x u
тъпак	t ə p a k
интересувам	i n t ɛ r ɛ s u v ə m
кутсуз	k u t s u s
джип	d ʒ i p
двусмислие	d v u s m i s lʲ i ɛ
ухо	u x ɔ
тия	t i j ə
дупка	d u p k ə
миг	m i k
негодяй	n ɛ ɡ o dʲ æ j
имах	i m a x
лейди	lʲ ɛ j d i
препоръчам	p r ɛ p o r ɤ t͡ʃ ə m
язовец	j a̟ z o v ɛ t͡s
бог	b ɔ k
проблем	p r o b lʲ ɛ m
наши	n a ʃ i
доверчив	d o v ɛ r t͡ʃ i f
четвъртък	t͡ʃ e t v ɤ r t ə k
прав	p r a f
съюз	s ə j u̟ s
би	b i
пръг	p r ɤ k
британия	b r i t a n i j ə
харем	x ɐ r ɛ m
оставям	o s t a vʲ ə m
добавя	d o b a vʲ ə
школа	ʃ k ɔ ɫ ə
бюро	bʲ u̟ r ɔ
допълнение	d o p ə ɫ n ɛ n i ɛ
абатско	ɐ b a t s k o
биографичен	b i o ɡ r ɐ f i t͡ʃ e n
пек	p ɛ k
юда	j u̟ d ə
различим	r ə z lʲ i t͡ʃ i m
продан	p r ɔ d ə n
шести	ʃ e s t i
поднеса	p o d n ɛ s ɤ
раждане	r a ʒ d ə n ɛ
боде	b o d ɛ
меч	m ɛ t͡ʃ
узаконявалият	ʊ z ə k o nʲ a̟ v ə lʲ i j ə t
царкиня	t͡s ɐ r kʲ i nʲ ə
легна	lʲ ɛ ɡ n a
узаконят	ʊ z ə k o nʲ ɤ̟ t
руски	r u s kʲ i
азербайджан	ə z ɛ r b ɐ j d ʒ a̟ n
глух	ɡ ɫ u x
доя	d o j ɤ̟
острица	o s t r i t͡s ə
абдал	ɐ b d a ɫ
гяур	ɡʲ ɐ u r
коноп	k o n ɔ p
остатък	o s t a t ə k
политичен	p o lʲ i t i t͡ʃ e n
пряпор	p rʲ a̟ p o r
бижу	b i ʒ u̟
абдукция	ɐ b d u k t͡s i j ə
аперитив	a p ɛ r i t i f
бележка	b ɛ lʲ ɛ ʃ k ə
бежов	b ɛ ʒ o̟ f
кафез	k ɐ f ɛ s
данък	d a n ə k
пате	p a t ɛ
грънчарница	ɡ r ə n t͡ʃ a̟ r n i t͡s ə
връст	v r ɤ s t
пасяща	p ɐ sʲ a̟ ʃ t ə
баня	b a nʲ ə
никой	n i k o j
радой	r ɐ d ɔ j
академия	ə k ɐ d ɛ m i j ə
довлека	d o v lʲ ɛ k ɤ
желая	ʒ e ɫ a j ə
надебелея	n ə d ɛ b ɛ lʲ ɛ j ə
знак	z n a k
правист	p r ɐ v i s t
будуя	b u d u j ə
скопие	s k ɔ p i ɛ
чупя	t͡ʃ u̟ pʲ ə
клюн	k lʲ u̟ n
шал	ʃ a̟ ɫ
аман	a m a n
май	m a j
опозиционен	o p o z i t͡s i ɔ n ɛ n
статус	s t a t ʊ s
разногласие	r ə z n o ɡ ɫ a s i ɛ
яйцевиден	j æ j t͡s ɛ v i d ɛ n
съдба	s ə d b a
плутоний	p ɫ u t ɔ n iː
лея	lʲ ɛ j ə
средняк	s r ɛ d nʲ a̟ k
втрисане	f t r i s ə n ɛ
автоблокировка	a f t o b ɫ o kʲ i r ɔ f k ə
решение	r ɛ ʃ e n i ɛ
семейство	s ɛ m ɛ j s t v o
отточник	o t t ɔ t͡ʃ n i k
октомври	o k t ɔ ɱ v r i
узаконените	ʊ z ə k o n ɛ n i t ɛ
кожарница	k o ʒ a̟ r n i t͡s ə
стилов	s t i ɫ o f
имате	i m ə t ɛ
яре	j a̟ r ɛ
юначен	j u̟ n a t͡ʃ e n
скрия	s k r i j ə
побеждавам	p o b ɛ ʒ d a v ə m
случвам	s ɫ u t͡ʃ v ə m
банкнота	b ɐ ŋ k n ɔ t ə
обърна	o b ɤ r n ə
пречупвам	p r ɛ t͡ʃ u̟ p v ə m
благодарност	b ɫ ə ɡ o d a r n o s t
длъжен	d ɫ ɤ ʒ e n
назова	n ə z o v a
студентство	s t u d ɛ n t s t v o
трудоемък	t r ʊ d o ɛ m ə k
граната	ɡ r ɐ n a t ə
ясно	j a̟ s n o
податък	p o d a t ə k
мренията	m r ɛ n i j ə t ə
милостив	m i ɫ o s t i f
апарат	ə p ɐ r a t
рева	r ɛ v a
яли	j a̟ lʲ i
октан	o k t a n
яж	j a̟ ʃ
рея	r ɛ j ə
фермий	f ɛ r m iː
метър	m ɛ t ə r
дециметър	d ɛ t͡s i m ɛ t ə r
финанси	f i n a n s i
девет	d ɛ v ɛ t
лекарски	lʲ ɛ k ə r s kʲ i
изваждам	i z v a ʒ d ə m
център	t͡s ɛ n t ə r
щъркел	ʃ t ɤ r kʲ ɛ ɫ
жълтеникав	ʒ ə ɫ t ɛ n i k ə f
твоето	t v ɔ ɛ t o
такава	t ɐ k a v ə
бърчина	b ə r t͡ʃ i n ə
еднодневка	ɛ d n o d n ɛ f k ə
летя	lʲ ɛ tʲ a̟
хлорофил	x ɫ o r o f i ɫ
съсирек	s ə s i r ɛ k
брегът	b r ɛ ɡ ɤ t
кошара	k o ʃ a̟ r ə
ламаринен	ɫ ə m ɐ r i n ɛ n
хубав	x u b ə f
собственост	s ɔ p s t v ɛ n o s t
цел	t͡s ɛ ɫ
славянин	s ɫ ɐ vʲ a̟ n i n
родителен	r o d i t ɛ lʲ ɛ n
закон	z ɐ k ɔ n
червей	t͡ʃ e r v ɛ j
чушле	t͡ʃ u̟ ʃ lʲ ɛ
работничка	r ɐ b ɔ t n i t͡ʃ k ə
опак	ɔ p ə k
възкръсвам	v ə s k r ɤ s v ə m
слюнка	s lʲ u̟ ŋ k ə
безделнича	b ɛ z d ɛ ɫ n i t͡ʃ ə
сквозе	s k v ɔ z ɛ
том	t ɔ m
белодробен	b ɛ ɫ o d r ɔ b ɛ n
блед	b lʲ ɛ t
камила	k ɐ m i ɫ ə
сприятеля	s p r i j ə t ɛ lʲ ɤ̟
професионален	p r o f ɛ s i o n a lʲ ɛ n
неизвестен	n ɛ i z v ɛ s t ɛ n
стръмен	s t r ɤ m ɛ n
женен	ʒ e n ɛ n
среден	s r ɛ d ɛ n
открия	o t k r i j ə
въглероден	v ə ɡ lʲ ɛ r ɔ d ɛ n
мегаметър	m ɛ ɡ ɐ m ɛ t ə r
сума	s u m ə
авансцена	ɐ v ɐ n s t͡s ɛ n ə
аварски	ɐ v a r s kʲ i
машина	m ɐ ʃ i n ə
папуняк	p ɐ p u nʲ ə k
амвон	ɐ ɱ v ɔ n
напълно	n ɐ p ɤ ɫ n o
играчка	i ɡ r a t͡ʃ k ə
накажа	n ɐ k a ʒ ə
околен	o k ɔ lʲ ɛ n
бъди	b ə d i
междуметие	m ɛ ʒ d u m ɛ t i ɛ
гледам	ɡ lʲ ɛ d ə m
заедно	z a ɛ d n o
англия	a ŋ ɡ lʲ i j ə
собол	s o b ɔ ɫ
чучулига	t͡ʃ ʊ t͡ʃ u̟ lʲ i ɡ ə
