آئین	ɑː iː n
آبادی	ɑː b ɑː d̪ iː
آبشار	ɑː b ʃ ɑː ɾ
آبی	ɑː b iː
آتما	ɑː t̪ m ɑː
آج	ɑː d͡ʒ
آخرت	ɑː x ɪ ɾ ə t̪
آدمی	ɑː d̪ m iː
آدھا	ɑː d̪ʱ ɑː
آدھنک	ɑː d̪ʱ ʊ n ɪ k
آذربائیجان	ɑː z ə ɾ b ɑː ɪ d͡ʒ ɑː n
آرام	ɑː ɾ ɑː m
آرزو	ɑː ɾ z uː
آریامن	ɑː ɾ j ə m ə n
آزادی	ɑː z ɑː d̪ iː
آزمانا	ɑː z m ɑː n ɑː
آزمودہ	ɑː z m uː d ə
آس	ɑː s
آسام	ɑː s ɑː m
آستین	ɑː s t̪ iː n
آسرا	ɑː s ɾ ɑː
آسمانی	ɑː s m ɑː n iː
آسٹریا	ɔː s ʈ ɾ ɪ j ɑː
آسکت	ɑː s ə k t̪
آسیب	ɑː s eː b
آغوش	ɑː ɣ oː ʃ
آفت	ɑː f ə t̪
آفریدی	ɑː f ɾ iː d̪ iː
آلس	ɑː l ə s
آلسی	ɑː l s iː
آلنگن	ɑː l ɪ ŋ ɡ ə n
آلودگی	ɑː l uː d̪ ə ɡ iː
آمریت	ɑː m ɪ ɾ ɪ j ə t̪
آموزش	ɑː m oː z ɪ ʃ
آمیزش	ɑː m eː z ɪ ʃ
آنا	ɑː n ɑː
آندھی	ɑː n d̪ʱ iː
آنسو	ɑ̃ː s uː
آنکھ	ɑ̃ː kʰ
آواز	ɑː ʋ ɑː z
آوشيکتا	ɑː ʋ ə ʃ j ə k t̪ ɑː
آٹھواں	ɑː ʈʰ ʋ ɑ̃ː
آپ	ɑː p
آکاش	ɑː k ɑː ʃ
آکرشت	ɑː k ə ɾ ʂ ɪ t̪
آکرمن	ɑː k ɾ ə m ə ɳ
آکھیٹ	ɑː kʰ eː ʈ
آگار	ɑː ɡ ɑː ɾ
آیا	ɑː j ɑː
ابابیل	ə b ɑː b iː l
ابهار	ʊ bʱ ɑː ɾ
ابو	ə b b uː
ابٹن	ʊ b ʈ ə n
ابھشیک	ə bʱ ɪ ʂ eː k
اتحاد	ɪ t̪ː ɪ ɦ ɑː d̪
اتحادی	ɪ t̪ t̪ ɪ ɦ ɑː d̪ iː
اترنا	ʊ t̪ ə ɾ n ɑː
اتصال	ɪ t̪ t̪ ɪ s ɑː l
اتفاق	ɪ t̪ t̪ ɪ f ɑː q
اتوار	ɪ t̪ ʋ ɑː ɾ
اتھان	ʊ t̪ t̪ʰ ɑː n
اثبات	ɪ s b ɑː t̪
اجازت	ɪ d͡ʒ ɑː z ə t̪
اجالا	ʊ d͡ʒ ɑː l ɑː
اجالنا	ʊ d͡ʒ ɑː l n ɑː
اجنبی	ə d͡ʒ n ə b iː
اجوائن	ə d͡ʒ ʋ ɑː ɪ n
اجگر	ə d͡ʒ ɡ ə ɾ
احباب	ə ɦ b ɑː b
احتجاج	eː ɦ t̪ ɪ d͡ʒ ɑː d͡ʒ
احترام	e ɦ t̪ ɪ ɾ ɑː m
احتمال	eː ɦ t̪ eː m ɑː l
احسان	ə ɦ ə s ɑː n
احمق	ə ɦ m ə q
اخاہ	ə xː ɑː
اخبار	ə x b ɑː ɾ
اخذ	ə x z
اخروٹ	ə x ɾ oː ʈ
اخلاق	ə x l ɑː q
ادا	ə d̪ ɑː
اداس	ʊ d̪ ɑː s
اداسی	ʊ d̪ ɑː s iː
اداہرن	ʊ d̪ ɑː ɦ ɾ ə ɳ
ادبیات	ə d̪ b ɪ j ɑː t̪
ادھار	ʊ d̪ʱ ɑː ɾ
ادھنا	ə d̪ʱ ʊ n ɑː
ادھورا	ə d̪ʱ uː ɾ ɑː
ادی	ə d̪ jᵊ
ارب	ə ɾ ə b
ارتعاش	ɪ ɾ t̪ eː ɑː ʃ
ارجت	ə ɾ d͡ʒ ɪ t̪
ارجن	ə ɾ d͡ʒ ʊ n
ارجنٹائن	ə ɾ d͡ʒ ə n ʈ ɑː iː n
اردو	ʊ ɾ d̪ uː
ارسطو	ə ɾ ə s t̪ uː
ارش	ə ɾ ʃ
ارغوانی	ə ɾ ɣ ʋ ɑː n iː
ارمان	ə ɾ m ɑː n
ارے	ə ɾ eː
از	ə z
ازدواج	ɪ z d̪ ɪ ʋ ɑː d͡ʒ
استری	ɪ s t̪ ɾ iː
استعمال	ɪ s t̪ eː m ɑː l
استقبال	ɪ s t̪ ɪ q b ɑː l
استنبول	ɪ s t̪ ə m b oː l
اسرائیل	ɪ s ɾ ɑː iː l
اسلام	ɪ s l ɑː m
اسم	ɪ s m
اشارہ	ɪ ʃ ɑː ɾ ɑː
اشبھ	ə ʃ ʊ bʱ
اشبیلیہ	ə ʃ b iː l ɪ j ɑː ɦ
اشتراکیت	ɪ ʃ t̪ e ɾ ɑː k ɪ j ə t̪
اشتقاق	ɪ ʃ t̪ ɪ q ɑː q
اشتمالیت	ɪ ʃ t̪ e m ɑː l ɪ j ə t̪
اصطبل	ə s t̪ ə b ə l
اصل	ə s ə l
اصلاح	ɪ s l ɑː ɦ
اصول	ʊ s uː l
اصیل	ə s iː l
اضافہ	ɪ z ɑː f ə
اضطراری	ɪ z t̪ ɪ ɾ ɑː ɾ iː
اطالیہ	ɪ t̪ ɑː l ɪ j ɑː ɦ
اطفال	ə t̪ f ɑː l
اطلاقی	ɪ t̪ l ɑː q iː
اطلس	ə t̪ l ə s
اطمینان	ɪ t̪ m iː n ɑː n
اغوا	ɪ ɣ ʋ ɑː
افزائش	ə f z ɑː ɪ ʃ
افسانہ	ə f s ɑː n ə
افغانستان	ə f ɣ ɑː n ɪ s t̪ ɑː n
افق	ɑː f ə q
افلاس	ɪ f l ɑː s
اقامت	ɪ q ɑː m ə t̪
اقتصادی	ɪ q t̪ ɪ s ɑː d̪ iː
اللہ	ə l l ɑː ɦ
الم	ə l ə m
الماس	ə l m ɑː s
النکار	ə l ə ŋ k ɑː ɾ
النکرت	ə l ə ŋ k ɾ ɪ t̪
الوداع	ə l ʋ ɪ d̪ ɑː
الگ	ə l ə ɡ
امتحان	ɪ m t̪ ɪ ɦ ɑː n
امداد	ɪ m d̪ ɑː d̪
امرود	ə m ɾ uː d̪
امن	ə m ə n
امی	ə m m iː
انار	ə n ɑː ɾ
انارکلی	ə n ɑː ɾ k ə l iː
انت	ə n t̪
انتخاب	ɪ n t̪ ɪ x ɑː b
انتظار	ɪ n t̪ ɪ z ɑː ɾ
انتظام	ɪ n t̪ ɪ z ɑː m
انتظامی	ɪ n t̪ ɪ z ɑː m iː
انتم	ə n t̪ ɪ m
انتہاپسند	ɪ n t̪ e ɦ ɑː p ə s ə n d̪
انجام	ə ɲ d͡ʒ ɑː m
انجانا	ə n d͡ʒ ɑː n ɑː
اندلس	ʊ n d̪ ʊ l ʊ s
اندیکھا	ə n d̪ eː kʰ ɑː
انسان	ɪ n s ɑː n
انش	ə n ʃ
انقلاب	ɪ n q ɪ l ɑː b
انپم	ə n ʊ p ə m
انڈا	ə ɳ ɖ ɑː
انڈکوش	ə ɳ ɖ ə k oː ʃ
انڈیا	ɪ n ɖ ɪ j ɑː
انگریزی	ə̃ ŋ ɡ ɾ eː z iː
انگلستان	ɪ ŋ ɡ l ɪ s t̪ ɑː n
انگلی	ʊ ŋ ɡ l iː
انگلینڈ	ɪ ŋ ɡ l ɛː n ɖ
انگور	ə n ɡ uː ɾ
انگوری	ə ŋ ɡ uː ɾ iː
انگوٹھا	ə ŋ ɡ uː ʈʰ ɑː
انھیں	ʊ nʱ ẽː
انہ	ɑː n ɑː
انہیں	ʊ n ɦ ẽː
اهہ	ɪ ɦ
اودا	uː d̪ ɑː
اودبلاؤ	uː d̪ b ɪ l ɑː oː
اودھی	ə ʋ ə d̪ʱ iː
اور	ɔː ɾ
اوسطا	ɔː s t̪ ə n
اوقات	ɔː q ɑː t̪
اول	ə ʋ ʋ ə l
اولا	oː l ɑː
اونٹ	ũː ʈ
اوہ	uː ɦ
اٹاچی	ə ʈ ɛː t͡ʃ iː
اپاہج	ə p ɑː ɦ ɪ d͡ʒ
اپدهان	ʊ p d̪ʱ ɑː n
اپرادھی	ə p ɾ ɑː d̪ʱ iː
اپریل	ə p ɾ ɛː l
اپستھت	ʊ p ə s t̪ʰ ɪ t̪
اپلبدھ	ʊ p l ə b d̪ʱ
اپنيتر	ʊ p n eː t̪ ɾᵊ
اچانک	ə t͡ʃ ɑː n ə k
اچت	ʊ t͡ʃ ɪ t̪
اچھا	ə t͡ʃ t͡ʃʰ ɑː
اڑان	ʊ ɽ ɑː n
اڑیوا	ə ɽ eː ʋ ɑː
اژدہا	ə ʒ d̪ ə ɦ ɑː
اکثر	ə k s ə ɾ
اکیلا	ə k eː l ɑː
اگر	ə ɡ ə ɾ
اگربتی	ə ɡ ə ɾ b ə t̪ t̪ iː
اگرچہ	ə ɡ ə ɾ t͡ʃ eː
اگلا	ə ɡ l ɑː
ایت	ə j ʊ t̪
ایتھنز	iː t̪ʰ ə n z
ایجنٹ	eː d͡ʒ ə ɳ ʈ
ایران	iː ɾ ɑː n
ایرانی	iː ɾ ɑː n iː
ایشور	iː ʃ ʋ ə ɾ
ایمان	iː m ɑː n
ایماندار	iː m ɑː n d̪ ɑː ɾ
اینٹورپن	ɛː n ʈ ʋ ə ɾ p ə n
ایوان	ɛː ʋ ɑː n
بائیسکل	b ɑː iː s ɪ k ə l
بات	b ɑː t̪
بادام	b ɑː d̪ ɑː m
بادامی	b ɑː d̪ ɑː m iː
بادشاہ	b ɑː d̪ ʃ ɑː ɦ
بادشاہت	b ɑː d̪ ʃ ɑː ɦ ə t̪
بادل	b ɑː d̪ ə l
بارش	b ɑː ɾ ɪ ʃ
بازو	b ɑː z uː
باشندہ	b ɑː ʃ ɪ n d̪ ɑː
باغ	b ɑː ɣ
بال	b ɑː l
بالکل	b ɪ l k ʊ l
بانچنا	b ɑ̃ː t͡ʃ n ɑː
باٹ	b ɑː ʈ
باہوبلی	b ɑː ɦ ʊ b ə l iː
ببھکشا	b ʊ bʱ ʊ k ʂ ɑː
بت	b ʊ t̪
بتانا	b ɪ t̪ ɑː n ɑː
بجلی	b ɪ d͡ʒ l iː
بحر	b ə ɦ ɾ
بددعا	b ə d̪ d̪ ʊ ɑː
بدر	b ə d̪ ə ɾ
بدلنا	b ə d̪ ə l n ɑː
بدلوانا	b ə d̪ ə l ʋ ɑː n ɑː
بدن	b ə d̪ ə n
بدھیا	b ə d̪ʱ ɪ j ɑː
برتن	b ə ɾ t̪ ə n
برسلز	b ɾ ə s ə l z
برما	b ə ɾ m ɑː
برمنگھم	b ə ɾ m ɪ n ɡʱ ə m
بروخے	b ɾ uː x eː
برچھا	b ə ɾ t͡ʃʰ ɑː
برچھیت	b ə ɾ t͡ʃʰ ɛː t̪
برکت	b ə ɾ k ə t̪
برکها	b ə ɾ kʰ ɑː
بزرگ	b ʊ z ʊ ɾ ɡ
بستی	b ə s t̪ iː
بطخ	b ə t̪ː ə x
بظاہر	b ə z ɑː ɦ ɪ ɾ
بغير	b ə ɣ ɛː ɾ
بقرعید	b ə q ɾ iː d̪
بلا	b ʊ l l ɑː
بلغاریہ	b ʊ l ɣ ɑː ɾ ɪ j ɑː
بلکہ	b ə l k iː
بمبہ	b ə m bᵊ
بناوٹی	b ə n ɑː ʋ ə ʈ iː
بنتی	b ɪ n t̪ iː
بنجارا	b ə n d͡ʒ ɑː ɾ ɑː
بند	b ə n d̪
بندر	b ə n d̪ ə ɾ
بنزین	b ə n z iː n
بنفشی	b ə n ə f ʃ iː
بنيان	b ə n ɪ j ɑː n
بهنجك	bʱ ə n d͡ʒ ə k
بهیس	bʱ eː s
بوریت	b oː ɾ ɪ j ə t̪
بولنا	b oː l n ɑː
بونا	b ɔː n ɑː
بوڑھا	b uː ɽʱ ɑː
بٹورنا	b ə ʈ oː ɾ n ɑː
بپتسمہ	b ə p t̪ ɪ s m ɑː
بچپن	b ə t͡ʃ p ə n
بڑا	b ə ɽ ɑː
بکاؤ	b ɪ k ɑː uː
بکرا	b ə k ɾ ɑː
بکری	b ə k ɾ iː
بکس	b ə k s
بکم	b ʊ k m
بکھراو	b ɪ kʰ ɾ ɑː ʋ
بھائی	bʱ ɑː iː
بھاجن	bʱ ɑː d͡ʒ ə n
بھارت	bʱ ɑː ɾ ə t̪
بھاروپیہ	bʱ ɑː ɾ oː p ɪ j ɑː
بھاشا	bʱ ɑː ʂ ɑː
بھالو	bʱ ɑː l uː
بھانگ	bʱ ɑː ŋ ɡ
بھراتا	bʱ ɾ ɑː t̪ ɑː
بھرن	bʱ ə ɾ ə n
بھروسہ	bʱ ə ɾ oː s ɑː
بھوت	bʱ uː t̪
بھوتنی	bʱ uː t̪ ɪ n iː
بھورا	bʱ uː ɾ ɑː
بھوک	bʱ uː k
بھکت	bʱ ə k t̪
بھکتی	bʱ ə k t̪ iː
بھگدڑ	bʱ ə ɡ d̪ ə ɽ
بھگوان	bʱ ə ɡ ʋ ɑː n
بھی	bʱ iː
بھید	bʱ eː d̪
بہاؤالدین	b ə ɦ ɑː ʔ ʊ d̪ d̪ iː n
بہار	b ə ɦ ɑː ɾ
بہاراں	b ə ɦ ɑː ɾ ɑ̃ː
بہت	b ə ɦ ʊ t̪
بہتر	b ə ɦ ə t̪ t̪ ə ɾ
بہشت	b ɪ ɦ ɪ ʃ t̪
بہن	bʱ ɛː n
بہنا	b ɛ ɦ n ɑː
بیلاروس	b eː l ɑː ɾ uː s
بیوی	b iː ʋ iː
بیچ	b iː t͡ʃ
تاجکستان	t̪ ɑː d͡ʒ ɪ k ɪ s t̪ ɑː n
تار	t̪ ɑː ɾ
تازہ	t̪ ɑː z ɑː
تاشقند	t̪ ɑː ʃ q ə n d̪
تال	t̪ ɑː l
تاناشاہ	t̪ ɑː n ɑː ʃ ɑː ɦ
تاناشاہی	t̪ ɑː n ɑː ʃ ɑː ɦ iː
تاپنا	t̪ ɑː p n ɑː
تاڑ	t̪ ɑː ɽ
تاڑی	t̪ ɑː ɽ iː
تبادلہ	t̪ ə b ɑː d̪ ɪ l ɑ ɦ
تبریز	t̪ ə b ɾ eː z
تتلی	t̪ ɪ t̪ l iː
ترانه	t̪ ə ɾ ɑː n ə
ترجمان	t̪ ə ɾ d͡ʒ ʊ m ɑː n
ترجمہ	t̪ ə ɾ d͡ʒ ʊ m ɑː
ترجیح	t̪ ə ɾ d͡ʒ iː ɦ
ترٹی	t̪ ɾ ʊ ʈ iː
ترکی	t̪ ʊ ɾ k iː
تسلیم	t̪ ə s l iː m
تشنہ	t̪ ɪ ʃ n ɑː
تعداد	t̪ ə ʔ d̪ ɑː d̪
تفصیل	t̪ ə f s iː l
تقریباً	t̪ ə q ɾ iː b ə n
تكميل	t̪ ə k m iː l
تلخ	t̪ ə l̪ ə x
تلخی	t̪ ə l x iː
تلوار	t̪ ə l ʋ ɑː ɾ
تم	t̪ ʊ m
تمام	t̪ ə m ɑː m
تمنا	t̪ ə m ə n n ɑː
تمنچه	t̪ ə m ə n t͡ʃ ɑː
تمھارا	t̪ ʊ mʱ ɑː ɾ ɑː
تمھیں	t̪ ʊ mʱ ẽː
تمہارا	t̪ ʊ m ɦ ɑː ɾ ɑː
تمہیں	t̪ ʊ m ɦ ẽː
تمیز	t̪ ə m iː z
تن	t̪ ə n
تنازع	t̪ ə n ɑː z oː ʔ
تندرست	t̪ ə n d̪ ʊ ɾ ʊ s t̪
تندرستی	t̪ ə n d̪ ʊ ɾ ʊ s t̪ iː
تندور	t̪ ə n d̪ uː ɾ
تنظیم	t̪ ə n z iː m
تنگ	t̪ ə ŋ ɡ
تو	t̪ uː
توبہ	t̪ ə ʊ b ɑː
توحیدیت	t̪ ɔː ɦ iː d̪ ɪ j ə t̪
تولیہ	t̪ ɔː l ɪ j ə
تولیے	t̪ ɔː l ɪ j eː
توچا	t̪ ʋ ə t͡ʃ ɑː
توہین	t̪ ɔː ɦ iː n
تڑت	t̪ ə ɽ ɪ t̪
تگنا	t̪ ɪ ɡ n ɑː
تھوک	t̪ʰ uː k
تھوکنا	t̪ʰ uː k n ɑː
تہائی	t̪ ɪ ɦ ɑː iː
تہجی	t̪ ə ɦ ə d͡ʒː iː
تیاگ	t̪ j ɑː ɡ
تیرا	t̪ eː ɾ ɑː
تیرنا	t̪ ɛː ɾ n ɑː
تیز	t̪ eː z
تیزاب	t̪ eː z aː b
تیسرا	t̪ iː s ɾ ɑː
تیمور	t̪ ɛː m uː ɾ
تین	t̪ iː n
تیکھا	t̪ iː kʰ ɑː
ثابت	s ɑː b ɪ t̪
ثبوت	s ə b uː t̪
ثروت	s ə ɾ ʋ ə t̪
ثقافت	s ə q ɑː f ə t̪
جائپھل	d͡ʒ ɑː ɪ pʰ ə l
جائیداد	d͡ʒ ɑː ɪ d̪ ɑː d̪
جادو	d͡ʒ ɑː d̪ uː
جامعہ	d͡ʒ ɑː m ɪ ʔ ɑː
جامن	d͡ʒ ɑː m ə n , d͡ʒ ɑː m ʊ n
جامنی	d͡ʒ ɑː m n iː
جاننا	d͡ʒ ɑː n n ɑː
جانور	d͡ʒ ɑː n ʋ ə ɾ
جانچنا	d͡ʒ ɑː n t͡ʃ n ɑː
جانکاری	d͡ʒ ɑː n k ɑː ɾ iː
جاپان	d͡ʒ ɑː p ɑː n
جاپانی	d͡ʒ ɑː p ɑː n iː
جبوتی	d͡ʒ ɪ b uː t̪ iː
جدا	d͡ʒ ʊ d̪ ɑː
جدید	d͡ʒ ə d̪ iː d̪
جرأت	d͡ʒ ʊ ɾ ɾ ə t̪
جراثیم	d͡ʒ ə ɾ ɑː s iː m
جرثومہ	d͡ʒ ʊ ɾ s uː m ɑː
جرمنی	d͡ʒ ə ɾ m ə n iː
جرگہ	d͡ʒ ɪ ɾ ɡ ɑː
جسور	d͡ʒ ə s uː ɾ
جشن	d͡ʒ ə ʃ ə n
جعلی	d͡ʒ ɑː l iː
جغرافیائی	d͡ʒ ʊ ɣ ɾ ɑː f ɪ j ɑː iː
جل	d͡ʒ ə l
جلانا	d͡ʒ ə l ɑː n ɑː
جلسہ	d͡ʒ ə l s ɑ ɦ
جلنا	d͡ʒ ə l n ɑː
جلوس	d͡ʒ ʊ l uː s
جمعرات	d͡ʒ ʊ m eː ɾ ɑː t̪
جمعہ	d͡ʒ ʊ m ʔ ɑː
جمہوریت	d͡ʒ ə m ɦ uː ɾ ɪ j ə t̪
جمہوریہ	d͡ʒ ʊ m ɦ uː ɾ ɪ j ɑː
جن	d͡ʒ ɪ n n
جنت	d͡ʒ ə nː ə t̪
جنتی	d͡ʒ ə nː ə t̪ iː
جنرل	d͡ʒ ə n ɾ ə l
جنگل	d͡ʒ ə ŋ ɡ ə l
جنیئو	d͡ʒ ə n eː uː
جوا	d͡ʒ ʊ ɑː
جواب	d͡ʒ ə ʋ ɑː b
جوانی	d͡ʒ ə ʋ ɑː n iː
جوت	d͡ʒ oː t̪
جور	d͡ʒ ʋ ə ɾ
جوگی	d͡ʒ oː ɡ iː
جوں	d͡ʒ ũː
جوہر	d͡ʒ ɔː ɦ ə ɾ
جوہری	d͡ʒ ɔː ɦ ɾ iː
جٹا	d͡ʒ ə ʈ ɑː
جپنا	d͡ʒ ə p n ɑː
جڑ	d͡ʒ ə ɽ
جڑواں	d͡ʒ ʊ ɽ ʋ ɑ̃ː
جگاڑ	d͡ʒ ʊ ɡ ɑː ɽ
جگنو	d͡ʒ ʊ ɡ n uː
جھانجھ	d͡ʒʱ ɑ̃ː d͡ʒʱ
جھنڈا	d͡ʒʱ ə n ɖ ɑː
جہاز	d͡ʒ ə ɦ ɑː z
جہازی	d͡ʒ ə ɦ ɑː z iː
جہنم	d͡ʒ ə ɦ ə n n ə m
جی	d͡ʒ iː
جیبھ	d͡ʒ iː bʱ
جیت	d͡ʒ iː t̪
جیش	d͡ʒ æː ʃ
جیل	d͡ʒ eː l
جیوتی	d͡ʒ j oː t̪ iː
جیون	d͡ʒ iː ʋ ə n
حالانکہ	ɦ ɑː l ɑ̃ː k iː
حبش	ɦ ə b ə ʃ
حبقوق	ɦ ə b ə q q uː q
حج	ɦ ə d͡ʒ d͡ʒ
حجام	ɦ ə d͡ʒ d͡ʒ ɑː m
حراست	ɦ ɪ ɾ ɑː s ə t̪
حضور	ɦ ʊ z uː ɾ
حفاظت	ɦ ɪ f ɑː z ə t̪
حقوق	ɦ ʊ q uː q
حقیقت	ɦ ə q iː q ə t̪
حلال	ɦ ə l ɑː l
حلقہ	ɦ ə l q ə
حملہ	ɦ ə m l ɑː
حنا	ɦ ɪ n ɑː
حویلی	ɦ ə ʋ eː l iː
حکومت	ɦ ʊ k uː m ə t̪
حیات	ɦ ə j ɑː t̪
حیاتیات	ɦ ə j ɑː t̪ ɪ j ɑː t̪
حیران	ɦ ɛː ɾ ɑː n
حیوانیات	ɦ ɛː ʋ ɑː n ɪ j ɑː t̪
خاتمہ	x ɑː t̪ ɪ m ə
خاتون	x ɑː t̪ uː n
خادم	x ɑː d̪ ɪ m
خارجہ	x ɑː ɾ ɪ d͡ʒ ɑː
خاصا	x ɑː s ɑː
خاصی	x ɑː s iː
خالق	x ɑː l ɪ q
خاموش	x ɑː m oː ʃ
خانساماں	x ɑː n s ɑː m ɑ̃ː
خانہ	x ɑː n ɑː
خاکسار	x ɑː k s ɑː ɾ
خاکستری	x ɑː k ɪ s t̪ ə ɾ iː
خبر	x ə b ə ɾ
خدا	x ʊ d̪ ɑː
خداوند	x ʊ d̪ ɑː ʋ ə n d̪
خدمت	x ɪ d̪ m ə t̪
خراش	x ə ɾ ɑː ʃ
خربوزہ	x ə ɾ b uː z ɑː
خرگوش	x ə ɾ ɡ oː ʃ
خریدنا	x ə ɾ iː d̪ n ɑː
خریدوانا	x ə ɾ iː d̪ ʋ ɑː n ɑː
خزاں	x ɪ z ɑ̃ː
خسارہ	x ɪ s ɑː ɾ ɑː ɦ
خسرہ	x ə s ɾ ɑː
خصوصا	x ʊ s uː s ə n
خلاف	x ɪ l ɑː f
خلافت	x ɪ l ɑː f ə t̪
خلفا	x ʊ l ə f ɑː
خلق	x ə l q
خلیج	x ə l iː d͡ʒ
خلیفہ	x ə l iː f ɑː ɦ
خنجر	x ə n d͡ʒ ə ɾ
خواب	x ɑː b
خواتین	x ə w ɑː t̪ iː n
خواجہ	x ɑː d͡ʒ ɑː
خواہ	x ɑː ɦ
خواہش	x ɑː ɦ ɪ ʃ
خوبانی	x uː b ɑː n iː
خوبصورت	x uː b s uː ɾ ə t̪
خود	x ʊ d̪
خودمختاری	x ʊ d̪ m ʊ x t̪ ɑː ɾ iː
خودکش	x ʊ d̪ k ʊ ʃ
خودکشی	x ʊ d̪ k ʊ ʃ iː
خوراک	x ʊ ɾ ɑː k
خوش	x ʊ ʃ
خوشی	x ʊ ʃ iː
خوف	x ɔː f
خون	x uː n
خیر	x ɛː ɾ
داخلہ	d̪ ɑː x ɪ l ə
داردر	d̪ ɑː ɾ ɪ d̪ ɾᵊ
داستان	d̪ ɑː s t̪ ɑ̃ː
داعش	d̪ ɑː ʔ ɪ ʃ
داغ	d̪ ɑː ɣ
دام	d̪ ɑː m
دانت	d̪ ə n t̪
دانش	d̪ ɑː n ɪ ʃ
داڑم	d̪ ɑː ɽ ɪ m
دایاں	d̪ ɑː j ɑ̃ː
دبئی	d̪ ʊ b ə iː
دباؤ	d̪ ə b ɑː oː
دجلہ	d̪ ə d͡ʒ l ɑː
درخت	d̪ ə ɾ ə x t̪
درود	d̪ ʊ ɾ uː d̪
دس	d̪ ə s
دسواں	d̪ ə s ʋ ɑ̃ː
دشت	d̪ ə ʃ t̪
دشمن	d̪ ʊ ʃ m ə n
دعا	d̪ ʊ ʔ ɑː
دفعہ	d̪ ə f ʔ ɑː
دفنانا	d̪ ə f n ɑː n ɑː
دل	d̪ ɪ l
دلربا	d̪ ɪ l ɾ ʊ b ɑː
دلچسپ	d̪ ɪ l t͡ʃ ə s p
دلی	d̪ ɪ lː iː
دمشق	d̪ ə m ɪ ʃ q
دن	d̪ ɪ n
دو	d̪ oː
دودھ	d̪ uː d̪ʱ
دورلیکھ	d̪ uː ɾ l eː kʰ
دوزخ	d̪ oː z ə x
دوستانہ	d̪ oː s t̪ ɑː n ɑː
دوسرا	d̪ uː s ɾ ɑː
دوش	d̪ oː ʃ
دونا	d̪ uː n ɑː
دوگنا	d̪ oː ɡ ʊ n ɑː
دکھ	d̪ ʊ kʰ
دکھانا	d̪ ɪ kʰ ɑː n ɑː
دگنا	d̪ ʊ ɡ n ɑː
دھات	d̪ʱ ɑː t̪
دھارا	d̪ʱ ɑː ɾ ɑː
دھاندل	d̪ʱ ɑː n d̪ ə l
دھاندلی	d̪ʱ ɑː n d̪ l iː
دھرتی	d̪ʱ ə ɾ t̪ iː
دھرم	d̪ʱ ə ɾ m
دھمال	d̪ʱ ə m m ɑː l
دھماکہ	d̪ʱ ə m ɑː k ɑː ɦ
دھن	d̪ʱ ʊ n
دھواں	d̪ʱ uː ɑ̃ː
دھوج	d̪ʱ ʋ ə d͡ʒ
دھوسر	d̪ʱ uː s ə r
دھول	d̪ʱ uː l
دھونا	d̪ʱ uː n ɑː
دھوپ	d̪ʱ uː p
دھیریہ	d̪ʱ ɛː ɾ jᵊ
دہلی	d̪ ɛ ɦ l iː
دیا	d̪ ɪ j ɑː
دیروز	d̪ iː ɾ oː z
دیش	d̪ eː ʃ
دینا	d̪ eː n ɑː
دینے	d̪ eː n eː
دیوانہ	d̪ iː ʋ ɑː n ə
دیوبندی	d̪ eː ʋ b ə n d̪ iː
دیوناگری	d̪ eː ʋ n ɑː ɡ ɾ iː
دیپک	d̪ iː p ə k
دیپکا	d̪ iː p ɪ k ɑː
دیکھنا	d̪ eː kʰ n ɑː
ذائقہ	z ɑː j q ɑː
ذات	z ɑː t̪
ذرہ	z ə rː ə
ذریعہ	z ə ɾ ɪ j ə
ذلت	z ɪ lː ə t̪
ذلیل	z ə l iː l
ذوق	z ɔː q
رائے	ɾ ɑː j
رابطہ	ɾ ɑː b t̪ ɑː
رات	ɾ ɑː t̪
راج	ɾ ɑː d͡ʒ
راجا	ɾ ɑː d͡ʒ ɑː
راستہ	ɾ ɑː s t̪ ə
راضی	ɾ ɑː z iː
رامائن	ɾ ɑː m ɑː j ə n
راکٹ	ɾ ɑː k ɪ ʈ
راکھ	ɾ ɑː kʰ
راہ	ɾ ɑː ɦ
راہب	ɾ ɑː ɦ ɪ b
راہبہ	ɾ ɑː ɦ ɪ b ɑː
راہداری	ɾ ɑː ɦ d̪ ɑː ɾ iː
ربوہ	ɾ ə b ʋ ɑː ɦ
رتن	ɾ ə t̪ ə n
رد	ɾ ə d̪ d̪
رسالہ	ɾ ɪ s ɑː l ɑː
رسول	ɾ ə s uː l
رفتار	ɾ ə f t̪ ɑː ɾ
رمضان	ɾ ə m z ɑː n
رنڈی	ɾ ə ɳ ɖ iː
رنگت	ɾ ə ŋ ɡ ə t̪
رنگولی	ɾ ə ŋ ɡ oː l iː
روانڈا	ɾ ə ʋ ɑː ɳ ɖ ɑː
روانہ	ɾ ə ʋ ɑː n ɑː
روزن	ɾ ɔː z ə n
روزہ	ɾ oː z ɑː
روس	ɾ uː s
روشنی	ɾ ɔː ʃ n iː
رونا	ɾ oː n ɑː
روپ	ɾ uː p
روچڈیل	ɾ ɔː t͡ʃ ɖ eː l
رویئہ	ɾ ə ʋ ə̯ i ɑː
رویہ	ɾ ə ʋ ə̯ i j ɑː
رکت	ɾ ə k t̪
رکشا	ɾ ə k ʂ ɑː
رہنا	ɾ ə ɦ n ɑː
ریاست	ɾ iː j ɑː s ə t̪
ریاستہا	ɾ ɪ j ɑː s ə t̪ ɦ ɑː
ریاضی	ɾ ɪ j ɑː z iː
ریختہ	ɾ eː x t̪ ɑː
ریشم	ɾ eː ʃ ə m
ریپھ	ɾ eː pʰ
ریچھ	ɾ iː t͡ʃʰ
زبان	z ʊ b ɑː n
زخم	z ə x m
زندگی	z ɪ n d̪ ə ɡ iː
زندہ	z ɪ n d̪ ɑː
زہر	z ə ɦ ə ɾ
زیادتی	z ɪ j ɑː d̪ t̪ iː
سؤر	s uː ə ɾ
سائز	s ɑː ɪ z
سائنس	s ɑː ɪ n s
سائنسی	s ɑː ɪ n s iː
سات	s ɑː t̪
ساتواں	s ɑː t̪ ʋ ɑ̃ː
ساتھی	s ɑː t̪ʰ iː
ساحل	s ɑː ɦ ɪ l
سازش	s ɑː z ɪ ʃ
سالگرہ	s ɑː l ɡ ɪ ɾ ə ɦ
سانولا	s ɑ̃ː ʋ l ɑː
سانپ	s ɑ̃ː p
ساڑی	s ɑː ɽ iː
سبد	s ə b ʊ d̪
سبزی	s ə b z iː
سبھا	s ə bʱ ɑː
سدابہار	s ə d̪ ɑː b ə ɦ ɑː ɾ
سدھارنا	s ʊ d̪ʱ ɑː ɾ n ɑː
سراب	s ə ɾ ɑː b
سرحد	s ə ɾ ɦ ə d̪
سردیاں	s ə ɾ d̪ ɪ j ɑ̃ː
سرسوتی	s ə ɾ ə s ʋ ə t̪ iː
سرسوں	s ə ɾ s õː
سرشت	s ə ɾ ɪ ʃ t̪
سرشپ	s ə ɾ ʂ ə p
سرفروش	s ə ɾ f ə ɾ oː ʃ
سرمئی	s ʊ ɾ m ə iː , s ə ɾ m ə iː
سرمہ	s ʊ ɾ m ɑː
سرور	s ʊ ɾ uː ɾ
سرونام	s ə ɾ ʋ n ɑː m
سرکار	s ə ɾ k ɑː ɾ
سرگرم	s ə ɾ ɡ ə ɾ m
سزا	s ə z ɑː
سستی	s ʊ s t̪ iː
سفارت	s ɪ f ɑː ɾ ə t̪
سفارتخانہ	s ɪ f ɑː ɾ ə t̪ x ɑː n ɑː
سفر	s ə f ə ɾ
سفید	s ə f eː d̪
سلاح	s ɪ l ɑː
سلام	s ə l ɑː m
سلجوق	s ə l d͡ʒ uː q
سلجوقی	s ə l d͡ʒ uː q iː
سمئے	s ə m ə j
سماس	s ə m ɑː s
سماعت	s ə m ɑː ʔ ə t̪
سماچار	s ə m ɑː t͡ʃ ɑː ɾ
سمجھدار	s ə m ə d͡ʒʱ d̪ ɑː ɾ
سمجھنا	s ə m ə d͡ʒʱ n ɑː
سمراٹ	s ə m ɾ ɑː ʈ
سمرتی	ɪ s m ɾ ɪ t̪ iː
سموسہ	s ə m oː s ɑː
سمپرداے	s ə m p ɾ ə d̪ ɑː eː
سمکھ	s ə m m ʊ kʰ
سناتن	s ə n ɑː t̪ ə n
سنترا	s ə n t̪ ɾ ɑː
سنجها	s ə n d͡ʒʱ ɑː
سندر	s ʊ n d̪ ə ɾ
سندھ	s ɪ n d̪ʱ
سنسکرت	s ə n s k ɾ ɪ t̪
سننا	s ʊ n n ɑː
سنگاپور	s ɪ ŋ ɡ ɑː p uː ɾ
سنگھ	s ɪ̃ ŋ ɡʱ
سنہ	s ɪ̃ ŋ ɦ
سنیوگ	s ə̃ j oː ɡ
سوادو	s ʋ ɑː d̪ uː
سوانگ	s ʋ ɑː ŋ ɡ
سواگت	s ʋ ɑː ɡ ə t̪
سوتیلا	s ɔː t̪ eː l ɑː
سوستک	s ʋ ə s t̪ ɪ k
سوغات	s ɔː ɣ ɑː t̪
سونا	s uː n ɑː
سويمور	s ʋ ə j ə m ʋ ə ɾ
سوچنا	s oː t͡ʃ n ɑː
سوکھا	s uː kʰ ɑː
سپاہی	s ɪ p ɑː ɦ iː
سڑک	s ə ɽ ə k
سکنا	s ə k n ɑː
سہمانا	s ə ɦ m ɑː n ɑː
سہمنا	s ə ɦ ə m n ɑː
سہواس	s ə ɦ ʋ ɑː s
سیاست	s ɪ j ɑː s ə t̪
سیاستدان	s ɪ j ɑː s ə t̪ d̪ ɑː n
سیر	s ɛː ɾ
سینکڑا	s ɛː ŋ k ɽ ɑː
سینگ	s iː ŋ ɡ
سینیٹر	s iː n eː ʈ ə ɾ
سیکھنا	s iː kʰ n ɑː
سے	s eː
شادی	ʃ ɑː d̪ iː
شارجہ	ʃ ɑː ɾ d͡ʒ ɑː ɦ
شاستر	ʃ ɑː s t̪ ə ɾ
شاعر	ʃ ɑː j ə ɾ
شاعرہ	ʃ ɑː j ɾ ɑː
شاعری	ʃ ɑː j ɾ iː
شام	ʃ ɑː m
شاپر	ʃ ɑː p ə ɾ
شاہراہ	ʃ ɑː ɦ ɾ ɑː ɦ
شاہی	ʃ ɑː ɦ iː
شبھ	ʃ ʊ bʱ
شترو	ʃ ə t̪ ɾ uː
شجر	ʃ ə d͡ʒ ə ɾ
شخص	ʃ ə x s
شراب	ʃ ə ɾ ɑː b
شرک	ʃ ɪ ɾ k
شرکرا	ʃ ə ɾ k ə ɾ ɑː
شریر	ʃ ə ɾ iː ɾ
شریعت	ʃ ə ɾ iː ʔ j ə t̪
شرینگر	ʃ ɾ iː n ə ɡ ə ɾ
ششن	ʃ ɪ ʃ n
شعر	ʃ eː ɾ
شناخت	ʃ ɪ n ɑː x t̪
شنتانو	ʃ ə n t̪ ə n uː
شوق	ʃ ɔː q
شکایت	ʃ ɪ k ɑː j ə t̪
شکتی	ʃ ə k t̪ iː
شکریہ	ʃ ʊ k ɾ ɪ j ɑː
شہر	ʃ ɛ ɦ ɛ ɾ
شہزادہ	ʃ ə ɦ z ɑː d̪ ɑː
شہلا	ʃ ə ɦ l ɑː
شیر	ʃ iː ɾ
شیشہ	ʃ iː ʃ ɑː
شیفیلڈ	ʃ ɛː f iː l ɖ
شیو	ʃ iː ʋ
صائب	s ɑː ɪ b
صابر	s ɑː b ɪ ɾ
صابن	s ɑː b ʊ n
صاحب	s ɑː ɦ ɪ b
صارف	s ɑː ɾ ɪ f
صارفین	s ɑː ɾ ɪ f iː n
صبح	s ʊ b ɦ
صحافی	s ɪ ɦ ɑː f iː
صحت	s ɪ ɦ ə t̪
صحیح	s ə ɦ iː
صفائی	s ɪ f ɑː iː
صفحہ	s ə f ɦ ɑː
صفرواں	s ɪ f ə ɾ ʋ ɑ̃ː
صلیب	s ə l iː b
ضرور	z ə ɾ uː ɾ
ضمانت	z ə m ɑː n ə t̪
طبلہ	t̪ ə b l əᵊ
طبیعت	t̪ ə b iː j ə t̪
طبیعیات	t̪ ə b iː ʔ j ɑː t̪
طرح	t̪ ə ɾ ɦ
طلاق	t̪ ə l ɑː q
طور	t̪ ɔː ɾ
طوفان	t̪ uː f ɑː n
عابد	ʔ ɑː b ɪ d̪
عام	ɑː m
عبادت	ɪ b ɑː d̪ ə t̪
عبرانی	ɪ b ɾ ɑː n iː
عبری	ɪ b ɾ iː
عجائب	ə d͡ʒ ɑː ɪ b
عجائبات	ə d͡ʒ ɑː ɪ b ɑː t̪
عجوبہ	ə d͡ʒ uː b ɑː
عجیب	ə d͡ʒ iː b
عراق	ɪ ɾ ɑː q
عرض	ə ɾ z
عزیز	ə z iː z
عشق	ɪ ʃ q
عطر	ʔ ɪ t̪ ɾ
عقل	ʔ ə q l
علاج	ʔ ɪ l ɑː d͡ʒ
علم	ɪ l m
علمیات	ɪ l m ɪ j ɑː t̪
علوم	ʔ ʊ l uː m
عمان	ʔ o m ɑː n
عمل	ə m ə l
عموما	ʊ m uː m ə n
عنابی	ʊ n n ɑː b iː , ə n ɑː b iː
عنب	ɪ n eː b
عوام	ə ʋ ɑː m
عورت	ɔː ɾ ə t̪
عیادت	ə j ɑː d̪ ə t̪
عیاشی	ʔ ə̯ i j ɑː ʃ iː
عیسیٰ	iː s ɑː
غرناطہ	ɣ ə ɾ n ɑː t̪ ɑː ɦ
غرور	ɣ ʊ ɾ uː ɾ
غلطی	ɣ ə l ə t̪ iː
غم	ɣ ə m
غنائیت	ɣ ʊ n n ɑː iː j ə t̪
غنچہ	ɣ ʊ n t͡ʃ ɑː
غنڈہ	ɣ ʊ n ɖ ɑː
غنہ	ɣ ʊ n n ə
غیر	ɣ ɛː ɾ
غیرت	ɣ ɛː ɾ ə t̪
فادر	f ɑː d̪ ə ɾ
فارسی	f ɑː ɾ s iː
فالحال	f ɪ l ɦ ɑː l
فالسئی	f ɑː l s ə iː
فالسہ	f ɑː l s ɑː
فانی	f ɑː n iː
فخر	f ə x ɾ
فرانس	f ɾ ɑː n s
فرضی	f ə ɾ z iː
فرمائش	f ə ɾ m ɑː ɪ ʃ
فرمانا	f ə ɾ m ɑː n ɑː
فطرت	f ɪ t̪ ɾ ə t̪
فلسطین	f ɪ l ɪ s t̪ iː n
فلپائن	f ɪ l ɪ p ɑː ɪ n
فلک	f ə l ə k
فلکیات	f ə l k iː j ɑː t̪
فوج	f ɔː d͡ʒ
فورا	f ɔː ɾ ə n
فون	f ō n
فکر	f ɪ k ɾ
فیروزی	f eː ɾ oː z iː
فیصد	f iː s ə d̪
قابض	q ɑː b ɪ z
قابل	q ɑː b ɪ l
قابلیت	q ɑː b l ɪ j ə t̪
قاتل	q ɑː t̪ ɪ l
قاعدہ	q ɑː ʔ ɪ d̪ ɑː ɦ
قاموس	q ɑː m uː s
قبض	q ə b ə z
قبضہ	q ə b z ə
قبول	q ʊ b uː l
قدیم	q ə d̪ iː m
قرآن	q ʊ ɾ ʔ ɑː n
قرطبہ	q ʊ ɾ t̪ ə b ɑː ɦ
قرمزی	q ɪ ɾ m ɪ z iː
قسط	q ɪ s t̪
قسمت	q ɪ s m ə t̪
ققنس	q ə q n ʊ s
قلعہ	q ɪ l ɑː
قلندر	q ə l ə n d̪ ə ɾ
قمیض	q ə m iː z
قواعد	q ə ʋ ɑː ɪ d̪
قوت	q ʊ ʋ ʋ ə t̪
قوم	q ɔː m
قومیت	q ɔː m ɪ j j ə t̪
قیادت	q ɪ j ɑː d̪ ə t̪
قیمتی	q iː m ə t̪ iː
قیمہ	q iː m ɑː
قینچی	q ɛ̃ː t͡ʃ iː
لال	l ɑː l
لامتناہی	l ɑː m ʊ t̪ ə n ɑː ɦ iː
لاپتہ	l ɑː p ə t̪ ə
لاکھ	l ɑː kʰ
لاہور	l ə ɦ oː ɾ
لتھوینیا	l ɪ t̪ʰ ʊ eː n ɪ j ɑː
لداخ	l ə d̪ː ɑː x
لدھیانہ	l ʊ d̪ʱ ɪ j ɑː n ɑː
لرزاں	l ə ɾ z ɑ̃ː
لسانیات	l ɪ s ɑː n ɪ j ɑː t̪
لغت	l ʊ ɣ ə t̪
لفظ	l ə f z
للاٹ	l ə l ɑː ʈ
لمبا	l ə m b ɑː
لمبائی	l ə̃ m b ɑː iː
لمپٹ	l ə m p ə ʈ
لندن	l ə n d̪ ə n
لنگ	l ɪ ŋ ɡ
لنگایت	l ɪ ŋ ɡ ɑː j ə t̪
لوبیا	l oː b ɪ j ɑː
لوتھ	l oː t̪ʰ
لوری	l oː ɾ iː
لوگ	l̪ oː ɡ
لڑکا	l ə ɽ k ɑː
لڑکی	l ə ɽ k iː
لکھائی	l ɪ kʰ ɑː iː
لکھنا	l ɪ kʰ n ɑː
لگانا	l ə ɡ ɑː n ɑː
لگے	l ə ɡ eː
لہذا	l ɪ ɦ ɑː z ɑː
لہرانا	l ɛ ɦ ɾ ɑː n ɑː
لہسن	l ə ɦ s ʊ n
لہنگا	l ɛː ɦ ɛː ŋ ɡ ɑː
لیئج	l ɪ j eː d͡ʒ
لیسٹر	l ɛː s ʈ ə ɾ
لینا	l eː n ɑː
لیٹنا	l eː ʈ n ɑː
لیکھنی	l eː kʰ ə n iː
مؤذن	m ʊ ə z z ɪ n
ماحول	m ɑː ɦ ɔː l
مارنا	m ɑː ɾ n ɑː
مارگ	m ɑː ɾ ɡ
مالا	m ɑː l ɑː
مالدیپ	m ɑː l d̪ iː p
مالٹا	m ə l ʈ ɑː
مانچسٹر	m ɑ̃ː t͡ʃ ə s ʈ ə ɾ
ماہر	m ɑː ɦ ɪ ɾ
ماہرین	m ɑː ɦ ɪ ɾ iː n
مت	m ə t̪
متوجہ	m ʊ t̪ ə ʋ ə d͡ʒ d͡ʒ ʊ ɦ
متھرا	m ə t̪ʰ ʊ ɾ ɑː
مثلا	m ə s l ə n
مجرم	m ʊ d͡ʒ ɾ ɪ m
محبت	m ʊ ɦ ə b b ə t̪
محراب	m ɪ ɦ ɾ ɑː b
محشر	m ə ɦ ʃ ə ɾ
محل	m ɛ ɦ ɛ l̪
محمد	m ʊ ɦ ə m m ə d̪
محنت	m ɪ ɦ n ə t̪
مختصر	m ʊ x t̪ ə s ɪ ɾ
مخمل	m ə x m ə l
مخملی	m ə x m ə l iː
مدھم	m ə d̪ːʰ ə m
مدیرا	m ə d̪ iː ɾ ɑː
مذاق	m ə z ɑː q
مذمت	m ə z ə mː ə t̪
مذکر	m ʊ z ə k k ə ɾ
مذہب	m ə z ɦ ə b
مراٹھی	m ə ɾ ɑː ʈʰ iː
مراکش	m ə ɾ ɑː k e ʃ
مرتبہ	m ə ɾ t̪ ə b ɑː
مرتیو	m ɾ ɪ t̪ j uː
مرد	m ə ɾ d̪
مردانگی	m ə ɾ d̪ ɑː n ɡ iː
مردانہ	m ə ɾ d̪ ɑː n ɑː
مرمت	m ə ɾ ə mː ə t̪
مرنا	m ə ɾ n ɑː
مروانا	m ə ɾ ʋ ɑː n ɑː
مزہ	m ə z ɑː
مسئلہ	m ə s l ɑː
مسافر	m ʊ s ɑː f ɪ ɾ
مسجد	m ə s d͡ʒ ɪ d̪
مسقط	m ə s q ə t̪
مسلمان	m ʊ s ə l m ɑː n
مسیحی	m ə s iː ɦ iː
مشکل	m ʊ ʃ k ɪ l
مصر	m ɪ s ə ɾ
مصیبت	m ʊ s iː b ə t̪
مظاہرہ	m ʊ z ɑː ɦ ɪ ɾ ɑː
معاشرہ	m ʊ ʔ ɑː ʃ ɪ ɾ ɑː
معاملہ	m ʊ ɑː m l ɑː
معبود	m ɑː ʔ b uː d̪
معجزہ	m o ʔ d͡ʒ ɪ z ɑː ɦ
معلم	m ʊ ʔ ə l l ɪ m
معیشت	m ə ʔ iː ʃ ə t̪
مفاہمت	m ʊ f ɑː ɦ ɪ m ə t̪
مقبوض	m ə q b uː z
مقبوضہ	m ə q b uː z ə
مقدار	m ɪ q d̪ ɑː ɾ
مقدسہ	m ʊ q ə d̪ d̪ ə s ɑː
ملائیشیا	m ə l ə j ʃ ɪ j ɑː
ململ	m ə l m ə l
ملن	m ɪ l ə n
ملک	m ʊ l k
ملکہ	m ə l ɪ k ɑː
ممالک	m ə m ɑː l ɪ k
ممبئی	m ʊ m b ə iː
مناسب	m ʊ n ɑː s ɪ b
مناظر	m ə n ɑː z ɪ ɾ
منتر	m ə n t̪ ə ɾ
منتظم	m ʊ n t̪ ə z ɪ m
مندر	m ə n d̪ ɪ ɾ
منشیات	m ʊ n ə ʃː ɪ j ɑː t̪
منشیہ	m ə n ʊ ʂ j ə
منٹ	m ɪ n ə ʈ
منڈا	m ʊ ɳ ɖ ɑː
منگوانا	m ə n ɡ ʋ ɑː n ɑː
منہ	m ʊ̃ ɦ
منی	m ə n iː
مواصلات	m ʊ ʋ ɑː s ə l ɑː t̪
مواقع	m ə ʋ ɑː q eː
موجودگی	m ɔː d͡ʒ uː d̪ᵊ ɡ iː
مورت	m uː ɾ ə t̪
مورتی	m uː ɾ t̪ iː
موسم	m ɔː s ə m
موقع	m ɔː q ɑː
مولا	m ɔː l ɑː
مٹانا	m ɪ ʈ ɑː n ɑː
مٹنا	m ɪ ʈ n ɑː
مچھلی	m ə t͡ʃʰ l iː
مکھ	m ʊ kʰ
مکھن	m ə kːʰ ə n
مکہ	m ə kː ə
مہابھارت	m ə ɦ ɑː bʱ ɑː ɾ ə t̪
مہاجر	m ʊ ɦ ɑː d͡ʒ ɪ ɾ
مہاجرت	m ʊ ɦ ɑː d͡ʒ ə ɾ ə t̪
مہاجرین	m ʊ ɦ ɑː d͡ʒ ɪ ɾ iː n
مہاراشٹر	m ə ɦ ɑː ɾ ɑː ʃ ʈ ə ɾ
مہارانی	m ə ɦ ɑː ɾ ɑː n iː
مہاوت	m ə ɦ ɑː ʋ ə t̪
مہر	m ʊ ɦ ə ɾ
مہمان	m ɪ ɦ m ɑː n
مہندی	m ɪ ɦ ə̃ d̪ iː
مہنگا	m ə ɦ ə̃ ɡ ɑː
مہنگائی	m ə ɦ ə ŋ ɡ ɑː iː
میاں	m ɪ j ɑ̃ː
میتھن	m ɛː t̪ʰ ʊ n
میرا	m eː ɾ ɑː
میزان	m iː z ɑː n
میزبان	m eː z b ɑː n
مینہ	m ẽː ɦ
میوہ	m eː ʋ ɑː
میگھ	m eː ɡʱ
میں	m ẽː
مے	m ɛː
نا	n ɑː
ناخدا	n ɑː x ʊ d̪ ɑː
نادان	n ɑː d̪ ɑː n
نارنجی	n ɑː ɾ ə n d͡ʒ iː
ناصرت	n ɑː s ə ɾ ə t̪
ناظم	n ɑː z ɪ m
نافرمان	n ɑː f ə ɾ m ɑː n
نام	n ɑː m
نانگل	n ɑː ŋ ɡ ə l
نباتیات	n ə b ɑː t̪ ɪ j ɑː t̪
نبض	n ə b z
نتیجتا	n ə t̪ iː d͡ʒ ə t̪ ə n
نخرا	n ə x ɾ ɑː
ندی	n ə d̪ iː
ندیاں	n ə d̪ ɪ j ɑ̃ː
ندیو	n ə d̪ ɪ j oː
ندیوں	n ə d̪ ɪ j õː
نر	n ə ɾ
نردوش	n ɪ ɾ d̪ oː ʂ
نرمان	n ɪ ɾ m ɑː ɳ
نسبتا	n ɪ s b ə t̪ ə n
نستعلیق	n ə s t̪ ɑː l iː q
نسل	n ə s l
نشریات	n ə ʃ ɾ ɪ j ɑː t̪
نشریہ	n ə ʃ ɾ ɪ jː ə
نشست	n ə ʃ ɪ s t̪
نشور	n ʊ ʃ uː ɾ
نصاب	n ɪ s ɑː b
نصاریٰ	n ə s ɑː ɾ ɑː
نصرانی	n ə s ɾ ɑː n iː
نصرت	n ʊ s ɾ ə t̪
نصیب	n ə s iː b
نظام	n ɪ z ɑː m
نظامت	n ɪ z ɑː m ə t̪
نظر	n ə z ə ɾ
نظم	n ə z ə m
نظیف	n ə z iː f
نعرہ	n ɑː ɾ ɑː ɦ
نغمہ	n ə ɣ m ə
نفاذ	n ə f ɑː z
نقاب	n ɪ q ɑː b
نقصان	n ʊ q s ɑː n
نقطہ	n ʊ q t̪ ɑː
نقلی	n ə q l iː
نماز	n ə m ɑː z
نمبو	n ɪ m b uː
نمستے	n ə m ə s t̪ eː
نمونہ	n ə m uː n ɑː
نمکین	n ə m k iː n
ننگا	n ə̃ ŋ ɡ ɑː
ننھا	n ə nʱ ɑː
نوبت	n ɔː b ə t̪
نوواں	n ə̯ u ʋ ɑ̃ː
نيت	n iː t̪
نکاح	n ɪ k ɑː ɦ
نکاراتمک	n ə k ɑː ɾ ɑː t̪ m ə k
نکالنا	n ɪ k ɑː l n ɑː
نکسیر	n ə k s iː ɾ
نکما	n ɪ k ə m m ɑː
نگرانی	n ɪ ɡ ɾ ɑː n iː
نہ	n ɑː
نہایت	n ɪ h ɑː j ə t̪
نہیں	n ə ɦ ĩː
نیا	n ə j ɑː
نیم	n ɪ j ə m
نے	n eː
وا	ʋ ɑː
واحد	ʋ ɑː ɦ ɪ d̪
وار	ʋ ɑː ɾ
وامن	ʋ ɑː m ə n
واکیہ	ʋ ɑː k jᵊ
وتر	ʋ ə t̪ ə ɾ
ورزش	ʋ ə ɾ z ɪ ʃ
وزیر	ʋ ə z iː ɾ
وستو	ʋ ə s t̪ uː
وشنو	ʋ ɪ ʃ n uː
وصال	ʋ ɪ s ɑː l
وضو	ʋ ʊ z uː
وفا	ʋ ə f ɑː
وفاق	w ɪ f ɑː q
ولائتی	ʋ ɪ l ɑː j ə t̪ iː
ولایت	ʋ ɪ l ɑː j ə t̪
ونا	ʋ ɪ n ɑː
وچن	ʋ ə t͡ʃ ə n
وہ	ʋ oː
وہاں	ʋ ə ɦ ɑ̃ː
وہی	ʋ ə ɦ iː
ویاکرن	ʋ j ɑː k ə ɾ ə n
وینجن	ʋ j ə n d͡ʒ ə n
ویژن	ʋ iː ʒ ə n
ٹانگ	ʈ ɑː ŋ ɡ
ٹلفورڈ	ʈ ɪ l f oː ɾ ɖ
ٹکر	ʈ ə k k ə ɾ
ٹکراو	ʈ ə k ɾ ɑː ʋ
ٹھوس	ʈʰ oː s
ٹھہرنا	ʈʰ ə ɦ ə ɾ n ɑː
پاؤں	p ɑ̃ː ũː
پاستا	p ɑː s t̪ ɑː
پانچ	p ɑ̃ː t͡ʃ
پانچواں	p ɑ̃ː t͡ʃ ʋ ɑ̃ː
پانڈو	p ɑː ɳ ɖ ə ʋ
پانی	p ɑː n iː
پاکستان	p ɑː k ɪ s t̪ ɑː n
پاکستانی	p ɑː k ɪ s t̪ ɑː n iː
پتا	p ɪ t̪ ɑː
پتلون	p ə t̪ l uː n
پتی	p ə t̪ t̪ iː
پراکرت	p ɾ ɑː k ɾ ɪ t̪
پربهات	p ɾ ə bʱ ɑː t̪
پرتگیا	p ɾ ə t̪ ɪ ɡ j ɑː
پرستش	p ə ɾ ə s t̪ ɪ ʃ
پرسوں	p ə ɾ s õː
پرشنسا	p ɾ ə ʃ ə n s ɑː
پرمکھ	p ɾ ə m ʊ kʰ
پرندہ	p ə ɾ ɪ n d̪ ɑː
پرنی	p ə ɾ n iː
پروار	p ə ɾ ɪ ʋ ɑː ɾ
پرول	p ə ɾ ʋ ə l
پرچم	p ə ɾ t͡ʃ ə m
پرچہ	p ə ɾ t͡ʃ ə
پرچی	p ə ɾ ɪ t͡ʃ ə j
پرکاش	p ɾ ə k ɑː ʃ
پری	p ə ɾ iː
پریت	p ə ɾ iː t̪
پریم	p ɾ eː m
پستان	p ɪ s t̪ ɑː n
پستک	p ʊ s t̪ ə k
پستہ	p ɪ s t̪ ɑː
پسینہ	p ə s iː n ɑː
پشاور	p e ʃ ɑː ʋ ə ɾ
پشتو	p ə ʃ t̪ oː
پلانڈو	p ə l ɑː ɳ ɖ uː
پنا	p ə n n ɑː
پنجاب	p ə n d͡ʒ ɑː b
پنچھی	p ə n t͡ʃʰ iː
پنکھا	p ə ŋ kʰ ɑː
پنکھڑی	p ə ŋ kʰ ʊ ɽ iː
پنگھٹ	p ə ŋ ɡʱ ə ʈ
پوت	p uː t̪
پوجا	p uː d͡ʒ ɑː
پوجنا	p uː d͡ʒ n ɑː
پور	p uː ɾ
پورا	p uː ɾ ɑː
پوشاک	p oː ʃ ɑː k
پون	p ə ʋ ə n
پٹاخا	p ə ʈ ɑː x ɑː
پٹل	p ə ʈ ə l
پٹول	p ə ʈ oː l
پٹھان	p ə ʈʰ ɑː n
پپاسا	p ɪ p ɑː s ɑː
پڑھنا	p ə ɽʱ n ɑː
پکار	p ʊ k ɑː ɾ
پھل	pʰ ə l
پھلنا	pʰ ə l n ɑː
پھول	pʰ uː l
پھوڑا	pʰ oː ɽ ɑː
پھیلاو	pʰ ɛː l ɑː ʋ
پہ	p eː
پہاڑ	p ə ɦ ɑː ɽ
پہلا	p ə ɦ l ɑː
پہلوان	p ə ɦ l w ə n
پہنچنا	p ə ɦ ʊ̃ t͡ʃ n ɑː
پیاز	p ɪ j ɑː z
پیاس	p j ɑː s
پیج	p ɛː d͡ʒ
پیرس	p ɛː ɾ ɪ s
پیشاب	p eː ʃ ɑː b
چابھی	t͡ʃ ɑː bʱ iː
چابی	t͡ʃ ɑː b iː
چار	t͡ʃ ɑː ɾ
چاشنی	t͡ʃ ɑː ʃ n iː
چاقو	t͡ʃ ɑː q uː
چال	t͡ʃ ɑː l
چاند	t͡ʃ ɑ̃ː d̪
چاندی	t͡ʃ ɑ̃ː d̪ iː
چاٹ	t͡ʃ ɑː ʈ
چاٹنا	t͡ʃ ɑː ʈ n ɑː
چاہت	t͡ʃ ɑː ɦ ə t̪
چاہے	t͡ʃ ɑː ɦ eː
چای	t͡ʃ ɑː j
چاۓ	t͡ʃ ɑː eː
چراغ	t͡ʃ ɪ ɾ ɑː ɣ
چربی	t͡ʃ ə ɾ b iː
چرخہ	t͡ʃ ə ɾ x ɑː
چلانا	t͡ʃ ɪ l l ɑː n ɑː
چلچتر	t͡ʃ ə l t͡ʃ ɪ t̪ ɾ ə
چمو	t͡ʃ ə m uː
چنتا	t͡ʃ ɪ n t̪ ɑː
چندربند	t͡ʃ ə n d̪ ə ɾ ə b ɪ n d̪ ʊ
چنگال	t͡ʃ ə ŋ ɡ ɑː l
چوتر	t͡ʃ uː t̪ ə ɾ
چوتڑ	t͡ʃ uː t̪ ə ɽ
چوتھا	t͡ʃ ɔː t̪ʰ ɑː
چوتھائی	t͡ʃ ɔː t̪ʰ ɑː iː
چودنا	t͡ʃ oː d̪ n ɑː
چور	t͡ʃ oː ɾ
چوری	t͡ʃ oː ɾ iː
چولھا	t͡ʃ uː l ɦ ɑː
چومنا	t͡ʃ uː m n ɑː
چوٹ	t͡ʃ oː ʈ
چوٹکی	t͡ʃʰ ʊ ʈ k iː
چوڑا	t͡ʃ ɔː ɽ ɑː
چوڑائی	t͡ʃ ɔː ɽ ɑː iː
چوگنا	t͡ʃ ɔː ɡ ʊ n ɑː
چپل	t͡ʃ ə pː ə l
چڑھنا	t͡ʃ ə ɽʱ n ɑː
چڑیا	t͡ʃ ɪ ɽ ɪ j ɑː
چکت	t͡ʃ ə k ɪ t̪
چکنا	t͡ʃ ʊ k n ɑː
چکنگنیا	t͡ʃ ɪ k ə n ɡ ʊ n ɪ j ɑː
چھال	t͡ʃʰ ɑː l
چھت	t͡ʃʰ ə t̪
چھتری	t͡ʃʰ ə t̪ ɾ iː
چھلانگ	t͡ʃʰ ə l ə ŋ ɡ
چھونا	t͡ʃʰ uː n ɑː
چھوٹ	t͡ʃʰ uː ʈ
چھوٹا	t͡ʃʰ oː ʈ ɑː
چھوٹنا	t͡ʃʰ uː ʈ n ɑː
چھٹا	t͡ʃʰ ʊ ʈ ʈ ɑː
چھٹپٹانا	t͡ʃʰ ə ʈ p ə ʈ ɑː n ɑː
چھٹی	t͡ʃʰ ʊ ʈː iː
چھڑکاؤ	t͡ʃʰ ɪ ɾ k ɑː oː
چھہ	t͡ʃʰ eː
چھینک	t͡ʃʰ ĩː k
چہارم	t͡ʃ ə ɦ ɑː ɾ ʊ m
چہرہ	t͡ʃ ɪ ɦ ɾ ɑː
چیز	t͡ʃ iː z
چین	t͡ʃ iː n
ڈاک	ɖ ɑː k
ڈاکیہ	ɖ ɑː k ɪ j ɑː
ڈبہ	ɖ ɪ b b əᵊ
ڈمرو	ɖ ə m ɾ uː
ڈنکرک	ɖ ə n k ə ɾ k
ڈنکی	ɖ ə ŋ k iː
ڈوری	ɖ oː ɾ iː
ڈکار	ɖ ə k ɑː ɾ
ڈھانپنا	ɖʱ ɑ̃ː p n ɑː
ڈھولک	ɖʱ oː l ə k
ڈھونڈھ	ɖʱ uː ɳ ɖʱ
ڈھيٹھ	ɖʱ iː ʈʰ
ژالہ	ʒ ɑː l ə
کابل	k ɑː b ʊ l
کارا	k ɑː ɾ ɑː
کارن	k ɑː ɾ ə n
کاروبار	k ɑː ɾ oː b ɑː ɾ
کارکردگی	k ɑː ɾ k ə ɾ d̪ ə ɡ iː
کالا	k ɑː l ɑː
کام	k ɑː m
کانپنا	k ɑ̃ː p n ɑː
کاویہ	k ɑː ʋ j ə
کاڑھا	k ɑː ɽʱ ɑː
کبج	k ʊ b d͡ʒ
کتا	k ʊ t̪ t̪ ɑː
کتاب	k ɪ t̪ ɑː b
کتراپی	k ʊ t̪ ɾ ɑː p iː
کتره	k ʊ t̪ ɾᵊ
کتی	k ə t̪ iː
کدو	k ə d̪ uː
کردنت	k ɾ ɪ d̪ ə n t̪
کرشمہ	k ə ɾ ɪ ʃ m ɑː
کرن	k ɪ ɾ ə n
کرنا	k ə ɾ n ɑː
کروانا	k ə ɾ ʋ ɑː n ɑː
کری	k ə ɾ iː
کشدھا	k ʂ ʊ d̪ʱ ɑː
کشما	k ʂ ə m ɑː
کشیدگی	k ə ʃ iː d̪ ɡ iː
کعبہ	k ɑː b ɑː
کلاونت	k ə l ɑː ʋ ə n t̪
کلیسیا	k ə l iː s ɪ j ɑː
کمائی	k ə m ɑː iː
کمان	k ə m ɑː n
کمرہ	k ə m ɾ ɑː
کمل	k ə m ə l
کمپ	k ə m p
کمپت	k ə m p ɪ t̪
کمپن	k ə m p ə n
کمھڑا	k ʊ mʱ ə ɽ ɑː
کمی	k ə m iː
کنجی	k ʊ n d͡ʒ iː
کندرا	k ə n d̪ ə ɾ ɑː
کنواری	k ʊ̃ ʋ ɑː ɾ iː
کنگارو	k ə ŋ ɡ ɑː ɾ uː
کهان	kʰ ɑː n
کو	k oː
کوتا	k ə ʋ ɪ t̪ ɑː
کوشش	k oː ʃ ɪ ʃ
کون	k ɔː n
کوٹھی	k oː ʈʰ iː
کوکب	k ɔː k ə b
کٹی	k ə ʈ iː
کپاس	k ə p ɑː s
کپاسی	k ə p ɑː s iː
کپتان	k ə p t̪ ɑː n
کپوت	k ə p oː t̪
کپڑا	k ə p ɽ ɑː
کچھ	k ʊ t͡ʃʰ
ککش	k ə k ʃ
کھاتا	kʰ ɑː t̪ ɑː
کھانا	kʰ ɑː n ɑː
کھانگ	kʰ ɑ̃ː ɡ
کھانی	kʰ ɑː n iː
کھاگ	kʰ ɑː ɡ
کھجلی	kʰ ʊ d͡ʒ l iː
کھجور	kʰ ə d͡ʒ uː ɾ
کھدیوت	kʰ ə d̪ j oː t̪
کھرجو	kʰ ə ɾ d͡ʒ uː
کھنن	kʰ ə n ə n
کھنک	kʰ ə n ə k
کھنکنا	kʰ ə n ə k n ɑː
کھٹائی	kʰ ə ʈ ɑː iː
کھڑا	kʰ ə ɽ ɑː
کھڑی	kʰ ə ɽ iː
کھڑے	kʰ ə ɽ eː
کھیل	kʰ eː l
کھیلا	kʰ eː l ɑː
کھیلنا	kʰ eː l n ɑː
کہ	k eː
کہانی	k ə ɦ ɑː n iː
کہاوت	k ə ɦ ɑː ʋ ə t̪
کہرا	k ʊ ɦ ɾ ɑː
کہنا	k ə ɦ n ɑː
کیا	k ɪ j ɑː
کیلئے	k eː l ɪ j eː
کیلا	k eː l ɑː
کیلی	k eː l iː
کیلے	k ɛː l eː
کیمرہ	k ɛː m ɾ ɑː
کیمیا	k iː m ɪ j ɑː
کیمیائی	k iː m ɪ j ɑː iː
کینسر	k æ n s ə ɾ
کینچلی	k ẽː t͡ʃ ʊ l iː
کیول	k eː ʋ ə l
کیڑا	k iː ɽ ɑː
گاؤں	ɡ ɑ̃ː oː
گائے	ɡ ɑː eː
گاتر	ɡ ɑː t̪ ɾᵊ
گانا	ɡ ɑː n ɑː
گانجا	ɡ ɑː n d͡ʒ ɑː
گاڑی	ɡ ɑː ɽ iː
گج	ɡ ə d͡ʒ
گجرات	ɡ ʊ d͡ʒᵊ ɾ ɑː t̪
گدا	ɡ ʊ d̪ ɑː
گدھ	ɡ ɪ d̪ d̪ʱ
گدھا	ɡ ə d̪ʱ ɑː
گذارنا	ɡ ʊ z ɑː ɾ n ɑː
گذراننا	ɡ ʊ z ɾ ɑː n n ɑː
گذرنا	ɡ ʊ z ə ɾ n ɑː
گرانا	ɡ ɪ ɾ ɑː n ɑː
گرجا	ɡ ɪ ɾ d͡ʒ ɑː
گرجنا	ɡ ə ɾ ə d͡ʒ n ɑː
گردن	ɡ ə ɾ d̪ ə n
گرمکھی	ɡ ʊ ɾ m ʊ kʰ iː
گرمیاں	ɡ ə ɾ m ɪ j ɑ̃ː
گرنا	ɡ ɪ ɾ n ɑː
گرڈ	ɡ ə ɾ ʊ ɖ
گرہن	ɡ ɾ ə ɦ ə n
گزارش	ɡ ʊ z ɑː ɾ ɪ ʃ
گلابی	ɡ ʊ l ɑː b iː
گلال	ɡ ʊ l ɑː l
گلانی	ɡ l ɑː n iː
گلو	ɡ ʊ l oː , ɡ ʊ l uː , ɡ ə l uː
گلہری	ɡ ɪ l ə ɦ ɾ iː
گمانا	ɡ ʊ m ɑː n ɑː
گمبھیر	ɡ ə m bʱ iː ɾ
گمنام	ɡ ʊ m n ɑː m
گنبذ	ɡ ʊ m b ə z
گنبھیر	ɡ ə̃ m bʱ iː ɾ
گنت	ɡ ə n ɪ t̪ ə
گنتی	ɡ ɪ n t̪ iː
گندمی	ɡ ə n d̪ ʊ m iː
گندہ	ɡ ə n d̪ ɑː
گنی	ɡ ɪ n iː
گنیش	ɡ ə ɳ eː ʃ
گورو	ɡ ɔː ɾ ə ʋ
گول	ɡ oː l
گوگرد	ɡ oː ɡ ɪ ɾ d̪
گڈا	ɡ ʊ ɖ ɖ ɑː
گڑیا	ɡ ʊ ɽ ɪ j ɑː
گگن	ɡ ə ɡ ə n
گھاو	ɡʱ ɑː ʋ
گھاٹا	ɡʱ ɑː ʈ ə
گھرانا	ɡʱ ə ɾ ɑː n ɑː
گھرنا	ɡʱ ɾ ɪ n ɑː
گھریلو	ɡʱ ə ɾ eː l uː
گھوڑا	ɡʱ oː ɽ ɑː
گھڑی	ɡʱ ə ɽ iː
گھڑیال	ɡʱ ə ɽ ɪ j ɑː l
گہرا	ɡ ə ɦ ɾ ɑː
گیا	ɡ ə j ɑː
گیلا	ɡ iː l ɑː
گیند	ɡ eː n d̪
گینڈا	ɡ ɛː ɳ ɖ ɑː
گیہوں	ɡ eː ɦ ũː
گے	ɡ eː
ہاتھ	ɦ ɑː t̪ʰ
ہاتھی	ɦ ɑː t̪ʰ iː
ہار	ɦ ɑː ɾ
ہانک	ɦ ɑ̃ː k
ہانکنا	ɦ ɑː ŋ k n ɑː
ہاں	ɦ ɑ̃ː
ہتھیار	ɦ ə t̪ʰ ɪ j ɑː ɾ
ہتھیلی	ɦ ə t̪ʰ eː l iː
ہتیارا	ɦ ə t̪ j ɑː ɾ ɑː
ہرانا	ɦ ə ɾ ɑː n ɑː
ہسپانیہ	ɦ ə s p ɑː n ɪ j ə ɦ
ہفتہ	ɦ ə f t̪ ɑː ɦ
ہم	ɦ ə m
ہمارا	ɦ ə m ɑː ɾ ɑː
ہماہمی	ɦ ə m ɑː ɦ ə m iː
ہمسفر	ɦ ə m s ə f ə ɾ
ہمنوائی	ɦ ə m ‿ n ə ʋ ɑː iː
ہمیشگی	ɦ ə m eː ʃ ɡ iː
ہمیں	ɦ ə m ẽː
ہند	ɦ ɪ n d̪
ہندو	ɦ ɪ n d̪ uː
ہندوستان	ɦ ɪ n d̪ ʊ s t̪ ɑː n
ہندوستانی	ɦ ɪ n d̪ ʊ s t̪ ɑː n iː
ہنسا	ɦ ɪ n s ɑː
ہنساتمک	ɦ ɪ̃ n s ɑː t̪ m ə k
ہنڈی	ɦ ʊ n ɖ iː
ہوا	ɦ ə ʋ ɑː
ہوس	ɦ ə ʋ ə s
ہوشیار	ɦ oː ʃ ɪ j ɑː ɾ
ہونا	ɦ oː n ɑː
ہونٹھ	ɦ õː ʈʰ
ہوٹل	ɦ oː ʈ ə l
ہچکنا	ɦ ɪ t͡ʃ ə k n ɑː
ہچکی	ɦ ɪ t͡ʃ k iː
ہکا	ɦ ɪ k k ɑː
ہیک	ɦ iː k
ہے	ɦ ɛː
یا	j ɑː
یات	ɪ j ɑː t̪
یار	j ɑː ɾ
یت	ɪ j ə t̪
یرمیاہ	j ɪ ɾ m ɪ j ɑː ɦ
یروشلم	j ə ɾ uː ʃ ə l ə m
یسعیاہ	j ə s ɑː ʔ j ɑː ɦ
یعنی	j ɑː ʔ n iː
یقینا	j ə q iː n ə n
یمن	j ə m ə n
ین	iː n
یورپ	j oː ɾ ə p
یونان	j uː n ɑː n
یوکرین	j uː k ɾ eː n
یہ	j eː
یہود	j ə ɦ uː d̪
یہودنی	j ə ɦ uː d̪ ɪ n iː
معضون	m aː z uː n
کلچر	k ʊ l t͡ʃ ʊ r
جزیرہ	d͡ʒ a z iː r a
عیسائی	ʕ iː s ɑː ʔ iː
کیئر	k iː ɛ ɾ
انکڈل	ɪ n k ə ɖ l
رفت	ɾ ə f t̪
استفسار	a s t a f s aː r
فرار	f a r aː r
عنقریب	ʕ ɪ n q ə r iː b
نطرثانی	n a t̪ r s aː n iː
کاٹ	k ɑː ʈ
ساڑھے	s aː r a
مشائخ	m ʊ ʃ ɑː ɪ x
واڑی	ʋ aː ɽ iː
بےدخلی	b eː d a x l iː
پھیلاؤ	pʰ eː l aː oː
میدان	m eː d̪ ɑː n
ٹسکرس	ʈ s k ə ɾ s
پجرنا	p ə d͡ʒ ɾ n ɑː
کیمپ	k eː m p
کوشاں	k ʊ ʃ ɑː n
مصارف	m ʊ s ɑː ɾ ɪ f
اٹاپٹو	a t̪ aː p t̪ o
ایرانڈیا	a iː r aː n d̪ iː aː
رب	ɾ ə b
جوفری	d͡ʒ o f r iː
ناساز	n ɑː s ɑː z
ڈھانک	ɖʱ ɑː n k
ندیم	n ə d̪ iː m
کروڑ	k ə ɾ oː ɽ
ترنمول	t ə r n m uː l
قوانین	q ʋ aː n iː n
قدر	q a d r
موجودہ	m oː d͡ʒ uː d ɑː
ٹم	t̪ a m
نائٹ	n aɪ t̪
ابیان	ɑː b j ɑː n
لکشمی	l ə k ʃ m iː
ہومگارڈ	ɦ oː m g aː r ɖ
مینار	m iː n aː r
شیوشنکر	ʃ iː ʋ ʃ ə n k ə ɾ
فوارے	f oʊ ɑː r eɪ
مولین	m oː l iː n
زاید	z ɑː j ɪ d̪
اوقاف	ɔː q ɑː f
غیرمعروف	ɣ ɪ ɾ m ɑː ɾ uː f
کڑپہ	k a r p a
ٹھیک	ʈʰ iː k
نسق	n ɪ s q
دیویندر	d̪ eː ʋ iː n d̪ ɾ
قدرے	q ɪ d̪ r eː
مسٹرسنہا	m ɪ s ʈ ə r s n ə h ɑː
جاسوس	d͡ʒ ɑː s uː s
ڈیفنس	ɖ iː f n ɪ s
خلل	x ʊ l l
ساتویں	s ɑː t̪ ʋ eː n
ارسال	ə ɾ s ɑː l
ناتھولا	n ɑː t̪ʱ oː l ɑː
کائنات	k ɑː ɪ n ɑː t̪
عمری	ʕ ʊ m r iː
الھند	ʔ ə l ɦ ɪ n d̪
انٹرملان	ɪ n ʈ ə ɾ m ə l ɑː n
اسپانچ	ɪ s p ɑː n t͡ʃ
سکو	s k uː
جائلس	d͡ʒ ɑː ɪ l s
بوائز	b oʊ z
رامچندر	ɾ ɑː m t͡ʃ ə n d̪ ɾ ə
پڑ	p ɽ
العبیدی	ʔ ɛː l ʕ ɛː b iː d̪ iː
آٹو	ɑː ʈ oʊ
عینی	ʕ eː n iː
بینالاقوامی	b eɪ n ɑː l ɑː q ʋ ɑː m iː
جنم	d͡ʒ ə n m
الیکٹریسٹی	æ l iː k t̪ r ɪ s t̪ iː
ماچٹ	m ɑː t͡ʃ ʈ
بیمار	b eː m ɑː ɾ
بنگالی	b ʊ ŋ g ɑː l iː
مارکس	m ɑː ɾ k s
پولیت	p oː l iː t̪
محمدو	m ʊ ɦ ə m ə d̪ ʋ oʊ
ران	r ɑː n
گولی	ɡ oː l iː
اومیش	oː m iː ʃ
اٹارنی	ɑː ʈ ɑː r n iː
خودمحتار	x ʊ d m ʊ h t aː ɾ
پرگنا	p ə r ɡ n ɑː
پورکر	p ʊː r k ə r
جینت	d͡ʒ iː n t̪
پانڈے	p ɑː n ʈ e
باولی	b aː oː l iː
ڈھا	ɖʱ ɑː
نثار	n ɪ s ɑː r
انڈر	ə n ɖ ə ɾ
گروداس	ɡ ə r uː d̪ ɑː s
کینیڈانژاد	k eː n iː d̪ ɑː n ʒ ɑː d̪
یوں	j ʊː n
شکایات	ʃ iː k aː j aː t̪
انشورنس	ɪ n ʃ ʊ r ə n s
بایزید	b aɪ z iː d
تولہ	t̪ ʊː l ɑː
اورنمائش	ɔː r n ə m ɑː ɪ ʃ
سائبرٹاورس	s ɑː ɪ b ə ɾ ʈ ɑː ʋ ə ɾ s
ڈگیس	ɖ ɪ ɡ iː s
ہاشمی	ɦ ɑː ʃ m iː
لٹیرا	l ʊ ʈ iː ɾ ɑː
تقلید	t̪ ə q l iː d̪
مصنوعات	m ʊ s n ʊː ʕ ɑː t̪
ایکشن	ɛː k ʃ ə n
پورہ	p uː r ɑː
خواہشمند	x ʋ ɑː ɦ ɪ ʃ m ɛː n d̪
لکشمن	l ʊ k ʃ m ʊ n
احمد	ʔ ə ɦ m ə d̪
سیرت	s iː r ə t̪
نکتہ	n ʊ k t̪ ɑː
عارضی	ʕ ɑː r ɪ z iː
تعمیری	t̪ ʕ ə m iː r iː
شین	ʃ iː n
جنوری	d͡ʒ a n uː r iː
نافذ	n ɑː f ɪ z
ناراض	n ɑː ɾ ɑː z
حقیئقت	ɦ ə q iː q ə t̪
جھک	d͡ʒʱ ə k
میتو	m iː t̪ ʊ
عبدالحمید	ʕ b d̪ ʊ l ɦ ə m iː d̪
کیوں	k j ɔː n
کاپی	k ɑː p iː
نمائندہ	n ʊ m ɑː ɪ n d ə ɦ
رکھا	ɾ ʊ kʰ ɑː
بارہا	b ɑː ɾ ɦ ɑː
اسپیشلسٹ	ə s p eː ʃ l ɪ s ʈ
تخلیہ	t ə x l iː ə
نااہلیت	n ɑː ɑː ɦ l iː t̪
ویرنمنٹ	ʋ iː ɾ n ə m ə n t̪
انوکھا	ə n oː kʰ ɑː
طرابلس	t̪ ɾ ɑː b ʊ l s
افرادی	ɑː f ɾ ɑː d̪ iː
نمائندگان	n ʊ m ɑː ɪ n d̪ ɡ ɑː n
نالے	n ɑː l eː
فضاء	f ɪ z ɑː
برطانوی	b ɾ ɪ t̪ ɑː n ʋ iː
درشی	d̪ ɾ ʃ iː
ٹینڈرس	ʈ eː n d̪ ʊ ɾ s
ریکارڈز	ɾ eɪ k ɑː ɾ ɖ z
مہنگی	m ə ɦ n ɡ iː
چدمبرم	t͡ʃ ʊ d̪ m b ʊ ɾ m
اوباما	ɔː b ɑː m ɑː
پرفتن	p ʊ ɾ f t̪ ʊ n
تماشہ	t̪ ʊ m ɑː ʃ ɑː
سائبان	s ɑː iː b ɑː n
ایمباسیٹرس	ɪ m b ɑː s iː ʈ ʊ ɾ s
میڑچل	m eː ɽ t͡ʃ l
ٹرانسکو	ʈ ɾ ɑː n s k oː
مشکور	m ʊ ʃ k ʊː ɾ
طورپر	t̪ ʊ ɾ p ʊ ɾ
دکن	d̪ ʊ k n
مانکیا	m ɑː n k iː ɑː
غلبہ	ɡʱ ʊ l b ɑː
آشکارا	ɑː ʃ k ɑː ɾ ɑː
فوجداری	f ʊ d͡ʒ d̪ ɑː ɾ iː
زبردستی	z ʊ b ɾ d̪ ʊ s t̪ iː
چیارٹیبل	t͡ʃ iː ɑː ɾ ʈ iː b ʊ l
نوموہیون	n ʊ m ʊ ɦ iː ʊ n
معمولی	m ʊ ʔ m ʊ l iː
سہولت	s ʊ ɦ ʊ l t̪
مجیب	m ʊ d͡ʒ iː b
مقصدبراری	m ʊ k s ə d b ə r ɑː r iː
میٹروپولیٹن	m eː ʈ ɾ ʊ p ʊ l iː ʈ ʊ n
باقاعدہ	b ɑː q ɑː ɪ d̪ ɑː
پان	p ɑː n
بموجب	b ə m ʊ d͡ʒ ɪ b
روٹس	r ɔː ʈ s
پرفل	p ə ɾ f l
ڈابسن	ɖ ɑː b s ə n
فوری	f ɔː r iː
فعالیت	f ʕ ɑː l iː t̪
کشتی	k ə ʃ t̪ iː
عادل	ʕ ɑː d ə l
اشکینازی	ə ʃ k iː n ɑː z iː
خداوندی	x ʊ d ɑː ʋ ə n d̪ iː
اودھاؤ	ɔː d̪ʱ ɑː ʊ
نند	n ə n d̪
گزشتہ	ɡ ʊ z ʃ t̪ ɦ
سبقت	s ʊ b q ʊ t̪
مکتوب	m ʊ k t̪ oʊ b
چاہیئے	t͡ʃ ɑː ɦ iː ɛ
كا	k ɑː
دخل	d̪ ə x ə l
دھمکا	d̪ʱ ʊ m k ɑː
بجٹ	b ə d͡ʒ ʈ
تعمیراتی	t̪ ʕ ə m iː r ɑː t̪ iː
ٹھکانا	tʰ ɪ k ɑː n ɑː
محروسی	m ʊ ɦ r uː s iː
عناصر	ʕ ɪ n ɑː s ə r
سمترا	s ə m t̪ r ɑː
آیوکت	ɑː j oː k t̪
المقدس	ʔ ə l m ʊ q d̪ ə s
درگاہ	d ə r ɡ ɑː ɦ
شوارع	ʃ oː aː r ʕ
سوکھ	s ʊ kʰ
اجناس	ə d͡ʒ n ɑː s
توجہی	t̪ ʋ oː d͡ʒ ɦ iː
مترا	m ʊ t̪ r ɑː
مذکور	m ʊ z k ʊ r
پار	p ɑː ɾ
نور	n ʊ r
اسکام	ə s k ɑː m
سینکڑہ	s eː n k ɽ ə ɦ
معصوم	m ʕ ʊ s uː m
نظرانداز	n ʊ z ɾ ɑː n d̪ ɑː z
ایل	ɑː ɪ l
فلاحی	f l ɑː ɦ iː
انڈیوگونزیلویس	a n ɖ iː ʋ a ɡ a n z iː l a ʋ iː s
جائزہ	d͡ʒ ɑː ɪ z ɑː
تمام۔تر	t̪ ʊ m ɑː m t̪ ɾ
الیکٹرولائٹ	ə l j eː k ʈ r oː l aː ɪ ʈ
پہن	p ɛː n
چوبیس	t͡ʃ oː b iː s
سترویں	s t̪ ɾ oː v eː n
بیورو	b j ʊ ɾ oː
انہوں	ʔ ʊ n ɦ ʊ n
گولمیز	g oː l m iː z
مراکیش	m ɾ ɑː k ɛː ʃ
مدائن	m ʊ d̪ ɑː ɪ n
اجتماع	ɪ d͡ʒ t̪ ɪ m aː ʕ
دارالقضات	d̪ ɑː ɾ ʊ l q ʊ z ɑː t̪
تحریر	t̪ ʊ ħ r iː r
جبری	d͡ʒ ʊ b r iː
گندھاری	g ʊ n d̪ ɦ ɑː ɾ iː
گرکیرت	g ɾ k iː ɾ t̪
وارسا	ʋ ɑː ɾ s ɑː
فولک	f oː l k
مفاہمانہ	m ʊ f ɑː ɦ m ɑː n ɑː
زنانی	z ʊ n ɑː n iː
انظر	ɪ n z ɾ
ایشیائی	ɑː iː ʃ iː ɑː iː
ریکٹر	ɾ eː k t̪ ɾ
آگ	aː ɡ
تحفظ	t̪ ə ɦ f ə z
یورانیم	j ʊ ɾ aː n iː m
شیطان	ʃ eː t̪ ɑː n
روا	r ʋ ɑː
یونیسیف	j uː n iː s iː f
طلبی	t̪ ɑː l b iː
خسر	x ʊ s ɾ
چیرمین	t͡ʃ eː r m iː n
وینکٹ	ʋ eː n k ɪ ʈ
نورین	n ʊ ɾ iː n
خاطیوں	x ɑː t̪ iː j oː n
شلپا	ʃ ʊ l p ɑː
پوزم	p oː z ə m
دلیری	d̪ ə l iː ɾ iː
وسیع	ʋ ʊ s iː ʕ
بلز	b ə l z
کرکٹرس	k ɪ r k ɪ t̪ ɾ ʊ s
الجھن	ʔ ə l d͡ʒ ʱ ʊ n
مزدور	m ʊ z d̪ ʊ r
عنصر	ʕ ʊ n s ʊ r
کنٹیشور	k a n ʈ iː ʃ ɔː r
سرمایہ	s ə r m ɑː j ə
الزہرہ	a l z ə h r ə
باہری	b ɑː ɦ ɪ r iː
ٹورسٹ	ʈ ɔː ɾ s ʈ
اداشدہ	ʔ ə d̪ ɑː ʃ ʊ d̪ ə
نہا	n ə ɦ ɑː
ظفر	z ʊ f ə r
آئندہ	ɑː ɪ n d̪ ə
اسٹائسٹکس	ɪ s ʈ ɑː ɪ s ʈ k s
بودھن	b oː d̪ʱ ə n
سواری	s ʋ ɑː ɾ iː
شاداب	ʃ ɑː d̪ ɑː b
دوچار	d̪ ʊ t͡ʃ ɑː ɾ
انٹرنیشنل	ɪ n ʈ ə r n iː ʃ ə n ə l
پیڑ	p eː ɽ
پرہیزگاری	p ə r ɦ eː z ɡ ɑː r iː
ٹرافک	ʈ r ɑː f ɪ k
درسگاہ	d̪ ə r s ɡ ɑː ɦ
مضحکہ	m ʊ z ɦ ɑː k ə
اڈمیرل	ə d̪ m iː r l
سی	s iː
ساریامی	s ɑː r iː ɑː m iː
فتنہ	f ə t̪ n ə
معلوم	m aː l uː m
گردی	ɡ ʊ r d̪ iː
شریک	ʃ a r iː k
بنجر	b ʊ n d͡ʒ ɛ r
جھگڑا	d͡ʒʱ ə ɡ ɽ ɑː
پٹے	p a t eɪ
تعاونی	t̪ a ɑː ʋ n iː
ادعا	ɑː d̪ ʊ ɑː
گارنر	ɡ ɑː r n ə r
تلقین	t ə l q iː n
مکر	m ʊ k ə ɾ
بادبانی	b ɑː d̪ b ɑː n iː
چنی	t͡ʃ ʊ n iː
اندھیرا	ə n d̪ʱ iː ɾ aː
سنت	s a n t̪
گنجان	ɡ ʊ n d͡ʒ ɑː n
دیکشت	d iː k ʃ t̪
ٹائلٹ	ʈ ɑː ɪ l ʈ
ایٹا	eɪ ʈ ɑː
ریشی	r eː ʃ iː
جدیدترین	d͡ʒ a d iː d̪ t̪ a r iː n
فرنانڈو	f a r n ɑː n ɖ a uː
مستحکم	m ʊ s t̪ a ɦ k a m
یونیورسٹی	j uː n iː ʋ a r s ʈ iː
جگر	d͡ʒ ə ɡ ə r
جنیشور	d͡ʒ ə n iː ʃ ʊ ɾ
مئی	m eː ɪ
عمر	a m r
مشروب	m a ʃ r uː b
دامودر	d ɑː m uː d̪ a r
کامرس	k aː m ə ɾ s
پذیرائی	p ə z iː r aː iː
اڑھا	a ɽʱ ɑː
انتہا	a n t̪ a ɑː
استثنی	ɪ s t̪ ɪ s n ɑː iː
ایہود	ɪ j ɑː h ʊ d̪
سرم	s ə r m
نسبت	n ɪ s b ə t̪
کریم	k ɾ iː m
ختم	x ə t̪ m
ایڈس	ɑː iː d̪ s
کسی	k ə s iː
کالسانگرا	k ɑː l s ɑː ŋ g r ɑː
دھرنہ	dʱ ʊ r n a
گارڈیولا	ɡ aː ɽ ɖ iː oː l aː
ڈوجی	ɖ oː d͡ʒ iː
اطباء	ɪ t̪ ɪ b ɑː ɑː
میٹرس	m eː t̪ ə r s
مجھ	m ʊ d͡ʒʱ
سہل	s ə ɦ l
روزی	r oː z iː
پریسیڈنٹ	p ɾ eː s iː ɖ ə n ʈ
کولکاتا	k oː l k ɑː t̪ ɑː
منصور	m ə n s ʊ ɾ
ہائی۔ٹیکس	ɦ aɪ t̪ ɛ k s
گھیرنے	ɡʱ iː r n eɪ
وانچو	ʋ ɑː n t͡ʃ oː
کومٹ	k oː m ʈ
مول	m oː l
باون	b ɑː ʊ n
ڈسٹرکٹ	ɖ ɪ s ʈ r ɪ k ʈ
صدرجمہوریہ	s ʊ d ə r d͡ʒ ʊ m ʰ uː r iː ə
ادعاء	ʔ ə d̪ ʕ aː
پھلکی	pʰ ʊ l k iː
ہلاکت	ɦ ɛː l ɑː k t̪
مالک	m ɑː l ə k
اسکولس	ə s k uː l s
شائنی	ʃ ɑː ɪ n iː
صلاح	s ʊ l ɑː ɦ
مہلوک	m ə h l oː k
کیابس	k j ɑː b s
میز	m iː z
بہیرہ	b ə ɦ eː ɾ ə
رخ	r ʊ x
بوزخشان	b oː z x ʃ aː n
اڈے	ə ɖ ɛː
ابودرداء	ʔ ɑː b uː d ə r d ɑː ʔ
بےصبری	b eː s ʊ b ɾ iː
دلچسپی	d̪ ɪ l t͡ʃ ʊ s p iː
الفاظ	a l f ɑː z
فائر	f aː ɪ ɾ
پالیسی	p ɑː l iː s iː
فریقی	f ə r iː q iː
جارجیا	d͡ʒ ɑː r d͡ʒ iː ɑː
مجسٹریل	m ʊ d͡ʒ s t̪ ɪ r iː l
غیرضروری	ɣ eː ɾ z ə ɾ uː ɾ iː
مسوری	m ʊ s ʋ ʊ r iː
اکابر	ʔ ɑː k ɑː b ɛː ɾ
پسماندگی	p ə s m ɑː n d̪ ɡ iː
طاقتور	t̪ ɑː q t̪ ʋ ɔː ɾ
چیتاپور	t͡ʃ iː t̪ aː p ɔː r
شب	ʃ a b
لرزہ	l ɪ r z ə
پڑوسی	p ɑː r oː s iː
پیلاگو	p iː l aː ɡ oː
کوششں	k oː ʃ ɪ ʃ a n
چناب	t͡ʃ ə n ɑː b
متوازن	m ʊ t̪ ʋ aː z ə n
بےپناہ	b eː p n aː ɦ
ولاقو	ʋ ə l aː q oː
الشیخ	ʔ ʊ l ʃ eː x
سلامی	s ə l aː m iː
ری۔ایکٹرس	ɾ eː ɑː ɪ k t̪ ɾ ʊ s
قدوائی	q ʊ d̪ ʋ aː ɪ
بھنڈاری	bʱ ʊ n ʈʰ ɑː r iː
پریشد	p ɪ r eː ʃ d̪
کارنامہ	k aː r n aː m ə
فلورنگ	f l ɔː r n ɪ ŋ
ادب	ɪ d̪ b
سلم	s ʊ l m
رنز	r ə n z
ارادہ	ʔ ɪ ɾ ɑː d̪ ə
سنور	s ɪ n ʋ ɔː ɾ
حریت	ħ ʊ r iː t̪
ٹورنمنٹ	ʈ ɔː r n m ə n ʈ
قلم	q ə l ə m
عمرہ	ʕ ʊ m ɾ ɑː
برڈ	b ɾ ʊ d̪
ترپاٹھی	t̪ ə ɾ p ɑː t̪ʰ iː
مینا	m eː n ɑː
چھاونی	t͡ʃʰ ɑː ʋ n iː
ڈگ	ɖ ə ɡ
موعود	m oː ʕ uː d̪
مجرمانہ	m ʊ d͡ʒ ɾ ɪ m ɑː n ɑː
شرائط	ʃ ʊ r ɑː ɪ ʈ
چلا	t͡ʃ ʊ l ɑː
مکرم	m ʊ k r ʊ m
احمدآباد	ɑː ɦ m ɛː d̪ ɑː b ɑː d̪
صالح	s ɑː l ɪ ɦ
حرج	ħ ʊ r d͡ʒ
اکائی	ɑː k ɑː iː
تشکیل	t̪ ʊ ʃ k iː l
اجمیر	ɑː d͡ʒ m iː r
کیپرس	k eɪ p ɛ r s
اساس	ʔ ə s ɑː s
ٹسکالوسکا	ʈ s k ɑː l ʊ s k ɑː
ممنوعہ	m ə m n oː ʕ ə ɦ
پردیب	p ə ɾ d̪ iː b
بھال	bʱ ɑː l
بچھڑی	b ɪ t͡ʃʰ ɽ iː
کراہیت	k ɾ ɑː ɦ iː t̪
پھاڑ	pʰ ɑː ɽ
پڑھ	p ɽʱ
اسٹیونس	ə s ʈ iː ʋ oː n s
تدریسی	t̪ ə d̪ ɾ iː s iː
ابلیس	ɑː b l iː s
لاشعوری	l ɑː ʃ eː ʋ oː ɾ iː
قیام	q iː ɑː m
کس	k ʊ s
ٹریژری	ʈ r iː ʒ ɛ r iː
کاپوریشن	k ɑː p oː ɾ iː ʃ ə n
آگاہی	ɑː ɡ ɑː ɦ iː
دلجمعی	d ə l d͡ʒ ʊ m ʕ iː
سکریٹری	s ə k ɾ iː ʈ ə ɾ iː
گوناگوں	ɡ oː n ɑː ɡ oː n
لاٹھی	l ɑː ʈʰ iː
لہجہ	l ə ɦ d͡ʒ ə
شیشے	ʃ iː ʃ eː
معتمد	m ʊ ʔ t̪ ə m ɪ d̪
ابتر	ə b t̪ ə ɾ
گلاس	ɡ l ɑː s
کیتیش	k eː t̪ iː ʃ
خط	x a t̪
سوان	s ʋ ɑː n
عبد	ʕ ʊ b d
زیر۔قیادت	z iː ɾ q iː ɑː d̪ ə t̪
مکھو	m ʊ kʰ oː
ٹیکسی	ʈ iː k s iː
چیلنج	t͡ʃ eː l n d͡ʒ
روپیا	ɾ uː p iː ɑː
نان	n ɑː n
تدبیر	t̪ ə d̪ b iː ɾ
کالنگ	k ɑː l ə ŋ ɡ
اوقافی	oː q aː f iː
الاسد	ə l ɑː s d̪
کیوبا	k iː ʋ b ɑː
مکتب	m ʊ k t ə b
یوم	j oː m
آمیز	ɑː m iː z
ظہیرآباد	z ə ɦ iː ɾ aː b aː d̪
زبیر	z ʊ b eː ɾ
امکانی	ə m k ɑː n iː
واجبی	w aː d͡ʒ b iː
بنچس	b ə n t͡ʃ ə s
بھرت	bʱ ə r t̪
فکسنگ	f ə k s ɪ ŋ
عقبہ	ʕ ɪ q b ɑː
روگردانی	ɾ oː ɡ ə ɾ d̪ aː n iː
کسمپرسی	k ə s m ʊ p r ə s iː
پوچیا	p oː t͡ʃ iː ɑː
جارجن	d͡ʒ ɑː r d͡ʒ ə n
طیرانگاہ	ʈ iː ɾ ɑː n ɡ ɑː ɦ
زائد	z ɑː ɪ d
سائنسداں	s ɑː ɪ n s d̪ ɑː n
اسٹیم	ɪ s ʈ iː m
چھاڑ	t͡ʃʰ ɑː ɽ
شجرکاری	ʃ ʊ d͡ʒ r k ɑː r iː
آئیرن	ɑː ɪ ɾ ə n
ڈال	ɖ ɑː l
گنگولی	ɡ ʊ ŋ ɡ ɔː l iː
نسچل	n ə s t͡ʃ ə l
نکل	n ɪ k ə l
اگزامنیشن	a ɡ z ɑː m n ɪ ʃ ə n
تئن	t̪ ɛː n
بدھا	b ʊ d̪ʱ ɑː
فرق	f ɾ q
تئیں	t̪ ɛː ɪ n
اسکینڈلس	ə s k iː n d̪ ə l s
ناقد	n ɑː q ə d̪
خطا	x ə t̪ ɑː
ہنوز	ɦ ə n oː z
انعام	ɪ n ʕ aː m
ہنس	ɦ ə n s
کنٹرےکٹ	k ʊ n t̪ ɾ eɪ k t̪
اسوسی	ɪ s ʊ s iː
آرڈر	ɑː ɾ ʈ ɾ
تعزیتی	t ə ʕ z iː t̪ iː
پ	p
بیٹے	b eː ʈ eː
آکسیجن	ɑː k s iː d͡ʒ ə n
کرےگی	k ə r eɪ ɡ iː
ازاں	ɑː z ɑː n
خاصے	x ɑː s e
گین	ɡ eː n
رومس	ɾ uː m s
پراڈکٹس	p ɾ ɑː ʈ k ʈ s
اسپائس	ɪ s p aɪ s
مینٹن	m eː n ʈ n
دال	d ɑː l
جاؤں	d͡ʒ ɑː ʊ̃
نزول	n ə z uː l
وزیرداخلہ	ʋ ə z iː r d ɑː x l ə
بدعنوانی	b ə d̪ a n ʋ ɑː n iː
کیف	k eː f
خراج	x ə r ɑː d͡ʒ
انفورسمنٹ	ɪ n f ɔː r s m ə n ʈ
ٹیکس	ʈ iː k s
معاملت	m ʊ ɑː m l ə t̪
باشاہ	b ɑː ʃ ɑː ɦ
بےحیائی	b eː ɦ j ɑː iː
ڈپٹی	ɖ ə p ʈ iː
سٹی	s ʈ iː
مارکٹس	m ɑː r k ɪ t̪ s
انتقال	ɪ n t̪ iː q ɑː l
طاقت	ʈ ɑː q ə t̪
قباحت	q ə b ɑː ɦ ə t̪
سائینس	s ɑː ɪ n s
کشور	k ə ʃ ʊ r
قدرت	q ʊ d ɾ ɑː t̪
کامتھ	k ɑː m t̪ʰ
گنگ	ɡ ʊ ŋ ɡ
لکژری	l ʊ k z ʊ r iː
جبرئیل	d͡ʒ ɪ b r aɪ l
علما	ʕ ə l m ɑː
مادری	m ɑː d̪ ɛ r iː
کنسلٹنگ	k a n s a l t̪ ɪ ŋ ɡ
موہن	m oː ɦ n
حمیدالدین	ħ ʊ m iː d̪ a l d̪ iː n
ڈرون	ɖ r oː n
نذرانہ	n ɪ z r ɑː n ɑː
اسمبلی	a s m b l iː
اشیاء	a ʃ j ɑː ʔ ɑː
بوتے	b ʊ t̪ eː
کوی۶	k oː ɪ a 6
ون	ʋ ʊ n
کواری	k w ɑː r iː
ش	ʃ
زیرقیادت	z ɪː r q iː ɑː d̪ t̪
معالجہ	m a ʕ ɑː l ɪ d͡ʒ ɑː
بےہوش	b eː ɦ oː ʃ
پیام	p j ɑː m
ویش	v eɪ ʃ
مرحومہ	m ə ɾ ɦ uː m ə
معاہدہ	m ʊ ɑː ɦ ɪ d̪ ɑː
دیرینہ	d̪ eɪ r iː n ɑː
سختی	s a x t̪ iː
بلین	b ɛː l iː n
کروڑپتی	k ɾ oː ɽ p a t̪ iː
دوری	d̪ oː r iː
افسوسناک	a f s oː s n ɑː k
استوار	ə s t̪ ʋ ɑː ɾ
جوڑا	d͡ʒ oʊ ɽ ɑː
ٹاکیوو	ʈ ɑː k j oː v
ایشیا	ɑː ɪ ʃ iː ɑː
بنچ	b ə n t͡ʃ
پرسکون	p ə ɾ s k uː n
دیانتداری	d iː aː n ə t̪ d aː r iː
آندھرا	ɑː n d̪ʱ ə ɾ ɑː
پتلا	p ʊ t̪ l ɑː
بہکا	b ə ɦ k ɑː
اکٹھا	ə k ʈʰ ɑː
نکسلائٹ	n ɪ k s l ɑː iː t̪
اکانٹس	ə k ɑː n ʈ s
بش	b ʊ ʃ
کاروائی	k ɑː ɾ oː ɑː iː
اخراجات	ɑː x r ɑː d͡ʒ ɑː t
مدینہ	m ə d̪ iː n ɑː
بمقابلہ	b ə m q ɑː b l ə ɦ
پرگی	p ə r ɡ iː
فارچو	f ɑː ɾ t͡ʃ oː
ثالث	s ɑː l ɪ s
ڈرین	ɖ ɾ iː n
سلنڈر	s ə l ə n ɖ ə ɾ
سپلی	s ə p l iː
لحاظ	l ɪ ɦ ɑː z
بینچ	b iː n t͡ʃ
ہیڈکوارٹر	ɦ iː ʈ k ʋ ɑː ɾ ʈ ə ɾ
محسن	m ʊ ɦ s ə n
پڈوچیری	p ə ɖ oː t͡ʃ iː ɾ iː
عروس	ʕ ʊ ɾ ʊ s
اسپنر	ə s p n ə ɾ
بالخصوص	b ɑː l x a s ʊ s
تنازعہ	t̪ ə n ɑː z a ɦ
بامشقت	b ɑː m ʃ q a t̪
شعار	ʃ a ɑː ɾ
پولیو	p oː l iː oː
راجستھان	ɾ ɑː d͡ʒ s t̪ʰ ɑː n
ونڈے	ʋ ʊ n ʈ eː
کوہیر	k oː ɦ iː ɾ
ب	b
شانی	ʃ ɑː n iː
سالومان	s ɑː l oː m ɑː n
جنسی	d͡ʒ ʊ n s iː
وویک	ʋ oː ʋ iː k
وین	ʋ eː n
عامہ	ʕ ɑː m ə
قیصر	q eː s ɾ
دریا	d̪ ə ɾ iː ɑː
ٹرانسپورٹ	ʈ r ɑː n s p ɔː r ʈ
وظیفدار	ʋ ʊ z iː f d̪ ɑː ɾ
طاق	t̪ ɑː q
گھرا	ɡʱ ɛː ɾ ɑː
جھونکا	d͡ʒʱ uː n k ɑː
وصولی	ʋ ʊ s uː l iː
ایمبرسمنٹ	ɛ m b ɾ ɛ s m ɛ n ʈ
منان	m ʊ n ɑː n
گیارنٹی	ɡ j ɑː r n ʈ iː
دہی	d̪ eː ɦ iː
دیگر	d̪ eː ɡ ɾ
مینڈس	m eː n ɖ s
ایکسپریس	aɪ k s p ɾ iː s
ہیکہ	ɦ eː k ɦ
شبہات	ʃ ə b ɦ ɑː t̪
پینسل	p eː n s ə l
ذمہداری	z ə m ɦ d̪ ɑː ɾ iː
وجود	ʋ ə d͡ʒ uː d̪
راس	ɾ aː s
گود	ɡ uː d̪
دینی	d̪ iː n iː
مباین	m ʊ b ɑː j n
لاپرواہی	l ɑː p ɾ ʋ ɑː ɦ iː
انڈین	ɪ n ʈ iː n
کمپیوٹر	k a m p j uː ʈ ə ɾ
بعدازاں	b aː d̪ ɑː z ɑː n
مہیندرا	m ə h iː n d r ɑː
اگان	ə ɡ ɑː n
ساحلی	s ɑː ɦ l iː
جانی	d͡ʒ ɑː n iː
تھکا	t̪ʰ ə k ɑː
سنتوش	s ʊ n t̪ oʊ ʃ
پرسار	p ə ɾ s ɑː ɾ
ایموٹو	ɛː m oʊ ʈ oʊ
لازم	l ɑː z ə m
ڈیویژنل	ɖ iː ʋ iː ʒ n l
وجیہ	ʋ ə d͡ʒ iː ɦ
اذیت	ə z iː t̪
کا	k ɑː
دستی	d̪ ə s t̪ iː
ڈاریوس	ɖ ɑː ɾ iː ʊ s
القاعدہ	ʔ ə l q ɑː ʕ ɪ d̪ ɑː
کوچ	k ʊ t͡ʃ
نارائن	n ɑː ɾ ɑː ɪ n
ووٹ	ʋ uː ʈ
گولہ	ɡ oː l a
خصوص	x ʊ s uː s
بابرہ	b ɑː b ɾ ɑː
برسر	b ə r s ə r
چراغاں	t͡ʃ ɾ ɑː ɣ ɑː̃
شان	ʃ aː n
اسکواڈ	ɑː s k uː ɑː d̪
العرفائ	ə l a ɾ f ɑː ɪ
افتتاح	ə f t̪ t̪ ɑː ɦ
چوکا	t͡ʃ oʊ k ə
کونسل	k oː n s ə l
پرکلا	p ɛ ɾ k l ɑː
پاپیا	p ɑː p iː ɑː
رازداری	ɾ ɑː z d̪ ɑː ɾ iː
طالبا	t̪ ɑː l ɪ b ɑː
لائے	l ɑː ɪ eː
محروم	m ə ɦ ɾ uː m
کانفرنس	k ɑː n f ɾ ə n s
سج	s ə d͡ʒ
غلام	ɣ ʊ l ɑː m
جھنڈ	d͡ʒ ʱ ʊ n ɖ
گیڈ	ɡ eː ɖ
برادرنسبتی	b ɾ ɑː d̪ ə r n ɪ s b ə t̪ iː
کرس	k ɾ ʊ s
سپریمو	s ʊ p ɾ iː m oː
پٹرولیم	p a t̪ ɾ oː l iː m
کب	k a b
بنوکلب	b ə n oː k l a b
مارون	m ɑː ɾ oː n
مصروف	m ʊ s ɾ ʊ f
نادیہ	n ɑː d̪ iː ɑː
اسٹیڈیم	ə s t̪ iː d̪ iː m
سرزنش	s ə ɾ z n ɪ ʃ
تلبیہ	t̪ ə l b iː ə
یافتہ	j ɑː f t̪ ɑː
آگاہ	ɑː ɡ aː ɦ
شوٹنگ	ʃ oː ʈ ɪ ŋ
تھم	t̪ ɦ ə m
شنید	ʃ ə n iː d
نمبیار	n ə m b j aː r
ایرلائینس	ɛː r l aɪ n s
سمیع	s ə m iː ʕ
بیاگ	b j aː ɡ
یوگانڈا	j ʊ ɡ ɑː n ʈ ɑː
التواء	ʔ ə l t̪ ʋ ɑː
موٹر	m oː ʈ ɾ
پوٹےشیم	p oʊ ʈ eɪ ʃ iː m
شرط	ʃ ə ɾ t̪
مفتاحی	m uː f t̪ aː ɦ iː
ہلڑ	ɦ ə l ɽ
پٹنہ	p a t̪ n ɑː
یکجا	j ə k d͡ʒ aː
پرتبھا	p ə r t̪ ʊ bʱ ɑː
چھڑا	t͡ʃʰ ɽ aː
الشمس	ʔ ə l ʃ ə m s
کیسی	k eɪ s iː
ذاکر	z ɑː k ə r
سیرسہ	s eː ɾ s ə
یوہان	j uː ɦ aː n
شہادت	ʃ ə ɦ ɑː d̪ ə t̪
نافذالعمل	n aː f iː z ʔ ə l ʕ ə m ə l
گفتگو	ɡ ʊ f t ɡ oʊ
کفر	k ə f ə r
د	d
جٹ	d͡ʒ a ʈ
چندناکھن	t͡ʃ ʊ n d̪ n ɑː kʰ n
راو	r aː ʋ
ویٹرنری	w eː ʈ ə r n ə r iː
پٹی	p ʈ iː
ڈرونس	ɖ ɾ oː n s
سامنے	s ɑː m n eɪ
کنٹرولرس	k ə n ʈ r oː l ə r s
شے۶	ʃ eː ʧʰ ʰ
تصویر	t̪ ə s ʋ iː ɾ
تحریک	t̪ ə ɦ ɾ iː k
ٹیوب	ʈ iː ʋ b
طالب	ʈ ɑː l ɪ b
آئٹمس	ɑː ɪ ʈ m s
موظف	m ʊ z ə f
صحابہ	s ʊ ɦ ɑː b ɑː
رہ	r ə ɦ
توصیف	t ʋ o s iː f
کوئ	k ʊ ɪ
ابھیلاشا	ə bʱ iː l ɑː ʃ ɑː
گائناکالوجی	ɡ ɑː iː n ɑː k ɑː l oː d͡ʒ iː
بلاکس	b l ɑː k s
اکسپریس	ə k s p eɪ r iː s
انفرنس	ɪ n f ə r n ə s
تناظر	t̪ ə n ɑː z ə r
کفایتی	k ə f aː j t̪ iː
کونکنی	k uː n k n iː
بیزار	b eɪ z ɑː r
ساری	s ɑː r iː
زینت	z eɪ n ə t̪
جواہر	d͡ʒ ʋ ɑː ɦ ə r
قربت	q ʊ r b ə t̪
مہربند	m ə ɦ ɾ b ə n d̪
دفتری	d̪ ə f t̪ ə r iː
اناج	ɑː n ɑː d͡ʒ
فارمس	f ɑː r m s
دہندہ	d̪ ə ɦ n d̪ ə
قرعہ	q ʊ r a ʕ ɑː
پجاری	p ʊ d͡ʒ ɑː r iː
پریدا	p ə r iː d̪ ɑː
متجاوز	m ʊ t̪ d͡ʒ ɑː ʋ ə z
لیاپس	l iː ɑː p s
پھیلی	pʰ eː l iː
نہس	n ɛ h s
میڈیم	m eː d̪ iː ə m
بدھسٹ	b ʊ d̪ʱ s ʈ
حافظ	ħ ɑː f ɪ z
عشرت	ʕ ɪ ʃ r ə t̪
وبائی	ʋ ʊ b aː ɪ
غرض	ɣ ʊ r d̪ z
چتا	t͡ʃ ʊ t̪ ɑː
فٹچ	f ʈʃ
توسیعی	t̪ ʊ s iː ʔ iː
ضبط	z a b t
آڈیٹنگ	ɑː d ɪ t ɪ ŋ
کرانیکل	k ə r ɑː n iː k ə l
تحدید	t̪ ə h d̪ iː d̪
کوبائلوبہ	k ʋ ʊ b ɑː iː l ʋ ʊ b ɑː
سوا	s ʋ aː
چھاپا	t͡ʃʰ ɑː p ɑː
محتاجی	m ʊ h t̪ ɑː d͡ʒ iː
گہہ	ɡ ə ɦ ɦ
مذاکراہ	m ʊ z ɑː k ɾ ɑː ɦ
الیکشن	a l iː k ʃ a n
روپوش	r uː p oː ʃ
دھو	d̪ʱ uː
بنجارہ	b ə n d͡ʒ ɑː ɾ ɑː
رائلس	ɾ ɑː ɪ l s
یزدانی	j ɛ z d ɑː n iː
ایٹمی	ɛː ʈ m iː
تماریڈی	t̪ ə m ɑː ɾ iː ɖ iː
انجنیئرنگ	ɪ n d͡ʒ ə n iː ə ɾ n ɡ
حقارت	ɦ ʊ q ɑː ɾ ə t̪
وشوکت	ʋ ə ʃ ʋ oː k ə t̪
کاری	k ɑː ɾ iː
ذمہ۔دارانہ	z ə m ɦ ɖ ɑː ɾ ɑː n ɑː
پیغام	p eː ɡ ɑː m
شائد	ʃ ɑː ɪ d̪
ورون	ʋ ə ɾ uː n
پرزور	p ə ɾ z ʊ ɾ
تصادم	t̪ ə s ɑː d̪ ə m
نامی	n ɑː m iː
موہنی	m oː h n iː
سلیکشن	s ə l iː k ʃ ə n
آمدنی	ɑː m d̪ ə n iː
شرم	ʃ ə ɾ m
اوز	oː z
ستاری	s t̪ ɑː ɾ iː
فائدہ	f ɑː ɪ d̪ ə
حبشی	ħ ʊ b ʃ iː
کمیونٹی	k a m j uː n ɪ ʈ iː
مشرق	m ɪ ʃ ɾ ɪ q
تقریبا	t̪ ə q ɾ iː b ɑː
ٹکٹس	ʈ ɪ k ʈ s
مےئر	m eː ɪ ɾ
رومن	ɾ uː m ə n
سمجھ	s ʊ m d͡ʒʱ
چکرورتی	t͡ʃ ə k r ʊ r t iː
کمپٹرولر	k a m p j uː t̪ ə ɾ oʊ l ə ɾ
متاثرہ	m ʊ t̪ ɑː s ɪ ɾ ɑː
اسٹارس	ə s ʈ ɑː ɾ s
متقاضی	m ʊ t̪ q aː z iː
ہوڑا	ɦ ʊ r ɑː
دستبردار	d̪ ʊ s t̪ b ɛ r d̪ ɑː r
افراد۔سازی	ɑː f ɾ ɑː d̪ . s ɑː z iː
فورٹ	f ɔː ɾ ʈ
کوششیں	k oː ʃ ɪ ʃ ẽː
پٹیل	p ʈ iː l
نتائج	n ɪ t̪ aː ɪ d͡ʒ
ملازم	m ʊ l ɑː z ə m
اتم	ɪ t̪ ə m
بحسن	b ɦ ʊ s n
اند	ɑː n d̪
صحافت	s ɪ ħ ɑː f ə t̪
رحمت	ɾ ɪ ɦ m a t̪
غیرمنافع	ɣ ɛː r m ə n ɑː f ɛ
بیدر	b iː d r
توقع	t̪ ʋ oː q ʕ
آسان	ɑː s ɑː n
احتراز	ə ɦ t̪ ɾ ɑː z
جمیعتہ	d͡ʒ ʊ m iː ʕ ɑː t̪ ɑː
دانیال	d ɑː n iː ɑː l
امدادی	ə m d ɑː d̪ iː
شماری	ʃ ʊ m ɑː ɾ iː
مشرا	m ə ʃ ɾ ɑː
وزیرستان	ʋ ə z iː ɾ ə s t̪ ɑː n
چارجس	t͡ʃ ɑː r d͡ʒ ɪ s
لیول	l iː ʋ ə l
وینکٹیش	ʋ eː n k ʈ iː ʃ
عہدہ	ʕ ɛː d̪ ɑː
فرزند	f ə r z ə n d
تعاقب	t̪ ʕ ɑː q ʊ b
امان	ə m ɑː n
ممتا	m ʊ m t̪ ɑː
سید	s eː d̪
سنوار	s ʊ n ʋ ɑː r
ساکری	s ɑː k ɾ iː
اذلان	ə z l ɑː n
خریدار	x ə r iː d ɑː r
پوشیدہ	p oː ʃ iː d̪ ə
کالجس	k ɑː l d͡ʒ ə s
غیرمحفوظ	ɣ ɛː ɾ m ɦ ʊ f ʊ z
شبانہ	ʃ ə b ɑː n ɑː
ڈسمبر	ɖ ə s m b ə ɾ
مبشر	m ʊ b ʃ ɛ r
جہدکار	d͡ʒ ə ɦ d̪ k ɑː ɾ
اڈوائزری	ə ɖ ʋ ɑː ɪ z ə ɾ iː
حجر	ɦ ə d͡ʒ ɾ
لاما	l ɑː m ɑː
آلراؤنڈر	ɑː l r aʊ n d̪ ə r
سوہال	s uː h aː l
جوڑ	d͡ʒ oː ɽ
کالم	k aː l ʊ m
گودھرا	ɡ oː d̪ʱ ɾ aː
دعائے	d̪ʊ ɑː ɪ eː
رامو	ɾ ɑː m ʊ
قاسمی	q aː s m iː
گلبرگہ	ɡ ʊ l b ə ɾ ɡ ə
بسس	b ə s s
سنوائی	s ʊ n oː ɑː iː
مضمون	m ʊ z m uː n
آنجہانی	ɑː n d͡ʒ ə h aː n iː
سوالیہ	s uː aː l iː ə
شری	ʃ ɾ iː
میکسیکو	m eː k s iː k oː
سری	s ɾ iː
علامہ	ʕ ə l aː m ə
وفاقی	w ʊ f ɑː q iː
غیرسرکاری	ɣ ɪ r s ʊ r k ɑː r iː
غمازی	ɣ ɪ m ɑː z iː
بغیر	b ɪ ɣ ɛː r
مانند	m aː n ɪ n d̪
خسرو	x ʊ s ɾ oː
پارٹنر	p aː ɾ ʈ n ə ɾ
لیکچرر	l iː k t͡ʃ ə ɾ ɾ
اندرا	ɪ n d r ɑː
دشواری	d̪ ʊ ʃ ʋ ɑː ɾ iː
ویراٹ	v ɪ r ɑː t̪
لیبرمن	l iː b ə r m ə n
مسدود	m ʊ s d̪ uː d̪
سوز	s ʊ z
باعزت	b ɑː ʕ ɪ z z ə t̪
پیٹرسن	p eː ʈ ə ɾ s ə n
حسنی	ɦ ə s n iː
ترملگیری	t ɛ r m ʊ l g iː r iː
نومنتخب	n oː m ə n t̪ ɪ x ə b
سرپنچ	s ə ɾ p ə n t͡ʃ
بھوگ	bʱ ʊ ɡ
پٹریو	p ʈ r iː oː
مولوی	m uː l oʊ w iː
مولانا	m oː l ɑː n ɑː
تھیلا	t̪ʰ iː l ɑː
باربروسہ	b ɑː r b ə r oː s ə
انشاء	ɪ n ʃ ɑː ʔ
باقاعدگی	b ɑː q ɑː ʔ ɪ d̪ ɡ iː
تجارتی	t̪ ɪ d͡ʒ ɑː r t̪ iː
مڈبھیڑ	m ʊ d̪ bʱ iː ɽ
پارلیمنٹ	p aː ɾ l iː m ə n ʈ
ٹیوٹ	ʈ iː uː ʈ
چشتی	t͡ʃ ɪ ʃ t̪ iː
وشاکھا	ʋ ʊ ʃ ɑː kʰ ɑː
بیدی	b eɪ d̪ iː
کم	k a m
ولتھاٹی	ʋ ʊ l t̪ʱ ɑː ʈ iː
البتہ	a l b ə t̪ ɑː
سنا	s ʊ n ɑː
دور	d̪ uː ɾ
ریکارڈکردہ	r eː k ɑː r ʈ k ʊ r d ə ɦ
ایف	eː f
ایشین	eː ʃ iː n
آرٹیکل	ɑː r ʈ iː k ə l
بھوٹیہ	bʱ ʊ ʈ iː ɑː
سینکڑوں	s eː n k ə ɽ oː n
بیٹسمےن	b eː ʈ s m ɛ n
منسوخی	m ʊ n s ʊ x iː
غصہ	ɣ ʊ s ɑː
امیت	a m iː t̪
لازمی	l ɑː z m iː
خونریز	x ʊ n r iː z
اڑا	a ɽ ɑː
سست	s ʊ s t̪
کلومیٹر	k ɪ l oʊ m iː t̪ ə ɾ
مالگاڑی	m ɑː l ɡ ɑː ɽ iː
ایکڑ	eː k ə r
پیٹ	p eː ʈ
جارحانہ	d͡ʒ ɑː ɾ ɦ ɑː n ɑː
سگنل	s ɪ g n ə l
ناممکن	n ɑː m ʊ m k ə n
واٹر	ʋ ɑː ʈ ə ɾ
علامت	ʕ ʊ l aː m a t
پیدائشی	p eː d̪ ɑː ɪ ʃ iː
لکیج	l ə k iː d͡ʒ
شعب	ʃ a ʕ b
عکس	a k s
ایووکیڈو	ɛ j uː k iː d oʊ
طبقات	ʈ ɑː b q ɑː t̪
مشاعرہ	m ʊ ʃ ɑː ɪ r ə
کوہ	k oː ɦ
راشٹرپتی	r ɑː ʃ t r p a t iː
ٹیکساس	ʈ iː k s ɑː s
ناخوش	n ɑː x ʊ ʃ
گیلانی	ɡ iː l ɑː n iː
عالمی	ʕ ɑː l ə m iː
ڈوگر	ɖ oː ɡ ɛː ɾ
فلور	f l oʊ r
پارٹنرشپ	p ɑː r t n ɛ r ʃ ɪ p
دوستی	d oʊ s t iː
ومبلڈن	v a m b l d a n
پھسل	pʰ a s l
پردہ	p a r d̪ ɑː
اسٹون	ɪ s t oʊ n
پنیسر	p a n iː s ɛ r
گرانٹس	ɡ r ɑː n t s
بھارتیہ	bʰ ɑː r t iː ə
نوٹ	n oʊ t
رنگاریڈی	ɾ ə ŋ g ɑː ɾ iː d̪ iː
سسرال	s a s r ɑː l
سیما	s iː m ɑː
رفتہ	r a f t ə
روپے	ɾ uː p eː
لیگ	l iː ɡ
دوپہر	d̪ uː p ɛː ɾ
نیاک	n iː ɑː k
مکانپور	m ə k ɑː n p ɔː ɾ
روایاتی	ɾ ʋ ɑː j ɑː t̪ iː
قیدی	q iː d̪ iː
سرزمین	s ʊ ɾ z ə m iː n
پیچھا	p iː t͡ʃʰ ɑː
ڈارا	ɖ ɑː ɾ ɑː
گنا	ɡ ʊ n ɑː
کچرہلز	k ʊ t͡ʃ r ə h l z
ٹکراؤ	ʈ ɪ k ɾ ɑː ʊ
برس	b ɛː ɾ s
بڑھتا	b ə ɽ ʈ ɑː
سنجہا	s ʊ n d͡ʒ ɦ ɑː
چنگل	t͡ʃ ʊ ŋ ɡ ʊ l
جس	d͡ʒ ʊ s
پرمیشور	p ɾ ə m iː ʃ ɔː ɾ
المرزائی	a l m ɛ r z aɪ iː
ایشن	eɪ ʃ ʊ n
بسا	b ə s ɑː
اوراد	ɔː ɾ ɑː d̪
ئن	ʔ ɪ n
ٹرانزیشنل	ʈ r ɑː n z iː ʃ a n l
منظوری	m ə n z ʊ r iː
پسند	p ə s ə n d̪
طوطی	ʈ ɔː ʈ iː
حسین	ɦ ʊ s eɪ n
ہائیکورٹ	ɦ aː iː k ɔː ɾ ʈ
ڈیوڈ	ɖ iː oʊ ɖ
چائے	t͡ʃ aɪ ə
خارج	x aː r ɪ d͡ʒ
کارنی	k aː r n iː
تب	t̪ ə b
مراسم	m ʊ r aː s ɪ m
یومی	j oː m iː
نیننس	n eː n ɪ n s
ورما	ʋ ɔː ɾ m ɑː
مظفر	m ʊ z f ə r
جوس	d͡ʒ oʊ s
ارکنساس	ɑː ɾ k ə n s ɑː s
سلجھ	s ʊ l d͡ʒ ɦ
کھمم	kʰ ʊ m m
بڑھوتری	b a ɽ ʊ t̪ ɾ iː
متواتر	m ʊ t̪ ʋ ɑː t̪ ɾ
شرع	ʃ ʊ r ʕ
بٹور	b ʊ t̪ ɔː ɾ
کھلاڑی	kʰ l ɑː ɽ iː
کورٹ	k ɔː r ʈ
جامع	d͡ʒ aː m ɛː
چینلس	t͡ʃ iː n ə l s
یرموک	j ɪ r m uː k
برت	b ə r t̪
تیرھواں	t̪ ɪ ɾ ʊ w ɑː n
لفٹ	l ɪ f t̪
بھونگیر	bʱ ʊ ŋ g iː r
سخت	s ʊ x t̪
غیردستوری	ɣ ɛː r d̪ ʊ s t̪ ʊ ɾ iː
جسونت	d͡ʒ ʊ s ʊ n t̪
جہازرانی	d͡ʒ ə ɦ ɑː z r ɑː n iː
برائے	b ɾ ɑː ɪ e
نوٹس	n oː ʈ s
دوپے	d̪ oː p eː
المسلمین	ʊ l m ʊ s l iː m iː n
عجب	ʕ ʤ a b
اہلیہ	ɑː ɦ l iː ɑː
مچلکہ	m ʊ t͡ʃ a l k ɑː
بریلی	b ɾ iː l iː
بےحد	b eː ɦ ə d̪
ینگ	j ɪ ŋ
دفن	d̪ a f n
بلاآواز	b a l ɑː ɑː ʋ ɑː z
فورسٹ	f ɔː r s t̪
ویریا	ʋ iː r iː ɑː
فالکن	f ɑː l k ə n
جدول	d͡ʒ ʊ d̪ ʊ l
اسپیکٹرم	ə s p eː k ʈ r ʊ m
دلیل	d ɪ l iː l
اچاریہ	ə t͡ʃ ɑː ɾ iː ə
پرنسپل	p ə ɾ n s p ə l
ڈگر	ɖ ə ɡ ə ɾ
کیڈٹس	k eː ɖ ɪ t̪ s
کشادہ	k ə ʃ aː d̪ ə
کٹرپسند	k ʈ ə ɾ p s ʊ n d̪
کنی	k ə n iː
چیلنجس	t͡ʃ eː l ə n d͡ʒ s
سوشیل	s oː ʃ iː l
مفت	m ʊ f t̪
میٹابولائز	m eː ʈ ɑː b oː l aː ɪ z
عوامی	ʕ ʋ aː m iː
مانے	m aː n eː
رعیتوبازار	ɾ ʕ j ɪ t̪ oː b ɑː z ɑː ɾ
کچن	k ʊ t͡ʃ n
گھنٹا	ɡʱ ʊ n ʈ ɑː
چیٹا	t͡ʃ iː ʈ ɑː
فٹنس	f ɪ t̪ n ə s
لکشمیا	l ə k ʃ m iː aː
گندا	ɡ ʊ n d ɑː
پیکیج	p eː k iː d͡ʒ
بتدریج	b ə t̪ d̪ ɾ iː d͡ʒ
مایاوتی	m aː j aː ʋ ə t̪ iː
یوسف	j uː s ə f
گجویل	ɡ ə d͡ʒ ʋ ə iː l
ذمہ۔دار	z ə m ɦ ə d̪ aː ɾ
رائےدہی	ɾ aː ɪ ə d̪ ɦ iː
میراں	m iː r aː n
کمپنی	k ə m p n iː
نقش	n ə q ʃ
ماہ	m aː ɦ
رسٹورنٹس	ɾ ə s ʈ ɔː ɾ ə n ʈ s
فیکلٹی	f iː k l ʈ iː
كر	k ə r
اسپاٹ	ɪ s p ɑː ʈ
کمبلے	k ə m b l eː
سائیٹ	s aɪ ʈ
کارپوریٹر	k aː ɾ p ɔː ɾ iː ʈ ə ɾ
غفلت	ɣ ə f l ə t̪
رہنمائے	ɾ ə ɦ n ə m aː ɪ
ہنومان	ɦ ə n ʋ oː m aː n
اردن	ɑː r d̪ ə n
ہمدردی	ɦ ə m d̪ ə r d̪ iː
مہربن	m ə ɦ r b ə n
پابند	p ɑː b ə n d̪
روایت	r ʋ ɑː j ə t̪
ٹیلی	ʈ iː l iː
بےجا	b eː d͡ʒ ɑː
ازم	ə z m
سلوک	s ʊ l uː k
گردوارہ	ɡ ʊ ɾ d̪ ʋ ɑː ɾ ɑː
باز	b ɑː z
انوراللہ	ɑː n ʋ ə r ɑː l l ɑː ɦ
اکرام	ɑː k r ɑː m
افتخار	ɑː f t̪ ɪ x ɑː r
بھاری	bʱ ɑː r iː
جونیر	d͡ʒ ʊ n iː ɾ
سوامی	s ʊ ɑː m iː
حصول	ɦ ʊ s uː l
بشمول	b ə ʃ m ʊ l
انڈر۔پاس	ɪ n ɖ ə ɾ p ɑː s
قانون	q ɑː n uː n
کارخانہ	k ɑː r x ɑː n ə
واقعاتی	ʋ ɑː q eː ɑː t̪ iː
ریمارک	r eɪ m ɑː r k
یونٹس	j ʊ n ɪ t̪ s
کے	k eː
جائے	d͡ʒ ɑː ɪ
عاص	ʕ ɑː s
انتہاپسندی	ɪ n t̪ ɦ ɑː p s ə n d̪ iː
سیکڑوں	s iː k ə ɾ ʊ n
کوڈا	k ʊ d̪ ɑː
مقامی	m ʊ q ɑː m iː
موجھی	m oʊ d͡ʒʱ iː
اکثریت	a k s ʊ ɾ iː t̪
نفس	n ə f s
برف	b ɛː ɾ f
فلو	f l oː
اولمپک	ʔ aʊ l m p ɪ k
جھوٹی	d͡ʒ ʱ uː ʈ iː
دندنا	d ə n d ə n ɑː
کارکرد	k ɑː r k ə r d̪
وغیرہ	ʋ ə ɣ ɛː r ə
ابن	ə b n
حالت	ɦ ɑː l ə t̪
بحیثیت	b ɦ ɪ s iː t̪
معین	m ʊ ʔ iː n
کمرے	k ə m ɾ eː
اظہر	ʔ ɪ z ʱ ə r
متوفی	m ʊ t̪ ʋ ɔː f iː
چوم	t͡ʃ oː m
ڈین	ɖ iː n
منیجر	m ə n iː d͡ʒ ə r
عسکریت۔پسند	a s k ɛ ɾ iː t̪ p ʊ s n ʊ n d̪
اوسو	ɔː s o
جگدیشور	d͡ʒ ʊ ɡ d̪ iː ʃ ʊ ɾ
رپورٹرس	ɾ ə p ɔː r ʈ ə r s
ایلینا	ʔ eː l iː n ɑː
روزنامہ	ɾ oː z n ɑː m ə
غداری	ɣ ə d̪ aː ɾ iː
ٹرینس	ʈ ɾ eː n s
گاڑ	ɡ ɑː ɽ
کیوی	k iː w iː
طینت	ʈ ɪ n t̪
ماک	m ɑː k
محفوظ	m ʊ h f oː z
رکوع	ɾ ʊ k uː ʕ
سنگین	s ʊ ŋ g iː n
مخاطب	m ʊ x ɑː t̪ ɪ b
ٹھہراؤ	ʈʰ ɛ ɦ r ɑː oʊ
فیریرو	f eɪ r iː r oʊ
آخرالزماں	ɑː x ɪ r a l z ʊ m ɑː n
کہاکہ	k ə ɦ ɑː k ə
تروپتی	t̪ r oʊ p t̪ iː
ادھو	a d̪ʱ oʊ
غیرمستحکم	ɣ ɪ r m ʊ s t̪ ɦ a k a m
شمولیت	ʃ ʊ m oʊ l iː t̪
روبہ	r oː b ɑː
مذکرہ	m ʊ z k ɪ ɾ ɑː
ڈیسک	ɖ iː s k
رگھوناتھ	r ʊ gʱ oʊ n ɑː t̪ʰ
ساتھ	s ɑː t̪ʰ
ضلاع	z ʊ l ɑː ʕ
صدی	s ə d̪ iː
طبقہ	ʈ ə b q ə
سیوریج	s iː ʋ ə ɾ ɪ d͡ʒ
ویٹ	ʋ eɪ t
غزہ	ɣ ə z ə
کارڈ	k ɑː ɽ d̪
چکنائی	t͡ʃ ʊ k n aɪ iː
ماسٹر	m ɑː s ʈ ə ɾ
چیرپرسن	t͡ʃ eː ɾ p ə ɾ s ə n
فیالوقت	f iː ɑː l ʋ ʊ q t̪
عزا	ʕ ɪ z ɑː
چٹس	t͡ʃ ə ʈ s
مانشیرا	m ɑː n ʃ iː ɾ ɑː
آبسٹیٹرکس	ɑː b s ʈ iː ʈ ɪ ɾ k s
فورسی	f ɔː ɾ s iː
نیلا	n iː l ɑː
دھل	d̪ ɦ ɛː l
فیڈنگ	f iː d̪ ɪ ŋ ɡ
ڈائریا	ɖ ɑː ɪ ɾ iː ɑː
برخلاف	b ɪ ɾ x ɪ l ɑː f
ناپاک	n ɑː p ɑː k
غور	ɣ ʊ ɾ
سوپر	s uː p ɪ ɾ
اعزازی	ɑː ɪ z ɑː z iː
شک	ʃ ʊ k
تضاد	t̪ ʊ z ɑː d̪
ثناخوان	θ n ɑː x w ɑː n
انفوٹی	ɪ n f oʊ ʈ iː
انفراسٹرکچر	ɪ n f r ɑː s t̪ ɾ ʊ k t̪ʃ ʊ ɾ
مسلح	m ʊ s l ɛ ɦ
ٹائیلس	ʈ ɑː ɪ l s
وسلم	ʋ ʊ s l ʊ m
کوچس	k oː t͡ʃ ə s
اگرچیکہ	ə ɡ ə ɾ t͡ʃ iː k ɛː
گز	ɡ ʊ z
ٹیچر	ʈ iː t͡ʃ ɪ ɾ
ماریشیس	m ɑː r iː ʃ iː s
سنجیدگی	s ʊ n d͡ʒ iː d̪ ɡ iː
سابقہ	s ɑː b iː q ɑː
سربیائی	s ʊ r b iː ɑː iː
ایذارسانیوں	ɑː ɪ ð ɑː ɾ s ɑː n iː ʊ n
سیریز	s iː ɾ iː z
مخبر	m ʊ x b ɪ ɾ
انڈسٹریل	ɪ n ɖ ʊ s t̪ r iː l
احد	ɑː ɦ ə d̪
خیرسگالی	x eː r s ɡ ɑː l iː
امام	ɪ m ɑː m
دوران	d̪ ʊ ɾ ɑː n
مقدر	m ʊ q d̪ ɑː ɾ
بچہ	b ə t͡ʃ ɑː
ڈھانچہ	ɖʱ ɑː n t͡ʃ ɑː
راجو	ɾ ɑː d͡ʒ oː
میاتھمیٹکس	m j ɑː t̪ʰ m iː ʈ ɪ k s
ابھیجیت	ə bʱ iː d͡ʒ iː t̪
محدود	m ə ɦ d̪ uː d̪
ویزا	ʋ iː z ɑː
لوسان	l oː s ɑː n
متحدہ	m ʊ t̪ ɦ ɛ d̪ ɑː
کیمیکل	k iː m iː k ə l
چوبے	t͡ʃ oː b eː
انحراف	ɪ n ɦ ɪ r ɑː f
درجہ	d̪ ə r d͡ʒ ɑː
فورتھ	f oː r t̪ʰ
کودنڈا	k ʊ d̪ n ʊ n d̪ ɑː
خریدی	x ə r iː d iː
پریمئر	p r eɪ m ɪə r
درس	d ə r s
کروڈ	k ə r oː ɖ
قاصر	q aː s ə r
اسٹال	ɪ s ʈ aː l
اروکھ	aː r oː kʰ
عاقد	ʕ aː q ə d
ہائی	ɦ aɪ
لاگو	l ɑː ɡ ʊ
بہیمانہ	b ə h iː m aː n ə
تھیراپی	t̪ʰ eː ɾ ɑː p iː
القرآن	a l q ʊ r aː n
خطیر	x ə t̪ iː r
تعصبیت	t̪ ʕ a s b iː t̪
بشرط	b ə ʃ ɾ ʈ
شرن	ʃ ə r n
برہان	b ə r ɦ aː n
نشانی	n ə ʃ aː n iː
خاصکر	x ɑː s k ə ɾ
کشٹاریڈی	k ʊ ʃ t̪ ɑː ɾ iː d̪ iː
ورنگل	ʋ ɔː r n ɡ a l
ایسی	aɪ s iː
انکاؤنٹر	ɪ n k aʊ n t̪ ɛ r
وسنت	ʋ ʊ s n a t̪
الطاف	a l t̪ ɑː f
مایوس۔کن	m aː j oː s k ʊ n
گجنی	ɡ ʊ d͡ʒ n iː
چیمپین	t͡ʃ iː m p iː n
روزگار	r oː z ɡ ɑː r
بریگیڈیر	b ɾ iː ɡ eɪ d̪ iː r
لائینز	l aɪ n z
یچوری	j ɛ t͡ʃ oː r iː
ناکامی	n ɑː k ɑː m iː
سربرآوردہ	s ɛ r b ɛ r ɑː ʋ ɛ r d̪ ɑː
آئیڈیا	ɑː ɪ d̪ iː ɑː
متعلق	m ʊ t̪ ʕ ʊ l ɪ q
پرنم	p ɛ r n a m
نارا	n ɑː ɾ ɑː
واقف	ʋ ɑː q ɪ f
وسعت	ʋ ʊ s a t̪
جوان	d͡ʒ ʋ ɑː n
گرفتارشدہ	ɡ ɛ r f t̪ ɑː r ʃ ʊ d̪ ɑː
کھلواڑ	kʰ ə l ʋ ɑː ɽ
معدنیات	m ʊ ʔ d̪ ə n iː ɑː t̪
ستیا	s ʊ t̪ iː ɑː
لارینس	l ɑː ɾ iː n s
دستاویزات	d̪ ə s t̪ ɑː ʋ iː z ɑː t̪
جھوٹ	d͡ʒ ʱ uː ʈ
بالے	b ɑː l eː
للن	l ʊ l ə n
رامیا	ɾ ɑː m iː ɑː
حکمرانی	ɦ ʊ k ʊ m ɾ ɑː n iː
غیرانسانی	ɣ ɛː r ɪ n s ɑː n iː
راجیم	r ɑː d͡ʒ iː m
مروڑ	m ɛ ɾ ʋ ɔː ɽ
باک	b ɑː k
بیگز	b eː ɡ z
الداخلہ	ʔ ɛː l d̪ ɑː x l ɑː
دیواکر	d̪ iː ʋ ɑː k ə ɾ
دعوہ	d̪ ʊ ʔ ɑː
کلب	k ʊ l b
تلاش	t ə l ɑː ʃ
پردیپ	p ə r d iː p
عبدالعزیز	ʕ ʊ b d ʊ l ʕ ʊ z iː z
شیواجی	ʃ iː ʋ ɑː d͡ʒ iː
یوگیتا	j oː g iː t̪ ɑː
مہندا	m ə ɦ n d ɑː
رشادی	r ə ʃ ɑː d iː
مقفل	m ʊ q f ʊ l
گائیڈنس	ɡ ɑː iː d̪ n s
کارگزاری	k ɑː r ɡ ʊ z ɑː r iː
رجوران	r ə d͡ʒ ʊ r ɑː n
عبید	ʕ ʊ b eː d̪
پورم	p ʊ r m
مطابق	m ʊ t̪ ɑː b ɪ q
ہنگامہ	ɦ ʊ ŋ ɡ ɑː m ə
لیفٹیننٹ	l iː f ʈ iː n ə n ʈ
اوپینین	oː p iː n iː n
انہدامی	ʔ ʊ n ɦ d ɑː m iː
رنجن	r ə n d͡ʒ ə n
سپرد	s ʊ p ə r d̪
میرے	m iː ɾ eː
پالکرتی	p ɑː l k ə ɾ t̪ iː
بریہ	b ə ɾ j ə
پاور	p ɑː ʋ ə ɾ
غزوۂ	ɣ ə z ʋ ə
خبریں	x ə b ɾ iː n
فنڈ	f ʊ n ʈ
چانسلر	t͡ʃ ɑː n s ə l ə ɾ
تجدید	t̪ ə d͡ʒ d̪ iː d̪
سری۔لنکائی	s ə ɾ iː l ə n k ɑː iː
فراخ۔دل	f ɾ ɑː x d ɪ l
سامل	s ɑː m ə l
استعفے	ɪ s t̪ ɪ ʕ f ɛː
سرسید	s ə ɾ s iː d̪
اندیشہ	ɪ n d̪ iː ʃ ɑː
چترویدی	t͡ʃ ə t̪ ɾ ʊ ʋ eː d̪ iː
اترپردیش	ʊ t̪ ə ɾ p ə ɾ d̪ eː ʃ
پدما	p ə d̪ m ɑː
اسٹیون	ɪ s t̪ iː ʋ ə n
فاروق	f ɑː ɾ ʊ q
متذکرہ	m ʊ t̪ ð ɪ k ɾ ɑː
بابری	b ɑː b ɾ iː
ہستم	ɦ ə s t̪ ə m
طلبہ	ʈ ə l b ə ɦ
گھنٹہ	ɡʱ ʊ n ʈ ɑː
فیڈرر	f eː d̪ ɛː ɾ ɾ
کاپٹر	k ɑː p ʈ ɾ
استاد	ʊ s t̪ ɑː d̪
آفسیر	ɑː f s iː ɾ
ملزمین	m ʊ l z ɪ m iː n
شروع	ʃ ʊ ɾ uː ʕ
دستاویزی	d̪ ə s t̪ ɑː ʋ iː z iː
فی۔الحال	f eː ɑː l ɦ ɑː l
اصغر	ɪ s ɣ ə ɾ
ہاما	ɦ ɑː m ɑː
کھوکس	kʰ oː k s
لوشیا	l oː ʃ iː ɑː
کنٹک	k ə n ʈ ɪ k
وطن	ʋ ə t̪ ə n
سیلسیس	s iː l s iː s
پسندیدہ	p ʊ s n d̪ iː d̪ ə
ریڈ	ɾ eː d̪
مظالم	m ʊ z ɑː l ɪ m
تبدیلی	t̪ a b d̪ iː l iː
بااثر	b ɑː ʔ s ɛ ɾ
پرجوش	p ʊ r d͡ʒ oː ʃ
نمائند	n ʊ m aː ɪ n d̪
ابوغریب	ɑː b ʊ ɣ ɾ iː b
ابلاغ	ə b l ɑː ɣ
ثانوی	θ ɑː n ʋ iː
سداسیوپیٹ	s ʊ d ɑː s j oː p iː ʈ
سیشنس	s eː ʃ n s
نبھانے	n ʊ bʱ ɑː n eː
تاریخی	t̪ ɑː r ɪ x iː
گرما	ɡ ɾ m aː
صرفہ	s ʊ ɾ f ɑː
رواداری	ɾ ʋ ɑː d̪ ɑː ɾ iː
کوتلماں	k oː t̪ ʊ l m ɑː n
ذرا	z ɪ ɾ ɑː
جادھوپور	d͡ʒ ɑː d̪ʱ oː p ʊ ɾ
وفد	ʋ ʊ f d̪
ھما	ɦ m ɑː
ارتکاب	ɪ ɾ t̪ k ɑː b
کودانڈارام	k uː d ɑː n ɖ ɑː ɾ ɑː m
ڈپارٹمنٹ	ʈ p ɑː ɾ ʈ m ʊ n ʈ
شیوسینا	ʃ iː ʋ s iː n ɑː
نورانی	n ʊ r aː n iː
مہنت	m ʊ h n a t
ریکارڈس	ɾ eː k ɑː ɾ ʈ s
تحصیل	t̪ ɦ ʊ s iː l
سینا	s iː n ɑː
بلے	b ʊ l eː
چنانچہ	t͡ʃ ʊ n ɑː n t͡ʃ ɑː
برتر	b ɪ ɾ t̪ ɾ
کاشف	k ɑː ʃ f
مند	m ʊ n d
نشر	n a ʃ r
دھوم	d̪ʱ uː m
ں	ɳ
انوپ	ɑː n uː p
موسیقی	m oː s iː q iː
سورج	s uː r d͡ʒ
برعکس	b ɾ a ʕ k s
مسٹالا	m ʊ s ʈ ɑː l ɑː
کمیشن	k a m iː ʃ a n
کشیدہ	k a ʃ iː d̪ ɑː
ہیرو	ɦ iː r uː
مکین	m ʊ k iː n
چاول	t͡ʃ ɑː ʋ ə l
دیو	d eː ʋ
کنٹراکٹر	k a n ʈ r ɑː k ʈ a r
فصل	f a s l
نقشہ	n a k ʃ ɑː
لئے	l ɛː
بوتھا	b oː t̪ʰ ɑː
منسلک	m ʊ n s ʊ l k
مالیت	m ɑː l iː t̪
شہد	ʃ ə ɦ d̪
سوار	s ʋ ɑː ɾ
صحافتی	s ʊ h ɑː f t̪ iː
بگاڈیا	b ʊ g ɑː ɖ iː ɑː
تکنیکی	t̪ a k n iː k iː
چھتیس	t͡ʃʰ a t iː s
فیاض	f j ɑː z
اعتماد	ɪ ʔ t̪ ɪ m ɑː d̪
النظر	ʔ ʊ l n ʊ z ɾ
سائمن	s ɑː ɪ m ʊ n
الارض	ʔ ʊ l ɑː ɾ z
غیرموسمی	ɣ ɛː ɾ m oː s m iː
گرفتاری	ɡ ɾ ɪ f t̪ ɑː ɾ iː
سونگھ	s uː ŋ ɦ
پینل	p eː n l
مکل	m ʊ k l
ششی	ʃ ɪ ʃ iː
اینٹی	ʔ eː n ʈ iː
نذرآتش	n ɛː z ɾ ɑː t̪ ɪ ʃ
بیک	b eː k
انجنئیر	ɪ n d͡ʒ ɪ n ɪː ɾ
حرف	ɦ ɛː ɾ f
انسیت	ɪ n s iː t̪
حامدالاحمر	ɦ ɑː m ɪ d̪ ʔ ɑː l ɑː ɦ m ɛː ɾ
انگلانگ	ɪ ŋ g l ɑː ŋ g
الہی	ʔ ɛː l ɦ iː
موڈ	m oː d̪
بتایاکہ	b ɪ t̪ ɑː j ɑː k ɛː
باضابطہ	b ɑː z ɑː b ɪ t̪ ɦ ɑː
سلیکٹر	s ʊ l iː k ʈ ɛ ɾ
ٹھنڈا	ʈʰ ʊ n ɖ ɑː
شداد	ʃ ə d aː d̪
عاشق	ʕ aː ʃ ɪ q
پرابین	p ə ɾ aː b iː n
مربع	m ʊ ɾ b ɑː
برن	b ə ɾ n
معمول	m ʕ ə m uː l
اختیارکردہ	ə x t̪ iː j aː ɾ k ə ɾ d̪ ə ɦ
معلنہ	m ʕ ə l ə n ə ɦ
اخوت	ə x ʋ oː t̪
ڈیولس	ɖ iː oː l s
مایہ	m aː j ɦ
ابوعبدالرحمن	ə b ʊ ʕ ə b d̪ ə l ɾ ɑː ɦ m ə n
واریرس	ʋ aː ɾ iː ɾ s
مناسبت	m ə n aː s b ə t̪
واقفیت	ʋ aː q f iː t̪
سنجائے	s ʊ n d͡ʒ ɑː ɪ j eː
اثاثہ	ɪ s ɑː s ɑː
دیواستھانم	d̪ eː ʋ ɑː s t̪ʰ ɑː n ə m
مکواوگر	m a k ʋ ɑː ʋ ɡ ə ɾ
بورڈس	b ɔː ɾ d̪ s
پلانٹ	p l ɑː n ʈ
نصبین	n ə s b iː n
اورمعیاری	ɔː ɾ m a ɪ j ɑː ɾ iː
مکرجی	m a k ɾ d͡ʒ iː
بشیر	b ə ʃ iː ɾ
سہیل	s ə ɦ iː l
جاہی	d͡ʒ ɑː ɦ iː
صد	s ʊ d
بہادر	b ə ɦ ɑː d̪ ə ɾ
مچھرکش	m ʊ t͡ʃʰ ɾ k ɪ ʃ
پرجا	p ɛ ɾ d͡ʒ ɑː
در	d ɑː ɾ
بے۔چین	b eː t͡ʃ eː n
بجائے	b ʊ d͡ʒ aː ɪ ə
مہیب	m ʊ h iː b
تاریک	t aː r iː k
پراڈکٹ	p ɾ aː ɖ a k ʈ
بیٹھ	b eː ʈʰ
ڈاکٹر	ɖ ɑː k ʈ ə ɾ
سنجیدہ	s ʊ n d͡ʒ iː d a
شیپ	ʃ eː p
کلکٹر	k ʊ l k ʈ ɛ ɾ
کاج	k ɑː d͡ʒ
دستاویز	d ʊ s t aː ʋ iː z
پےنٹ	p eː n ʈ
پدماناتھن	p ʊ d m aː n aː tʰ n
ماتحت	m aː tʰ a t
مباحثہ	m ʊ b aː h a tʰ a
ایونٹ	ɑː j uː n ʈ
سمن	s ʊ m ə n
اختتام۔پزیر	ɑː x t̪ t̪ ɑː m p ə z iː ɾ
نبردآزما	n ə b ɾ d̪ ɑː z m ɑː
سلیور	s ʊ l j ɔː ɾ
نبی	n ə b iː
سندھو	s ɪ n d̪ʱ uː
اولیا	ɑː ʋ l iː ɑː
سوپراسٹار	s uː p ɾ ɑː s ʈ ɑː ɾ
ناٹ	n ɑː ʈ
سشما	s ʊ ʃ m ɑː
چھان	t͡ʃʰ ɑː n
فروری	f ə ɾ ʋ ə ɾ iː
یکساں	j ə k s ɑː n
مرکندہ	m ʊ ɾ k ə n d̪ ə
یونائیٹڈ	j uː n ɑː iː ʈ ɪ d̪
اناہزارے	ɪ n ɑː ɦ z ɑː ɾ eː
افریقہ	ɑː f r iː q ɑː
پیکلس	p eɪ k l s
مذاکرہ	m ʊ z ɑː k ə r ɑː
منسٹرس	m ə n s t ə r s
قطب	q ʊ t̪ b
پانچوں	p ɑː n t͡ʃ o
سبب	s ə b b
مسٹرڈ	m ʊ s t ə r d
فہد	f ə h d
یوسی	j oʊ s iː
فریدآباد	f ə r iː d ɑː b ɑː d
زکوا	z ə k ʋ ɑː
ہدیۂ	ɦ ə d iː ə
ریحان	r eɪ h ɑː n
ذ	z
بلی	b ə l iː
تیسری	t eː s r iː
فلک۔نما	f ɪ l k n ə m ɑː
بندیل	b ə n d iː l
تحقیقی	t̪ ə ɦ ə q iː q iː
شائق	ʃ ɑː ɪ q
کار	k ɑː ɾ
ہانگ	ɦ ɑː ŋ ɡ
سکتہ	s ə k t̪ ə
ڈومور	ɖ ʋ oː m ɔː ɾ
ڈر	ɖ ə ɾ
ترقی	t̪ ə ɾ q iː
سارا	s ɑː ɾ ɑː
خازن	x ɑː z ə n
امریکا	ɑː m ɾ iː k ɑː
خروش	x ɾ ʊ ʃ
دادا	d ɑː d ɑː
رضوی	ɾ ɪ z ʋ iː
مدعوئین	m ʊ d ʕ ʋ ɪː n
مفتی	m ʊ f t iː
شوقین	ʃ ʊ q iː n
راجیش	ɾ ɑː d͡ʒ iː ʃ
خالد	x ɑː l ɪ d̪
ناظرہ	n ɑː z ɪ ɾ ə
مقررہ	m ʊ q ɾ ɑː ɾ ə
مہارت	m ə ɦ ɑː ɾ ə t̪
مر	m ə ɾ
راما	ɾ ɑː m ɑː
گمبھی	ɡ ə m bʱ iː
سوٹ	s uː ʈ
مقتول	m ʊ q t̪ uː l
میٹنگ	m iː ʈ ɪ ŋ ɡ
ناگ	n ɑː ɡ
پاؤڈر	p ɑː ʊ ʈ ə ɾ
سل	s ə l
بادبان	b ɑː d̪ b ɑː n
پردیش	p ɾ ə d̪ iː ʃ
شرکا	ʃ ə ɾ k ɑː
چوراستہ	t͡ʃ ʊ ɾ ɑː s t̪ ə
وینیو	ʋ eɪ n iː uː
سیکریٹریٹ	s iː k r iː ʈ ə r iː ʈ
پانڈیچری	p ɑː n ɖ iː t͡ʃ ə r iː
آندھرائی	ɑː n d̪ʱ ə r ɑː iː
آیئنا	ɑː iː ə n ə
بشکل	b ʊ ʃ k ə l
ہجوم	h ə d͡ʒ oʊ m
ٹھیس	ʈʰ iː s
بےبس	b eɪ b ə s
نظریہ	n ə z ə r iː ə
دلائی	d ə l ɑː iː
سکھشا	s ə kʰ ʃ ɑː
ڈیولپمنٹ	ɖ iː oʊ l p m ə n ʈ
نکال	n ɪ k ɑː l
زراعت	z ə r ɑː ʕ ə t
اجتماعی	ɑː d͡ʒ t ɪ m ɑː ʕ iː
نجیب	n ə d͡ʒ iː b
انتخابی	ɪ n t̪ ɪ x ɑː b iː
آئے	ɑː ɪ ɛː
مودی	m uː d iː
نندی	n ə n d iː
ایذارسانی	ɛː ð ɑː ɾ s ɑː n iː
پلاٹس	p l ɑː ʈ s
منسٹرا	m ə n s ʈ ɾ ɑː
رائےدہندگان	ɾ ɑː ɪ d̪ ə ɦ ə n d̪ ɡ ɑː n
پل	p ə l
شکوہ	ʃ ɪ k ʋ ə ɦ
راؤنڈر	ɾ ɑː ʊ n ɖ ə ɾ
نتجہ	n ə t̪ d͡ʒ ə ɦ
اندر	ɪ n d̪ ə ɾ
بورن	b ɔː ɾ n
عنقاد	ʕ ɪ n q ɑː d̪
ہڑتالی	ɦ ə ɽ t̪ ɑː l iː
توں	t̪ ʊ n
پھیر	pʰ eː ɾ
