руферствам	r u fʲ ɪ r s t v ə m
обуваете	ɐ b ʊ v a j ɪ tʲ e
магнатов	m ɐ ɡ n a t ə f
багажниках	b ɐ ɡ a ʐ nʲ ɪ k ə x
вскриков	f s k rʲ i k ə f
платке	p ɫ ɐ t kʲ e
стилистика	sʲ tʲ ɪ lʲ i sʲ tʲ ɪ k ə
напоролся	n ə p ɐ r o ɫ s ⁽ʲ ⁾ ə
осатанеешь	ɐ s ə t ɐ nʲ e j ɪ ʂ
мяукала	mʲ ɪ u k ə ɫ ə
добреешь	d ɐ b rʲ e j ɪ ʂ
вляпался	v lʲ a p ə ɫ s ⁽ʲ ⁾ ə
божественны	b ɐ ʐ ɛ s t vʲ ɪ nː ɨ
фреске	f rʲ e s kʲ e
поступавшись	p ə s t ʊ p a f ʂ ɨ sʲ
прокалываешь	p r ɐ k a ɫ ɨ v ə j ɪ ʂ
бесполезный	bʲ ɪ s p ɐ lʲ e z n ɨ j
целлюлозным	t͡s ɨ lʲ ʊ ɫ o z n ɨ m
морфием	m o r fʲ ɪ j ɪ m
клонись	k ɫ ɐ nʲ i sʲ
позволяла	p ə z v ɐ lʲ a ɫ ə
допускаетесь	d ə p ʊ s k a j ɪ tʲ ɪ sʲ
продлеваю	p r ə d lʲ ɪ v a j ʊ
проскрипишь	p r ə s k rʲ ɪ pʲ i ʂ
очертенеете	ɐ t͡ɕ ɪ r tʲ ɪ nʲ e j ɪ tʲ e
горячностям	ɡ ɐ rʲ æ t͡ɕ n ə sʲ tʲ ə m
слонопотамам	s ɫ ə n ə p ɐ t a m ə m
надколеннике	n ə t k ɐ lʲ e nʲː ɪ kʲ e
перекликаем	pʲ ɪ rʲ ɪ k lʲ ɪ k a j ɪ m
насаждавши	n ə s ɐ ʐ d a f ʂ ɨ
умиришь	ʊ mʲ ɪ rʲ i ʂ
заступало	z ə s t ʊ p a ɫ ə
стукаясь	s t u k ə j ɪ sʲ
прыснет	p r ɨ sʲ nʲ ɪ t
метафизику	mʲ ɪ t ɐ fʲ i zʲ ɪ k ʊ
самсарою	s ɐ m s a r ə j ʊ
втыкаете	f t ɨ k a j ɪ tʲ e
троичный	t r o ɪ t͡ɕ n ɨ j
обсуждением	ɐ p s ʊ ʐ dʲ e nʲ ɪ j ɪ m
глаукома	ɡ ɫ ə ʊ k o m ə
обхватывав	ɐ p x v a t ɨ v ə f
слизняку	s ⁽ʲ ⁾ lʲ ɪ zʲ nʲ ɪ k u
предъявится	p rʲ ɪ d j æ vʲ ɪ t͡s ə
гитаристам	ɡʲ ɪ t ɐ rʲ i s t ə m
выкорчёвывайте	v ɨ k ɐ r t͡ɕ ɵ v ɨ v ə j tʲ e
скрепляешь	s k rʲ ɪ p lʲ æ j ɪ ʂ
походов	p ɐ x o d ə f
ухожено	ʊ x o ʐ ɨ n ə
присмотрев	p rʲ ɪ s m ɐ t rʲ e f
расторгла	r ɐ s t o r ɡ ɫ ə
предъявись	p rʲ ɪ d j ɪ vʲ i sʲ
гимназией	ɡʲ ɪ m n a zʲ ɪ j ɪ j
позавидуйте	p ə z ɐ vʲ i d ʊ j tʲ e
объевший	ɐ b j e f ʂ ɨ j
сластён	s ɫ ɐ sʲ tʲ ɵ n
синтетику	sʲ ɪ n t ɛ tʲ ɪ k ʊ
отсчётах	ɐ t͡ɕ ɕː ɵ t ə x
правоохранительный	p r a v ɐ ɐ x r ɐ nʲ i tʲ ɪ lʲ n ɨ j
порочили	p ɐ r o t͡ɕ ɪ lʲ ɪ
смешались	s mʲ ɪ ʂ a lʲ ɪ sʲ
барахтайся	b ɐ r a x t ə j sʲ ə
пионеру	pʲ ɪ ɐ nʲ e r ʊ
прояснениями	p r ə j ɪ sʲ nʲ e nʲ ɪ j ə mʲ ɪ
выясняешь	v ɨ j ɪ sʲ nʲ æ j ɪ ʂ
сопряжёшь	s ə p rʲ ɪ ʐ o ʂ
прикажу	p rʲ ɪ k ɐ ʐ u
эликсиром	ɪ lʲ ɪ k sʲ i r ə m
подкатить	p ə t k ɐ tʲ i tʲ
ручейке	r ʊ t͡ɕ ɪ j kʲ e
матрон	m ɐ t r o n
заглинизированности	z ə ɡ lʲ ɪ nʲ ɪ zʲ i r ə v ə nː ə sʲ tʲ ɪ
горестно	ɡ o rʲ ɪ s n ə
возобновись	v ə z ə b n ɐ vʲ i sʲ
сыроваров	s ɨ r ɐ v a r ə f
съязвил	s j ɪ z vʲ i ɫ
вальцом	v ɐ lʲ t͡s o m
назначит	n ɐ z n a t͡ɕ ɪ t
активизме	ɐ k tʲ ɪ vʲ i z mʲ e
множится	m n o ʐ ɨ t͡s ə
гобеленами	ɡ ə bʲ ɪ lʲ e n ə mʲ ɪ
подсолнухе	p ɐ t͡s s o ɫ n ʊ xʲ e
карайте	k ɐ r a j tʲ e
подзаголовков	p ə d͡z z ə ɡ ɐ ɫ o f k ə f
затирав	z ə tʲ ɪ r a f
комик	k o mʲ ɪ k
надушу	n ə d ʊ ʂ u
жертву	ʐ ɛ r t v ʊ
молилась	m ɐ lʲ i ɫ ə sʲ
альбоме	ɐ lʲ b o mʲ e
приползать	p rʲ ɪ p ɐ ɫ z a tʲ
крякав	k rʲ a k ə f
описаешь	ɐ pʲ i s ə j ɪ ʂ
мессою	mʲ e sː ə j ʊ
курируйте	k ʊ rʲ i r ʊ j tʲ e
веселеешь	vʲ ɪ sʲ ɪ lʲ e j ɪ ʂ
повстанцами	p ɐ f s t a n t͡s ə mʲ ɪ
анемоном	ɐ nʲ ɪ m o n ə m
садит	s a dʲ ɪ t
копчений	k ɐ p t͡ɕ e nʲ ɪ j
лейкозом	lʲ ɪ j k o z ə m
сигнализации	sʲ ɪ ɡ n ə lʲ ɪ z a t͡s ɨ ɪ
надувающийся	n ə d ʊ v a j ʉ ɕː ɪ j sʲ ə
бривший	b rʲ i f ʂ ɨ j
похваляет	p ə x v ɐ lʲ æ j ɪ t
отяжелеть	ɐ tʲ ɪ ʐ ɨ lʲ e tʲ
чардаша	t͡ɕ a r d ə ʂ ə
полуторку	p ɐ ɫ u t ə r k ʊ
проститутки	p r ə sʲ tʲ ɪ t u t kʲ ɪ
снашивала	s n a ʂ ɨ v ə ɫ ə
поторопятся	p ə t ɐ r o pʲ ə t͡s ə
утопят	ʊ t o pʲ ə t
ознаменовав	ɐ z n ə mʲ ɪ n ɐ v a f
закричали	z ə k rʲ ɪ t͡ɕ æ lʲ ɪ
ликбезам	lʲ ɪ ɡ bʲ e z ə m
диктор	dʲ i k t ə r
грязнувший	ɡ rʲ a z n ʊ f ʂ ɨ j
ожирела	ɐ ʐ ɨ rʲ e ɫ ə
рухните	r u x nʲ ɪ tʲ e
сатирах	s ɐ tʲ i r ə x
статейкой	s t ɐ tʲ e j k ə j
торговцы	t ɐ r ɡ o f t͡s ɨ
искусите	ɪ s k ʊ sʲ i tʲ e
соучастниц	s ə ʊ t͡ɕ æ sʲ nʲ ɪ t͡s
кличьте	k lʲ i t͡ɕ tʲ e
фокстерьерах	f ə k s t ɨ rʲ j e r ə x
дожах	d o ʐ ə x
политологиям	p ə lʲ ɪ t ɐ ɫ o ɡʲ ɪ j ə m
монголом	m ɐ n ɡ o ɫ ə m
ранкам	r a n k ə m
перигея	pʲ ɪ rʲ ɪ ɡʲ e j ə
нуворишам	n ʊ v ɐ rʲ i ʂ ə m
пронюхиваете	p r ɐ nʲ ʉ xʲ ɪ v ə j ɪ tʲ e
клеивший	k lʲ e ɪ f ʂ ɨ j
жёрнов	ʐ o r n ə f
опушалась	ɐ p ʊ ʂ a ɫ ə sʲ
порок	p o r ə k
говорунам	ɡ ə v ə r ʊ n a m
дорывавшийся	d ə r ɨ v a f ʂ ɨ j sʲ ə
киножурналами	kʲ ɪ n ə ʐ ʊ r n a ɫ ə mʲ ɪ
сравнивая	s r a v nʲ ɪ v ə j ə
уладим	ʊ ɫ a dʲ ɪ m
доводят	d ɐ v o dʲ ə t
стерпеть	sʲ tʲ ɪ r pʲ e tʲ
палеографиям	p ə lʲ ɪ ɐ ɡ r a fʲ ɪ j ə m
ссужал	sː ʊ ʐ a ɫ
адмиралов	ɐ d mʲ ɪ r a ɫ ə f
наколют	n ɐ k o lʲ ʊ t
выбравши	v ɨ b r ə f ʂ ɨ
обгорают	ɐ b ɡ ɐ r a j ʊ t
тирамису	tʲ ɪ r ə mʲ ɪ s u
предамся	p rʲ ɪ d a m sʲ ə
напротив	n ɐ p r o tʲ ɪ f
выигрывают	v ɨ i ɡ r ɨ v ə j ʊ t
пырнёшь	p ɨ r nʲ ɵ ʂ
разъём	r ɐ z j ɵ m
выписал	v ɨ pʲ ɪ s ə ɫ
изготовителями	ɪ z ɡ ə t ɐ vʲ i tʲ ɪ lʲ ə mʲ ɪ
топазу	t ɐ p a z ʊ
состряпаете	s ɐ s t rʲ a p ə j ɪ tʲ e
ниточками	nʲ i t ə t͡ɕ k ə mʲ ɪ
великодушием	vʲ ɪ lʲ ɪ k ɐ d u ʂ ɨ j ɪ m
флексийный	f lʲ ɪ k sʲ i j n ɨ j
гомони	ɡ ə m ɐ nʲ i
патрульному	p ɐ t r u lʲ n ə m ʊ
плавкою	p ɫ a f k ə j ʊ
деревяшкой	dʲ ɪ rʲ ɪ vʲ a ʂ k ə j
орешь	o rʲ ɪ ʂ
соборяне	s ə b ɐ rʲ æ nʲ e
перелётом	pʲ ɪ rʲ ɪ lʲ ɵ t ə m
секта	sʲ e k t ə
реквизициями	rʲ ɪ k vʲ ɪ zʲ i t͡s ɨ j ə mʲ ɪ
вкладывают	f k ɫ a d ɨ v ə j ʊ t
укутавши	ʊ k u t ə f ʂ ɨ
амбра	a m b r ə
поносят	p ɐ n o sʲ ə t
отображу	ɐ t ə b r ɐ ʐ u
пересказываем	pʲ ɪ rʲ ɪ s k a z ɨ v ə j ɪ m
вкрадывалась	f k r a d ɨ v ə ɫ ə sʲ
маршировали	m ə r ʂ ɨ r ɐ v a lʲ ɪ
воскрешаешь	v ə s k rʲ ɪ ʂ a j ɪ ʂ
аскетом	ɐ s kʲ e t ə m
костницей	k o sʲ nʲ ɪ t͡s ɨ j
моавитянине	m ɐ ɐ vʲ i tʲ ɪ nʲ ɪ nʲ e
преуспеете	p rʲ ɪ ʊ s pʲ e j ɪ tʲ e
муруй	m ʊ r u j
вздорожании	v z d ə r ɐ ʐ a nʲ ɪ ɪ
шхун	ʂ x u n
катране	k ɐ t r a nʲ e
экспансия	ɪ k s p a n ⁽ʲ ⁾ sʲ ɪ j ə
шутим	ʂ u tʲ ɪ m
восприняла	v ə s p rʲ ɪ nʲ ɪ ɫ a
взвинчивал	v z vʲ i nʲ t͡ɕ ɪ v ə ɫ
государственникам	ɡ ə s ʊ d a r s t vʲ ɪ nʲː ɪ k ə m
мнений	m nʲ e nʲ ɪ j
укреплений	ʊ k rʲ ɪ p lʲ e nʲ ɪ j
пожирает	p ə ʐ ɨ r a j ɪ t
отчаливала	ɐ t͡ɕː æ lʲ ɪ v ə ɫ ə
полемику	p ɐ lʲ e mʲ ɪ k ʊ
клетку	k lʲ e t k ʊ
сморкая	s m ɐ r k a j ə
нормированиями	n ɐ r mʲ i r ə v ə nʲ ɪ j ə mʲ ɪ
плацента	p ɫ ɐ t͡s ɛ n t ə
жутями	ʐ u tʲ ə mʲ ɪ
ларьках	ɫ ɐ rʲ k a x
выстелите	v ɨ sʲ tʲ ɪ lʲ ɪ tʲ e
трактуете	t r ɐ k t u j ɪ tʲ e
анфилады	ɐ n fʲ ɪ ɫ a d ɨ
отправками	ɐ t p r a f k ə mʲ ɪ
дубу	d u b ʊ
вертунах	vʲ ɪ r t ʊ n a x
покладая	p ə k ɫ ɐ d a j ə
нику	nʲ i k ʊ
расстилавши	r ə sʲː tʲ ɪ ɫ a f ʂ ɨ
басом	b a s ə m
рисовал	rʲ ɪ s ɐ v a ɫ
склеило	s k lʲ e ɪ ɫ ə
открестившись	ɐ t k rʲ ɪ sʲ tʲ i f ʂ ɨ sʲ
претенденткою	p rʲ ɪ tʲ ɪ nʲ dʲ e n t k ə j ʊ
откашлявшись	ɐ t k a ʂ lʲ ɪ f ʂ ɨ sʲ
вцепляйтесь	f t͡s ɨ p lʲ æ j tʲ ɪ sʲ
халатикам	x ɐ ɫ a tʲ ɪ k ə m
семяизвержении	sʲ ɪ mʲ ɪ ɪ z vʲ ɪ r ʐ ɛ nʲ ɪ ɪ
угасла	ʊ ɡ a s ɫ ə
сраженью	s r ɐ ʐ ɛ nʲ j ʊ
пальбой	p ɐ lʲ b o j
базаря	b ɐ z a rʲ ə
выпускается	v ɨ p ʊ s k a j ɪ t͡s ə
оттаяло	ɐ tː a j ɪ ɫ ə
дискетах	dʲ ɪ s kʲ e t ə x
чревоугодиям	t͡ɕ rʲ ɪ v ə ʊ ɡ o dʲ ɪ j ə m
облепляемый	ɐ b lʲ ɪ p lʲ æ j ɪ m ɨ j
отбавлявший	ɐ d b ɐ v lʲ a f ʂ ɨ j
просушивать	p r ɐ s u ʂ ɨ v ə tʲ
тонею	t o nʲ ɪ j ʊ
затрудни	z ə t r ʊ dʲ nʲ i
факельщиков	f a kʲ ɪ lʲ ɕː ɪ k ə f
фотонов	f ɐ t o n ə f
артистке	ɐ r tʲ i s t kʲ e
провзаимодействуешь	p r ə v z ɐ i m ɐ dʲ e j s t v ʊ j ɪ ʂ
обнажите	ɐ b n ɐ ʐ ɨ tʲ e
забредают	z ə b rʲ ɪ d a j ʊ t
перегрелись	pʲ ɪ rʲ ɪ ɡ rʲ e lʲ ɪ sʲ
истеки	ɪ sʲ tʲ ɪ kʲ i
присудим	p rʲ ɪ s u dʲ ɪ m
краба	k r a b ə
дотаскаешь	d ə t ɐ s k a j ɪ ʂ
мужененавистничествам	m ʊ ʐ ɨ nʲ ɪ n ɐ vʲ i sʲ nʲ ɪ t͡ɕ ɪ s t v ə m
щипая	ɕː ɪ p a j ə
хождении	x ɐ ʐ dʲ e nʲ ɪ ɪ
заботитесь	z ɐ b o tʲ ɪ tʲ ɪ sʲ
девайсам	dʲ ɪ v a j s ə m
заседатели	z ə sʲ ɪ d a tʲ ɪ lʲ ɪ
обусловили	ɐ b ʊ s ɫ o vʲ ɪ lʲ ɪ
котдивуарцев	k o dʲː ɪ v ʊ a r t͡s ɨ f
интерферометра	ɪ n t ɨ r fʲ ɪ r o mʲ ɪ t r ə
маскировкою	m ə s kʲ ɪ r o f k ə j ʊ
сопела	s ɐ pʲ e ɫ ə
подрастай	p ə d r ɐ s t a j
одиннадцатилетиям	ɐ dʲ i n ə t͡sː ɨ tʲ ɪ lʲ e tʲ ɪ j ə m
матраца	m ɐ t r a t͡s ə
зажарят	z ɐ ʐ a rʲ ə t
назначении	n ə z n ɐ t͡ɕ e nʲ ɪ ɪ
панграммами	p ɐ n ɡ r a mː ə mʲ ɪ
взбегав	v z bʲ ɪ ɡ a f
челнок	t͡ɕ ɪ ɫ n o k
выпустимся	v ɨ p ʊ sʲ tʲ ɪ m sʲ ə
опьянением	ɐ p ⁽ʲ ⁾ j ɪ nʲ e nʲ ɪ j ɪ m
блумфонтейн	b ɫ u m f ə n t ɨ j n
растащим	r ɐ s t a ɕː ɪ m
проверяй	p r ə vʲ ɪ rʲ æ j
ворочанный	v ɐ r o t͡ɕ ɪ nː ɨ j
надававший	n ə d ɐ v a f ʂ ɨ j
бодаем	b ɐ d a j ɪ m
шаромыгами	ʂ ə r ɐ m ɨ ɡ ə mʲ ɪ
беляев	bʲ ɪ lʲ æ j ɪ f
постыло	p ɐ s t ɨ ɫ ə
сожитию	s ɐ ʐ ɨ tʲ ɪ j ʊ
мобилизовав	m ə bʲ ɪ lʲ ɪ z ɐ v a f
понудь	p ɐ n u tʲ
исключился	ɪ s k lʲ ʉ t͡ɕ i ɫ s ⁽ʲ ⁾ ə
четверостишиями	t͡ɕ ɪ t vʲ ɪ r ɐ sʲ tʲ i ʂ ɨ j ə mʲ ɪ
черкать	t͡ɕ ɪ r k a tʲ
теряет	tʲ ɪ rʲ æ j ɪ t
уславший	ʊ s ɫ a f ʂ ɨ j
рашпером	r a ʂ pʲ ɪ r ə m
цингою	t͡s ɨ n ɡ o j ʊ
чулок	t͡ɕ ʊ ɫ o k
граммами	ɡ r a m ə mʲ ɪ
подтягиваюсь	p ɐ tʲː æ ɡʲ ɪ v ə j ʉ sʲ
пастеризациею	p ə s t ɨ rʲ ɪ z a t͡s ɨ j ɪ j ʊ
ромашкою	r ɐ m a ʂ k ə j ʊ
изжогах	ɪ ʐː o ɡ ə x
ошарашиваете	ɐ ʂ ɐ r a ʂ ɨ v ə j ɪ tʲ e
весельчаках	vʲ ɪ sʲ ɪ lʲ t͡ɕ ɪ k a x
каптенармусе	k ə p t ɨ n a r m ʊ sʲ e
производительности	p r ə ɪ z v ɐ dʲ i tʲ ɪ lʲ n ə sʲ tʲ ɪ
осушал	ɐ s ʊ ʂ a ɫ
парижане	p ə rʲ ɪ ʐ a nʲ e
трепыхаемся	t rʲ ɪ p ɨ x a j ɪ m sʲ ə
бредим	b rʲ e dʲ ɪ m
стуке	s t u kʲ e
фотоном	f ɐ t o n ə m
финансировало	fʲ ɪ n ɐ n ⁽ʲ ⁾ sʲ i r ə v ə ɫ ə
жажда	ʐ a ʐ d ə
абсорбатам	ɐ p s ɐ r b a t ə m
усложняем	ʊ s ɫ ɐ ʐ nʲ æ j ɪ m
окисью	o kʲ ɪ sʲ j ʊ
спросите	s p r o sʲ ɪ tʲ e
соломами	s ɐ ɫ o m ə mʲ ɪ
хачике	x a t͡ɕ ɪ kʲ e
заперлись	z a pʲ ɪ r lʲ ɪ sʲ
знаменованный	z n ə mʲ ɪ n o v ə nː ɨ j
поспешивший	p ə s pʲ ɪ ʂ ɨ f ʂ ɨ j
опохмелившийся	ɐ p ə x mʲ ɪ lʲ i f ʂ ɨ j sʲ ə
нацеливаясь	n ɐ t͡s ɛ lʲ ɪ v ə j ɪ sʲ
цыплятами	t͡s ɨ p lʲ a t ə mʲ ɪ
кастрировав	k ɐ s t rʲ i r ə v ə f
турой	t ʊ r o j
дающийся	d ɐ j ʉ ɕː ɪ j sʲ ə
закипятив	z ə kʲ ɪ pʲ ɪ tʲ i f
адоптировавшийся	ɐ d ɐ p tʲ i r ə v ə f ʂ ɨ j sʲ ə
выводкам	v ɨ v ə t k ə m
бодрства	b o d r s t v ə
храмы	x r a m ɨ
озадаченный	ɐ z ɐ d a t͡ɕ ɪ nː ɨ j
принятий	p rʲ ɪ nʲ æ tʲ ɪ j
загораживала	z ə ɡ ɐ r a ʐ ɨ v ə ɫ ə
растревоживают	r ə s t rʲ ɪ v o ʐ ɨ v ə j ʊ t
пойл	p o j ɫ
взыскиваете	v z ɨ s kʲ ɪ v ə j ɪ tʲ e
реабилитируем	rʲ ɪ ə bʲ ɪ lʲ ɪ tʲ i r ʊ j ɪ m
распознаешь	r ə s p ɐ z n a j ɪ ʂ
сопутствую	s ɐ p u t͡s t v ʊ j ʊ
генофонда	ɡʲ ɪ n ɐ f o n d ə
высь	v ɨ sʲ
сокращало	s ə k r ɐ ɕː a ɫ ə
приземлявшийся	p rʲ ɪ zʲ ɪ m lʲ a f ʂ ɨ j sʲ ə
спор	s p o r
водяного	v ə dʲ ɪ n o v ə
аккомпанировали	ɐ k ə m p ɐ nʲ i r ə v ə lʲ ɪ
оттащила	ɐ tː ɐ ɕː i ɫ ə
каннибалами	k ə nʲ ɪ b a ɫ ə mʲ ɪ
смолкнет	s m o ɫ k nʲ ɪ t
служеньям	s ɫ ʊ ʐ ɛ nʲ j ə m
перестройка	pʲ ɪ rʲ ɪ s t r o j k ə
осклабляю	ɐ s k ɫ ɐ b lʲ æ j ʊ
ресторанчик	rʲ ɪ s t ɐ r a nʲ t͡ɕ ɪ k
упоениям	ʊ p ɐ j e nʲ ɪ j ə m
подпорка	p ɐ t p o r k ə
отёртый	ɐ tʲ ɵ r t ɨ j
дозванивайтесь	d ɐ z v a nʲ ɪ v ə j tʲ ɪ sʲ
плодился	p ɫ ɐ dʲ i ɫ s ⁽ʲ ⁾ ə
задумках	z ɐ d u m k ə x
наперстянок	n ə pʲ ɪ r s ⁽ʲ ⁾ tʲ a n ə k
бесило	bʲ ɪ sʲ i ɫ ə
вавилонянами	v ə vʲ ɪ ɫ o nʲ ɪ n ə mʲ ɪ
закономерностями	z ə k ə n ɐ mʲ e r n ə sʲ tʲ ə mʲ ɪ
сходит	s x o dʲ ɪ t
отставший	ɐ t͡s s t a f ʂ ɨ j
преобразовывавшийся	p rʲ ɪ ə b r ɐ z o v ɨ v ə f ʂ ɨ j sʲ ə
навек	n ɐ vʲ e k
разбушевались	r ə z b ʊ ʂ ɨ v a lʲ ɪ sʲ
разведка	r ɐ z vʲ e t k ə
бузотёрами	b ʊ z ɐ tʲ ɵ r ə mʲ ɪ
тенёта	tʲ ɪ nʲ ɵ t ə
силуэты	sʲ ɪ ɫ ʊ ɛ t ɨ
створяло	s t v ɐ rʲ a ɫ ə
орграфами	ɐ r ɡ r a f ə mʲ ɪ
цесарем	t͡s ɛ s ə rʲ ɪ m
амилазой	ɐ mʲ ɪ ɫ a z ə j
систола	sʲ i s t ə ɫ ə
шпагах	ʂ p a ɡ ə x
опосредуемый	ɐ p ɐ s rʲ e d ʊ j ɪ m ɨ j
диссонансами	dʲ ɪ sː ɐ n a n s ə mʲ ɪ
проткнём	p r ɐ t k nʲ ɵ m
буксы	b u k s ɨ
включав	f k lʲ ʉ t͡ɕ a f
антикварках	ɐ nʲ tʲ ɪ k v a r k ə x
леях	lʲ e j ə x
додумаешься	d ɐ d u m ə j ɪ ʂ sʲ ə
льнам	lʲ n a m
хуярил	x ʊ j æ rʲ ɪ ɫ
полился	p ɐ lʲ i ɫ s ⁽ʲ ⁾ ə
сплетавшийся	s p lʲ ɪ t a f ʂ ɨ j sʲ ə
похоронят	p ə x ɐ r o nʲ ə t
районах	r ɐ j ɵ n ə x
дарвиниста	d ə r vʲ ɪ nʲ i s t ə
ушибитесь	ʊ ʂ ɨ bʲ i tʲ ɪ sʲ
рассказало	r ə s k ɐ z a ɫ ə
остряках	ɐ s t rʲ ɪ k a x
луиджи	ɫ ʊ i d͡ʐ ʐ ɨ
строганый	s t r o ɡ ə n ɨ j
умились	ʊ mʲ ɪ lʲ i sʲ
зарвёшься	z ɐ r vʲ ɵ ʂ sʲ ə
микросхемы	mʲ ɪ k r ɐ s xʲ e m ɨ
воспев	v ɐ s pʲ e f
горнилу	ɡ ɐ r nʲ i ɫ ʊ
номинирует	n ə mʲ ɪ nʲ i r ʊ j ɪ t
мановении	m ə n ɐ vʲ e nʲ ɪ ɪ
наполняя	n ə p ɐ ɫ nʲ æ j ə
перетекли	pʲ ɪ rʲ ɪ tʲ ɪ k lʲ i
октябрь	ɐ k tʲ a b rʲ
осечкам	ɐ sʲ e t͡ɕ k ə m
чокаешься	t͡ɕ ɵ k ə j ɪ ʂ sʲ ə
обуреваешь	ɐ b ʊ rʲ ɪ v a j ɪ ʂ
заняло	z a nʲ ɪ ɫ ə
помойкою	p ɐ m o j k ə j ʊ
постираете	p ə sʲ tʲ ɪ r a j ɪ tʲ e
ломаку	ɫ ɐ m a k ʊ
разговлялись	r ə z ɡ ɐ v lʲ æ lʲ ɪ sʲ
несбыточный	nʲ ɪ z b ɨ t ə t͡ɕ n ɨ j
доброжелательностями	d ə b r ə ʐ ɨ ɫ a tʲ ɪ lʲ n ə sʲ tʲ ə mʲ ɪ
проговоримся	p r ə ɡ ə v ɐ rʲ i m sʲ ə
накалывать	n ɐ k a ɫ ɨ v ə tʲ
ментом	mʲ ɪ n t o m
людях	lʲ ʉ dʲ ə x
смещаем	s mʲ ɪ ɕː æ j ɪ m
бисексуал	bʲ ɪ s ɨ k s ʊ a ɫ
всхлипываниями	f s x lʲ i p ɨ v ə nʲ ɪ j ə mʲ ɪ
дождичкам	d o ʐ dʲ ɪ t͡ɕ k ə m
обжа	o b ʐ ə
убирайте	ʊ bʲ ɪ r a j tʲ e
выразивший	v ɨ r ə zʲ ɪ f ʂ ɨ j
рогачу	r ə ɡ ɐ t͡ɕ u
доработавши	d ə r ɐ b o t ə f ʂ ɨ
обрабатывают	ɐ b r ɐ b a t ɨ v ə j ʊ t
козлищ	k o z ⁽ʲ ⁾ lʲ ɪ ɕː
портупей	p ə r t ʊ pʲ e j
слюней	s ⁽ʲ ⁾ lʲ ʉ nʲ e j
единомышленников	j ɪ dʲ ɪ n ɐ m ɨ ʂ lʲ ɪ nʲː ɪ k ə f
зачитывайся	z ɐ t͡ɕ i t ɨ v ə j sʲ ə
выдумками	v ɨ d ʊ m k ə mʲ ɪ
чувствуйте	t͡ɕ u s t v ʊ j tʲ e
абсолютистах	ɐ p s ə lʲ ʉ tʲ i s t ə x
презрел	p rʲ ɪ z rʲ e ɫ
девальвации	d ɨ v ɐ lʲ v a t͡s ɨ ɪ
перевешивай	pʲ ɪ rʲ ɪ vʲ e ʂ ɨ v ə j
воспроизводивший	v ə s p r ə ɪ z v ɐ dʲ i f ʂ ɨ j
жадала	ʐ ɐ d a ɫ ə
паркуюсь	p ɐ r k u j ʉ sʲ
транслитерацией	t r ə n s ⁽ʲ ⁾ lʲ ɪ tʲ ɪ r a t͡s ɨ j ɪ j
эстонского	ɪ s t o n s k ə v ə
виноградинами	vʲ ɪ n ɐ ɡ r a dʲ ɪ n ə mʲ ɪ
утком	ʊ t k o m
капишон	k ə pʲ ɪ ʂ o n
поведениям	p ə vʲ ɪ dʲ e nʲ ɪ j ə m
вредоносу	v rʲ ɪ d ɐ n o s ʊ
бестолочь	bʲ e s t ə ɫ ə t͡ɕ
хост	x o s t
корзна	k o r z n ə
разговорись	r ə z ɡ ə v ɐ rʲ i sʲ
лесотундрой	lʲ e s ɐ t u n d r ə j
ёбанная	j ɵ b ə nː ə j ə
раскраской	r ɐ s k r a s k ə j
подмигивай	p ɐ d mʲ i ɡʲ ɪ v ə j
окупленный	ɐ k u p lʲ ɪ nː ɨ j
поразительны	p ə r ɐ zʲ i tʲ ɪ lʲ n ɨ
гектоваттов	ɡʲ ɪ k t ɐ v a t ə f
ухаживают	ʊ x a ʐ ɨ v ə j ʊ t
загорались	z ə ɡ ɐ r a lʲ ɪ sʲ
генералитете	ɡʲ ɪ nʲ ɪ r ə lʲ ɪ tʲ e tʲ e
долбануть	d ə ɫ b ɐ n u tʲ
волокут	v ə ɫ ɐ k u t
зачислявши	z ə t͡ɕ ɪ s ⁽ʲ ⁾ lʲ a f ʂ ɨ
коверкаемый	k ɐ vʲ e r k ə j ɪ m ɨ j
хорошей	x ɐ r o ʂ ɨ j
завораживать	z ə v ɐ r a ʐ ɨ v ə tʲ
попадётся	p ə p ɐ dʲ ɵ t͡sː ə
пронюхивала	p r ɐ nʲ ʉ xʲ ɪ v ə ɫ ə
угощениях	ʊ ɡ ɐ ɕː e nʲ ɪ j ə x
удавался	ʊ d ɐ v a ɫ s ⁽ʲ ⁾ ə
рейхстагу	r ɨ j x s t a ɡ ʊ
вселить	f sʲ ɪ lʲ i tʲ
баржу	b a r ʐ ʊ
афрофобиею	ɐ f r ɐ f o bʲ ɪ j ɪ j ʊ
краеведы	k r ə j ɪ vʲ e d ɨ
серологию	sʲ ɪ r ɐ ɫ o ɡʲ ɪ j ʊ
засосов	z ɐ s o s ə f
монотонность	m ə n ɐ t o nː ə sʲ tʲ
подлокотником	p ə d ɫ ɐ k o tʲ nʲ ɪ k ə m
терапии	tʲ ɪ r ɐ pʲ i ɪ
изобарою	ɪ z ɐ b a r ə j ʊ
причинив	p rʲ ɪ t͡ɕ ɪ nʲ i f
замечается	z ə mʲ ɪ t͡ɕ æ j ɪ t͡s ə
гирям	ɡʲ i rʲ ə m
вкалывая	f k a ɫ ɨ v ə j ə
кольчугами	k ɐ lʲ t͡ɕ u ɡ ə mʲ ɪ
сближает	z b lʲ ɪ ʐ a j ɪ t
зацеплять	z ə t͡s ɨ p lʲ æ tʲ
горячностей	ɡ ɐ rʲ æ t͡ɕ n ə sʲ tʲ ɪ j
доросли	d ə r ɐ s ⁽ʲ ⁾ lʲ i
недоедавший	nʲ ɪ d ə j ɪ d a f ʂ ɨ j
благоустрой	b ɫ ə ɡ ə ʊ s t r o j
именуй	ɪ mʲ ɪ n u j
колледж	k o lʲ ɪ t͡ʂ ʂ
завываете	z ə v ɨ v a j ɪ tʲ e
буханке	b ʊ x a n kʲ e
полонян	p ə ɫ ɐ nʲ a n
прокалывает	p r ɐ k a ɫ ɨ v ə j ɪ t
приписать	p rʲ ɪ pʲ ɪ s a tʲ
тыква	t ɨ k v ə
украшу	ʊ k r a ʂ ʊ
инактивирую	ɪ n ə k tʲ ɪ vʲ i r ʊ j ʊ
отпускавши	ɐ t p ʊ s k a f ʂ ɨ
библиотекарша	bʲ ɪ b lʲ ɪ ɐ tʲ e k ə r ʂ ə
писателями	pʲ ɪ s a tʲ ɪ lʲ ə mʲ ɪ
обтёсывают	ɐ p tʲ ɵ s ɨ v ə j ʊ t
ворвитесь	v ɐ r vʲ i tʲ ɪ sʲ
рабский	r a p s kʲ ɪ j
красавчик	k r ɐ s a f t͡ɕ ɪ k
выправка	v ɨ p r ə f k ə
сгущаюсь	z ɡ ʊ ɕː æ j ʉ sʲ
мораторий	m ə r ɐ t o rʲ ɪ j
сформулировал	s f ə r m ʊ lʲ i r ə v ə ɫ
епархия	j ɪ p a r xʲ ɪ j ə
запричитаешь	z ə p rʲ ɪ t͡ɕ ɪ t a j ɪ ʂ
припоминаешь	p rʲ ɪ p ə mʲ ɪ n a j ɪ ʂ
прозвучишь	p r ə z v ʊ t͡ɕ i ʂ
мироточцами	mʲ ɪ r ɐ t o t͡ɕ t͡s ə mʲ ɪ
тюльпана	tʲ ʉ lʲ p a n ə
комендатуре	k ə mʲ ɪ n d ɐ t u rʲ e
осечётесь	ɐ sʲ ɪ t͡ɕ ɵ tʲ ɪ sʲ
ситами	sʲ i t ə mʲ ɪ
надоедания	n ə d ə j ɪ d a nʲ ɪ j ə
съедутся	s j e d ʊ t͡s ə
затмениях	z ɐ t mʲ e nʲ ɪ j ə x
клирошанам	k lʲ ɪ r ɐ ʂ a n ə m
отработайте	ɐ t r ɐ b o t ə j tʲ e
раздумывал	r ɐ z d u m ɨ v ə ɫ
урезавший	ʊ rʲ e z ə f ʂ ɨ j
промокай	p r ə m ɐ k a j
ласково	ɫ a s k ə v ə
усмехаясь	ʊ s mʲ ɪ x a j ɪ sʲ
мейтнериев	mʲ ɪ j tʲ nʲ e rʲ ɪ j ɪ f
осуждённый	ɐ s ʊ ʐ dʲ ɵ nː ɨ j
употребляли	ʊ p ə t rʲ ɪ b lʲ æ lʲ ɪ
расстраивался	r ɐ sː t r a ɪ v ə ɫ s ⁽ʲ ⁾ ə
разуметь	r ə z ʊ mʲ e tʲ
крылышке	k r ɨ ɫ ɨ ʂ kʲ e
окошечек	ɐ k o ʂ ɨ t͡ɕ ɪ k
буревестника	b ʊ rʲ ɪ vʲ e sʲ nʲ ɪ k ə
бесплодны	bʲ ɪ s p ɫ o d n ɨ
предводителя	p rʲ ɪ d v ɐ dʲ i tʲ ɪ lʲ ə
переиграть	pʲ ɪ rʲ ɪ ɪ ɡ r a tʲ
харь	x a rʲ
тын	t ɨ n
перечтём	pʲ ɪ rʲ ɪ t͡ɕ tʲ ɵ m
наносивший	n ə n ɐ sʲ i f ʂ ɨ j
крошенный	k r o ʂ ɨ nː ɨ j
нелепиц	nʲ ɪ lʲ e pʲ ɪ t͡s
разглядите	r ə z ɡ lʲ ɪ dʲ i tʲ e
обугливала	ɐ b u ɡ lʲ ɪ v ə ɫ ə
оцепеней	ɐ t͡s ɨ pʲ ɪ nʲ e j
столбами	s t ɐ ɫ b a mʲ ɪ
похвалю	p ə x v ɐ lʲ u
нагрузка	n ɐ ɡ r u s k ə
выдёргивай	v ɨ dʲ ɵ r ɡʲ ɪ v ə j
текил	tʲ ɪ kʲ i ɫ
салфеточкам	s ɐ ɫ fʲ e t ə t͡ɕ k ə m
употребляюсь	ʊ p ə t rʲ ɪ b lʲ æ j ʉ sʲ
очаг	ɐ t͡ɕ a k
лизнув	lʲ ɪ z n u f
пристрастимся	p rʲ ɪ s t r ɐ sʲ tʲ i m sʲ ə
разобьёшься	r ə z ɐ b ⁽ʲ ⁾ j ɵ ʂ sʲ ə
фурфуролу	f ʊ r f ʊ r o ɫ ʊ
дождливый	d ɐ ʐ d lʲ i v ɨ j
лагуну	ɫ ɐ ɡ u n ʊ
заблагорассудим	z ə b ɫ ə ɡ ə r ɐ sː u dʲ ɪ m
яду	j a d ʊ
придавливало	p rʲ ɪ d a v lʲ ɪ v ə ɫ ə
поощряв	p ɐ ɐ ɕː rʲ a f
маразмы	m ɐ r a z m ɨ
обрести	ɐ b rʲ ɪ sʲ tʲ i
гудела	ɡ ʊ dʲ e ɫ ə
разработалась	r ə z r ɐ b o t ə ɫ ə sʲ
верующим	vʲ e r ʊ j ʉ ɕː ɪ m
помышляем	p ə m ɨ ʂ lʲ æ j ɪ m
молодят	m ə ɫ ɐ dʲ a t
украдёшь	ʊ k r ɐ dʲ ɵ ʂ
предприемлите	p rʲ ɪ t p rʲ ɪ j e m lʲ ɪ tʲ e
эполетом	ɪ p ɐ lʲ e t ə m
волчку	v ɐ ɫ t͡ɕ k u
дрожанию	d r ɐ ʐ a nʲ ɪ j ʊ
увозов	ʊ v o z ə f
привязь	p rʲ i vʲ ɪ sʲ
пиву	pʲ i v ʊ
поруководи	p ə r ʊ k ə v ɐ dʲ i
поручительством	p ə r ʊ t͡ɕ i tʲ ɪ lʲ s t v ə m
отводилась	ɐ t v ɐ dʲ i ɫ ə sʲ
проговаривалось	p r ə ɡ ɐ v a rʲ ɪ v ə ɫ ə sʲ
тарантулом	t ɐ r a n t ʊ ɫ ə m
кусаем	k ʊ s a j ɪ m
покрученный	p ɐ k r u t͡ɕ ɪ nː ɨ j
инет	ɪ n ɛ t
оподельдока	ɐ p ə d ɨ lʲ d o k ə
стоил	s t o ɪ ɫ
рутиною	r ʊ tʲ i n ə j ʊ
запросят	z ɐ p r o sʲ ə t
исчезавший	ɪ ɕ t͡ɕ ɪ z a f ʂ ɨ j
разрушились	r ɐ z r u ʂ ɨ lʲ ɪ sʲ
копеечкою	k ɐ pʲ e j ɪ t͡ɕ k ə j ʊ
осияваешь	ɐ sʲ i j ɪ v ə j ɪ ʂ
обгрызаем	ɐ b ɡ r ɨ z a j ɪ m
сломила	s ɫ ɐ mʲ i ɫ ə
информационный	ɪ n f ə r m ə t͡s ɨ o nː ɨ j
переделываю	pʲ ɪ rʲ ɪ dʲ e ɫ ɨ v ə j ʊ
кольчугой	k ɐ lʲ t͡ɕ u ɡ ə j
провозя	p r ə v ɐ zʲ a
накапливаем	n ɐ k a p lʲ ɪ v ə j ɪ m
провидцу	p r ɐ vʲ i t͡sː ʊ
коклюш	k ɐ k lʲ u ʂ
обилие	ɐ bʲ i lʲ ɪ j e
оцепляете	ɐ t͡s ɨ pʲ æ j ɪ tʲ e
холмиками	x o ɫ mʲ ɪ k ə mʲ ɪ
новациям	n ɐ v a t͡s ɨ j ə m
снабжал	s n ɐ b ʐ a ɫ
хлебнул	x lʲ ɪ b n u ɫ
разбредалась	r ə z b rʲ ɪ d a ɫ ə sʲ
чернью	t͡ɕ e r nʲ j ʊ
морфий	m o r fʲ ɪ j
заимейте	z ə ɪ mʲ e j tʲ e
перекусят	pʲ ɪ rʲ ɪ k u sʲ ə t
обмерю	ɐ b mʲ e rʲ ʊ
вверяй	vʲː ɪ rʲ æ j
бодрствованиями	b o d r s t v ə v ə nʲ ɪ j ə mʲ ɪ
относим	ɐ t n o sʲ ɪ m
обидами	ɐ bʲ i d ə mʲ ɪ
изучитесь	ɪ z u t͡ɕ ɪ tʲ ɪ sʲ
эрекциею	ɪ r ɛ k t͡s ɨ j ɪ j ʊ
гонялись	ɡ ɐ nʲ æ lʲ ɪ sʲ
бомбардировка	b ə m b ə r dʲ ɪ r o f k ə
выразителям	v ɨ r ɐ zʲ i tʲ ɪ lʲ ə m
свешивайте	s vʲ e ʂ ɨ v ə j tʲ e
дымили	d ɨ mʲ i lʲ ɪ
астероидах	ɐ s t ɨ r o ɪ d ə x
недомыслиям	nʲ ɪ d ɐ m ɨ s ⁽ʲ ⁾ lʲ ɪ j ə m
провозглашай	p r ə v ə z ɡ ɫ ɐ ʂ a j
истязанием	ɪ sʲ tʲ ɪ z a nʲ ɪ j ɪ m
литов	lʲ i t ə f
гидрологиях	ɡʲ ɪ d r ɐ ɫ o ɡʲ ɪ j ə x
работницами	r ɐ b o tʲ nʲ ɪ t͡s ə mʲ ɪ
переубеди	pʲ ɪ rʲ ɪ ʊ bʲ ɪ dʲ i
просрочке	p r ɐ s r o t͡ɕ kʲ e
разочаровываешь	r ə z ə t͡ɕ ɪ r o v ɨ v ə j ɪ ʂ
разозлить	r ə z ə z ⁽ʲ ⁾ lʲ ɪ tʲ
времечке	v rʲ e mʲ ɪ t͡ɕ kʲ e
похищавший	p ə xʲ ɪ ɕː a f ʂ ɨ j
отвыкавший	ɐ t v ɨ k a f ʂ ɨ j
верны	vʲ e r n ɨ
чаячий	t͡ɕ æ j ɪ t͡ɕ ɪ j
прочитываемый	p r ɐ t͡ɕ i t ɨ v ə j ɪ m ɨ j
обозначаемый	ɐ b ə z n ɐ t͡ɕ æ j ɪ m ɨ j
сенокосец	sʲ ɪ n ɐ k o sʲ ɪ t͡s
захлопнитесь	z ɐ x ɫ o p nʲ ɪ tʲ ɪ sʲ
контроллера	k ɐ n t r o lʲː ɪ r ə
перепивав	pʲ ɪ rʲ ɪ pʲ ɪ v a f
потирать	p ə tʲ ɪ r a tʲ
попросись	p ə p r ɐ sʲ i sʲ
проработав	p r ə r ɐ b o t ə f
просвещай	p r ə s vʲ ɪ ɕː æ j
металась	mʲ ɪ t a ɫ ə sʲ
умудрит	ʊ m ʊ d rʲ i t
гидраты	ɡʲ ɪ d r a t ɨ
вотум	v o t ʊ m
разукрашу	r ə z ʊ k r a ʂ ʊ
интеллектами	ɪ nʲ tʲ ɪ lʲ e k t ə mʲ ɪ
костры	k ɐ s t r ɨ
фабрикую	f ə b rʲ ɪ k u j ʊ
пробурчала	p r ə b ʊ r t͡ɕ a ɫ ə
высвободимся	v ɨ s v ə b ə dʲ ɪ m sʲ ə
парейдолиях	p ə rʲ ɪ j d ɐ lʲ i j ə x
ослабеете	ɐ s ɫ ɐ bʲ e j ɪ tʲ e
убийцы	ʊ bʲ i j t͡s ɨ
привстающий	p rʲ ɪ f s t ɐ j ʉ ɕː ɪ j
поджариваем	p ɐ d͡ʐ ʐ a rʲ ɪ v ə j ɪ m
уставившись	ʊ s t a vʲ ɪ f ʂ ɨ sʲ
хлебцем	x lʲ e p t͡s ɨ m
испустить	ɪ s p ʊ sʲ tʲ i tʲ
доносчиками	d ɐ n o ɕ t͡ɕ ɪ k ə mʲ ɪ
гранитный	ɡ r ɐ nʲ i t n ɨ j
пролезла	p r ɐ lʲ e z ɫ ə
трансляциям	t r ɐ n s ⁽ʲ ⁾ lʲ a t͡s ɨ j ə m
жерлах	ʐ ɛ r ɫ ə x
ассемблера	ɐ s ɛ m b lʲ ɪ r ə
совершал	s ə vʲ ɪ r ʂ a ɫ
бровку	b r o f k ʊ
отлучайте	ɐ t ɫ ʊ t͡ɕ æ j tʲ e
черенами	t͡ɕ e rʲ ɪ n ə mʲ ɪ
рулями	r ʊ lʲ æ mʲ ɪ
потираю	p ə tʲ ɪ r a j ʊ
выведется	v ɨ vʲ ɪ dʲ ɪ t͡s ə
брёха	b rʲ ɵ x ə
интерпретированный	ɪ n t ɨ r p rʲ ɪ tʲ i r ə v ə nː ɨ j
заканчивала	z ɐ k a nʲ t͡ɕ ɪ v ə ɫ ə
сомнениями	s ɐ m nʲ e nʲ ɪ j ə mʲ ɪ
содрогавшийся	s ə d r ɐ ɡ a f ʂ ɨ j sʲ ə
растянутся	r ɐ sʲ tʲ a n ʊ t͡s ə
абсорбироваться	ɐ p s ɐ r bʲ i r ə v ə t͡s ə
одиссеями	ɐ dʲ ɪ sʲ e j ə mʲ ɪ
обручавший	ɐ b r ʊ t͡ɕ a f ʂ ɨ j
нашумлю	n ə ʂ ʊ m lʲ u
откатившись	ɐ t k ɐ tʲ i f ʂ ɨ sʲ
гонореи	ɡ ə n ɐ rʲ e ɪ
мобильники	m ɐ bʲ i lʲ nʲ ɪ kʲ ɪ
очертило	ɐ t͡ɕ ɪ r tʲ i ɫ ə
дуэта	d ʊ ɛ t ə
папирусах	p ɐ pʲ i r ʊ s ə x
репортёрах	rʲ ɪ p ɐ r tʲ ɵ r ə x
сплющивавший	s p lʲ ʉ ɕː ɪ v ə f ʂ ɨ j
задёргиваем	z ɐ dʲ ɵ r ɡʲ ɪ v ə j ɪ m
скопирую	s k ɐ pʲ i r ʊ j ʊ
восславляю	v ə sː ɫ ɐ v lʲ æ j ʊ
искушай	ɪ s k ʊ ʂ a j
змиям	z mʲ i j ə m
палантине	p ə ɫ ɐ nʲ tʲ i nʲ e
глотает	ɡ ɫ ɐ t a j ɪ t
списаний	s pʲ ɪ s a nʲ ɪ j
отхватываемый	ɐ t x v a t ɨ v ə j ɪ m ɨ j
осунется	ɐ s u nʲ ɪ t͡s ə
спешил	s pʲ e ʂ ɨ ɫ
оплатим	ɐ p ɫ a tʲ ɪ m
корпусом	k o r p ʊ s ə m
дисквалификациях	dʲ ɪ s k v ə lʲ ɪ fʲ ɪ k a t͡s ɨ j ə x
рыльцам	r ɨ lʲ t͡s ə m
пригубит	p rʲ ɪ ɡ u bʲ ɪ t
прокурору	p r ə k ʊ r o r ʊ
наклеит	n ɐ k lʲ e ɪ t
подчёркивают	p ɐ t͡ɕː ɵ r kʲ ɪ v ə j ʊ t
мистера	mʲ i s t ɨ r ə
рассыплешься	r ɐ sː ɨ p lʲ ɪ ʂ sʲ ə
ошеломлением	ɐ ʂ ɨ ɫ ɐ m lʲ e nʲ ɪ j ɪ m
десерты	dʲ ɪ sʲ e r t ɨ
абстиненты	ɐ p sʲ tʲ ɪ nʲ e n t ɨ
расквитается	r ə s k vʲ ɪ t a j ɪ t͡s ə
мотайтесь	m ɐ t a j tʲ ɪ sʲ
забудусь	z ɐ b u d ʊ sʲ
конденсаторами	k ə n d ɨ n s a t ə r ə mʲ ɪ
кашицы	k a ʂ ɨ t͡s ɨ
уставу	ʊ s t a v ʊ
аншлюсов	a n ʂ lʲ ʊ s ə f
бакинки	b ɐ kʲ i n kʲ ɪ
плошкою	p ɫ o ʂ k ə j ʊ
примадонну	p rʲ ɪ m ɐ d o nː ʊ
купают	k ʊ p a j ʊ t
кровоснабжение	k r ə v ə s n ɐ b ʐ ɛ nʲ ɪ j e
агатом	ɐ ɡ a t ə m
фурункулами	f ʊ r u n k ʊ ɫ ə mʲ ɪ
колыхав	k ə ɫ ɨ x a f
биатлонами	bʲ ɪ ɐ t ɫ o n ə mʲ ɪ
намыливающий	n ɐ m ɨ lʲ ɪ v ə j ʉ ɕː ɪ j
туземцами	t ʊ zʲ e m t͡s ə mʲ ɪ
грузимый	ɡ r ʊ zʲ i m ɨ j
переодевавши	pʲ ɪ rʲ ɪ ə dʲ ɪ v a f ʂ ɨ
озарила	ɐ z ɐ rʲ i ɫ ə
кинолентами	kʲ i n ɐ lʲ e n t ə mʲ ɪ
удалённостями	ʊ d ɐ lʲ ɵ nː ə sʲ tʲ ə mʲ ɪ
защищаетесь	z ə ɕː ɪ ɕː æ j ɪ tʲ ɪ sʲ
мироустройствах	mʲ ɪ r ə ʊ s t r o j s t v ə x
лепетать	lʲ ɪ pʲ ɪ t a tʲ
одышка	ɐ d ɨ ʂ k ə
присылавши	p rʲ ɪ s ɨ ɫ a f ʂ ɨ
долинах	d ɐ lʲ i n ə x
предсказуемостью	p rʲ ɪ t͡s k ɐ z u j ɪ m ə sʲ tʲ j ʊ
лесоэкспорт	lʲ e s ɐ ɛ k s p ə r t
инкубациям	ɪ n k ʊ b a t͡s ɨ j ə m
кустарям	k ʊ s t ɐ rʲ a m
вальцу	v ɐ lʲ t͡s u
болотам	b ɐ ɫ o t ə m
заказчиков	z ɐ k a ɕː ɪ k ə f
иволгою	i v ə ɫ ɡ ə j ʊ
усыновляйте	ʊ s ɨ n ɐ v lʲ æ j tʲ e
имевшись	ɪ mʲ e f ʂ ɨ sʲ
царевна	t͡s ɐ rʲ e v n ə
трудясь	t r ʊ dʲ æ sʲ
деточка	dʲ e t ə t͡ɕ k ə
ответству	ɐ t vʲ e t͡s t v ʊ
плеоназм	p lʲ ɪ ɐ n a z m
унижавший	ʊ nʲ ɪ ʐ a f ʂ ɨ j
взбираетесь	v z bʲ ɪ r a j ɪ tʲ ɪ sʲ
поживавший	p ə ʐ ɨ v a f ʂ ɨ j
пополнять	p ə p ɐ ɫ nʲ æ tʲ
прояснявшийся	p r ə j ɪ sʲ nʲ a f ʂ ɨ j sʲ ə
сигало	sʲ ɪ ɡ a ɫ ə
компрометирующий	k ə m p r ə mʲ ɪ tʲ i r ʊ j ʉ ɕː ɪ j
маскарадам	m ə s k ɐ r a d ə m
эмигранты	ɪ mʲ ɪ ɡ r a n t ɨ
братиною	b r a tʲ ɪ n ə j ʊ
обнадёживать	ɐ b n ɐ dʲ ɵ ʐ ɨ v ə tʲ
коуче	k o ʊ t͡ɕ e
выпустишься	v ɨ p ʊ sʲ tʲ ɪ ʂ sʲ ə
астроблемы	ɐ s t r ɐ b lʲ e m ɨ
стелили	sʲ tʲ ɪ lʲ i lʲ ɪ
древнейший	d rʲ ɪ v nʲ e j ʂ ɨ j
сутулишься	s ʊ t u lʲ ɪ ʂ sʲ ə
разъезжать	r ə z j ɪ ʐː a tʲ
цевках	t͡s ɛ f k ə x
выражен	v ɨ r ə ʐ ɨ n
занято	z a nʲ ɪ t ə
лыком	ɫ ɨ k ə m
зонтами	z ɐ n t a mʲ ɪ
прославляйтесь	p r ə s ɫ ɐ v lʲ æ j tʲ ɪ sʲ
чужеродный	t͡ɕ ʊ ʐ ɨ r o d n ɨ j
трефы	t rʲ e f ɨ
тюфяком	tʲ ʉ fʲ ɪ k o m
дисциплинировала	dʲ ɪ s t͡s ɨ p lʲ ɪ nʲ i r ə v ə ɫ ə
абсорбированиями	ɐ p s ɐ r bʲ i r ə v ə nʲ ɪ j ə mʲ ɪ
выучишься	v ɨ ʊ t͡ɕ ɪ ʂ sʲ ə
расслабленные	r ɐ sː ɫ a b lʲ ɪ nː ɨ j e
зарядный	z ɐ rʲ a d n ɨ j
повторяют	p ə f t ɐ rʲ æ j ʊ t
являвшись	j ɪ v lʲ a f ʂ ɨ sʲ
отмахавши	ɐ t m ɐ x a f ʂ ɨ
взламывавший	v z ɫ a m ɨ v ə f ʂ ɨ j
высокохудожественный	v ɨ s ə k ə x ʊ d o ʐ ɨ s t vʲ ɪ nː ɨ j
обёртках	ɐ bʲ ɵ r t k ə x
бант	b a n t
просветишь	p r ɐ s vʲ e tʲ ɪ ʂ
обречённостью	ɐ b rʲ ɪ t͡ɕ ɵ nː ə sʲ tʲ j ʊ
набивают	n ə bʲ ɪ v a j ʊ t
прапорщик	p r a p ə r ɕː ɪ k
пижму	pʲ i ʐ m ʊ
граммам	ɡ r a m ə m
провозы	p r ɐ v o z ɨ
опечатывали	ɐ pʲ ɪ t͡ɕ a t ɨ v ə lʲ ɪ
соус	s o ʊ s
потёрла	p ɐ tʲ ɵ r ɫ ə
коллапсам	k ɐ ɫ a p s ə m
мастодонты	m ə s t ɐ d o n t ɨ
насупившийся	n ɐ s u pʲ ɪ f ʂ ɨ j sʲ ə
грилем	ɡ rʲ i lʲ ɪ m
поварят	p ə v ɐ rʲ a t
неполноту	nʲ ɪ p ə ɫ n ɐ t u
вылечивайте	v ɨ lʲ e t͡ɕ ɪ v ə j tʲ e
окопа	ɐ k o p ə
ветрениц	vʲ e t rʲ ɪ nʲ ɪ t͡s
вставишься	f s t a vʲ ɪ ʂ sʲ ə
приятны	p rʲ ɪ j a t n ɨ
альдегида	ɐ lʲ d ɨ ɡʲ i d ə
мурзиками	m u r zʲ ɪ k ə mʲ ɪ
пожелтеем	p ə ʐ ɨ ɫ tʲ e j ɪ m
перекупаем	pʲ ɪ rʲ ɪ k ʊ p a j ɪ m
кровавил	k r ɐ v a vʲ ɪ ɫ
аблефароном	ɐ b lʲ ɪ f ɐ r o n ə m
извиняли	ɪ z vʲ ɪ nʲ æ lʲ ɪ
врезаешься	v rʲ ɪ z a j ɪ ʂ sʲ ə
децентрализовали	d ɛ t͡s ɨ n t r ə lʲ ɪ z ɐ v a lʲ ɪ
испуган	ɪ s p u ɡ ə n
слёзы	s ⁽ʲ ⁾ lʲ ɵ z ɨ
видеозапись	vʲ i dʲ ɪ o z a pʲ ɪ sʲ
стремянку	s t rʲ ɪ mʲ a n k ʊ
втором	f t ɐ r o m
прилечь	p rʲ ɪ lʲ e t͡ɕ
сочинением	s ə t͡ɕ ɪ nʲ e nʲ ɪ j ɪ m
швартуете	ʂ v ɐ r t u j ɪ tʲ e
разговорчиками	r ə z ɡ ɐ v o r t͡ɕ ɪ k ə mʲ ɪ
абсурдиста	ɐ p s ʊ r dʲ i s t ə
леденела	lʲ ɪ dʲ ɪ nʲ e ɫ ə
даннике	d a nʲː ɪ kʲ e
близнецу	b lʲ ɪ zʲ nʲ ɪ t͡s u
опекунами	ɐ pʲ ɪ k ʊ n a mʲ ɪ
связисте	s vʲ ɪ zʲ i sʲ tʲ e
раскисли	r ɐ s kʲ i s ⁽ʲ ⁾ lʲ ɪ
однообразиям	ɐ d n ɐ ɐ b r a zʲ ɪ j ə m
аблактировке	ɐ b ɫ ə k tʲ ɪ r o f kʲ e
переустроит	pʲ ɪ rʲ ɪ ʊ s t r o ɪ t
эмиграциям	ɪ mʲ ɪ ɡ r a t͡s ɨ j ə m
брезгают	b rʲ e z ɡ ə j ʊ t
блютус	b lʲ ʊ t u s
уединилась	ʊ j ɪ dʲ ɪ nʲ i ɫ ə sʲ
кардане	k ɐ r d a nʲ e
летный	lʲ e t n ɨ j
хламы	x ɫ a m ɨ
погрязают	p ə ɡ rʲ ɪ z a j ʊ t
бляшкам	b lʲ a ʂ k ə m
фельдмаршала	fʲ ɪ lʲ d m a r ʂ ə ɫ ə
музыкою	m u z ɨ k ə j ʊ
кругосветный	k r ʊ ɡ ɐ s vʲ e t n ɨ j
посвистывали	p ɐ s vʲ i s t ɨ v ə lʲ ɪ
дубком	d ʊ p k o m
реквизита	rʲ ɪ k vʲ ɪ zʲ i t ə
биотоксичность	bʲ ɪ ə t ɐ k sʲ i t͡ɕ n ə sʲ tʲ
хаживал	x a ʐ ɨ v ə ɫ
заботивши	z ɐ b o tʲ ɪ f ʂ ɨ
защитим	z ə ɕː ɪ tʲ i m
шатах	ʂ a t ə x
изъянами	ɪ z j a n ə mʲ ɪ
экспериментировавший	ɪ k s pʲ ɪ rʲ ɪ mʲ ɪ nʲ tʲ i r ə v ə f ʂ ɨ j
пиздить	pʲ i zʲ dʲ ɪ tʲ
подушечка	p ɐ d u ʂ ɨ t͡ɕ k ə
трансплантируем	t r ə n s p ɫ ɐ nʲ tʲ i r ʊ j ɪ m
попками	p o p k ə mʲ ɪ
культурностей	k ʊ lʲ t u r n ə sʲ tʲ ɪ j
угрях	ʊ ɡ rʲ a x
алгоритмам	ɐ ɫ ɡ ɐ rʲ i t m ə m
зачёркиваем	z ɐ t͡ɕ ɵ r kʲ ɪ v ə j ɪ m
боронивши	b ə r ɐ nʲ i f ʂ ɨ
суммируешь	s ʊ mʲ i r ʊ j ɪ ʂ
гармоники	ɡ ɐ r m o nʲ ɪ kʲ ɪ
двухлетиями	d v ʊ x lʲ e tʲ ɪ j ə mʲ ɪ
сковород	s k ə v ɐ r o t
сжимав	ʐː ɨ m a f
волнении	v ɐ ɫ nʲ e nʲ ɪ ɪ
засвистим	z ə s vʲ ɪ sʲ tʲ i m
заржаветь	z ɐ r ʐ a vʲ ɪ tʲ
чищенный	t͡ɕ i ɕː ɪ nː ɨ j
апограф	ɐ p o ɡ r ə f
сконфузят	s k ɐ n f u zʲ ə t
унтер	u nʲ tʲ ɪ r
матёрый	m ɐ tʲ ɵ r ɨ j
хаяли	x a j ɪ lʲ ɪ
водрузив	v ə d r ʊ zʲ i f
голье	ɡ ɐ lʲ j e
бабосам	b ɐ b o s ə m
отмерит	ɐ t mʲ e rʲ ɪ t
лётов	lʲ ɵ t ə f
прижигайте	p rʲ ɪ ʐ ɨ ɡ a j tʲ e
расправах	r ɐ s p r a v ə x
сосною	s ɐ s n o j ʊ
хмыкнут	x m ɨ k n ʊ t
умаляемся	ʊ m ɐ lʲ æ j ɪ m sʲ ə
антропологии	ɐ n t r ə p ɐ ɫ o ɡʲ ɪ ɪ
заверещи	z ə vʲ ɪ rʲ ɪ ɕː i
аблаутов	ɐ b ɫ a ʊ t ə f
корыту	k ɐ r ɨ t ʊ
вазочками	v a z ə t͡ɕ k ə mʲ ɪ
разговляются	r ə z ɡ ɐ v lʲ æ j ʊ t͡s ə
привяжу	p rʲ ɪ vʲ ɪ ʐ u
отозваться	ɐ t ɐ z v a t͡sː ə
тору	t o r ʊ
увезённый	ʊ vʲ ɪ zʲ ɵ nː ɨ j
заведованием	z ɐ vʲ e d ə v ə nʲ ɪ j ɪ m
казанах	k ə z ɐ n a x
поженить	p ə ʐ ɨ nʲ i tʲ
усопла	ʊ s o p ɫ ə
завешивайте	z ɐ vʲ e ʂ ɨ v ə j tʲ e
извергший	ɪ z vʲ e r k ʂ ɨ j
благородно	b ɫ ə ɡ ɐ r o d n ə
замере	z ɐ mʲ e rʲ e
втаскивали	f t a s kʲ ɪ v ə lʲ ɪ
готовностью	ɡ ɐ t o v n ə sʲ tʲ j ʊ
слушанию	s ɫ u ʂ ə nʲ ɪ j ʊ
остужав	ɐ s t ʊ ʐ a f
повязанный	p ɐ vʲ a z ə nː ɨ j
епитрахилей	j ɪ pʲ ɪ t r ɐ xʲ i lʲ ɪ j
торопыга	t ə r ɐ p ɨ ɡ ə
пагубах	p a ɡ ʊ b ə x
цензурировавший	t͡s ɨ n z ʊ rʲ i r ə v ə f ʂ ɨ j
проникаются	p r ə nʲ ɪ k a j ʊ t͡s ə
лопари	ɫ o p ə rʲ ɪ
разгневаюсь	r ɐ z ɡ nʲ e v ə j ʉ sʲ
наскребавший	n ə s k rʲ ɪ b a f ʂ ɨ j
сделаешься	zʲ dʲ e ɫ ə j ɪ ʂ sʲ ə
вместишь	v mʲ ɪ sʲ tʲ i ʂ
запрыгать	z ɐ p r ɨ ɡ ə tʲ
замахивались	z ɐ m a xʲ ɪ v ə lʲ ɪ sʲ
остригавшись	ɐ s t rʲ ɪ ɡ a f ʂ ɨ sʲ
согласовываетесь	s ə ɡ ɫ ɐ s o v ɨ v ə j ɪ tʲ ɪ sʲ
обливающийся	ɐ b lʲ ɪ v a j ʉ ɕː ɪ j sʲ ə
погрешите	p ə ɡ rʲ ɪ ʂ ɨ tʲ e
брехлом	b rʲ ɪ x ɫ o m
выдачею	v ɨ d ə t͡ɕ ɪ j ʊ
чекать	t͡ɕ ɪ k a tʲ
должные	d o ɫ ʐ n ɨ j e
пихтами	pʲ i x t ə mʲ ɪ
радиопередач	r a dʲ ɪ o pʲ ɪ rʲ ɪ d a t͡ɕ
формализовавший	f ə r m ə lʲ ɪ z ɐ v a f ʂ ɨ j
обеспечиваю	ɐ bʲ ɪ s pʲ e t͡ɕ ɪ v ə j ʊ
смыкал	s m ɨ k a ɫ
стачкой	s t a t͡ɕ k ə j
аватаре	ɐ v ɐ t a rʲ e
заглохло	z ɐ ɡ ɫ o x ɫ ə
ослабнет	ɐ s ɫ a b nʲ ɪ t
селёдки	sʲ ɪ lʲ ɵ t kʲ ɪ
кровавленный	k r ɐ v a v lʲ ɪ nː ɨ j
священстве	s vʲ ɪ ɕː e n s t vʲ e
хиты	xʲ ɪ t ɨ
привставать	p rʲ ɪ f s t ɐ v a tʲ
показах	p ɐ k a z ə x
завязло	z ɐ vʲ a z ɫ ə
атавизмов	ɐ t ɐ vʲ i z m ə f
прихватизацией	p rʲ ɪ x v ə tʲ ɪ z a t͡s ɨ j ɪ j
ассистенте	ɐ sʲ ɪ sʲ tʲ e nʲ tʲ e
парейдолиею	p ə rʲ ɪ j d ɐ lʲ i j ɪ j ʊ
стечению	sʲ tʲ ɪ t͡ɕ e nʲ ɪ j ʊ
англосфере	a n ɡ ɫ ɐ s fʲ e rʲ e
разразились	r ə z r ɐ zʲ i lʲ ɪ sʲ
успокаиваем	ʊ s p ɐ k a ɪ v ə j ɪ m
завалитесь	z ɐ v a lʲ ɪ tʲ ɪ sʲ
угрожающий	ʊ ɡ r ɐ ʐ a j ʉ ɕː ɪ j
застревать	z ə s t rʲ ɪ v a tʲ
объявлений	ɐ b j ɪ v lʲ e nʲ ɪ j
слижите	s ⁽ʲ ⁾ lʲ ɪ ʐ ɨ tʲ e
шепнув	ʂ ɨ p n u f
плантациях	p ɫ ɐ n t a t͡s ɨ j ə x
выговорившись	v ɨ ɡ ə v ə rʲ ɪ f ʂ ɨ sʲ
утончи	ʊ t ɐ nʲ t͡ɕ i
сровняйте	s r ɐ v nʲ æ j tʲ e
эксцессов	ɪ k s t͡s ɛ s ə f
уделах	ʊ dʲ e ɫ ə x
почисть	p ɐ t͡ɕ i sʲ tʲ
мудоёба	m ʊ d ɐ j ɵ b ə
санитары	s ə nʲ ɪ t a r ɨ
синхронизаций	sʲ ɪ n x r ə nʲ ɪ z a t͡s ɨ j
заревом	z a rʲ ɪ v ə m
костюмчик	k ɐ sʲ tʲ u m t͡ɕ ɪ k
каскадам	k ɐ s k a d ə m
учредительный	ʊ t͡ɕ rʲ ɪ dʲ i tʲ ɪ lʲ n ɨ j
выращивание	v ɨ r a ɕː ɪ v ə nʲ ɪ j e
задаюсь	z ə d ɐ j ʉ sʲ
пружинит	p r ʊ ʐ ɨ nʲ ɪ t
закалывала	z ɐ k a ɫ ɨ v ə ɫ ə
удочерениях	ʊ d ə t͡ɕ ɪ rʲ e nʲ ɪ j ə x
обозначься	ɐ b ɐ z n a t͡ɕ sʲ ə
откалибровывавшую	ɐ t k ə lʲ ɪ b r o v ɨ v ə f ʂ ʊ j ʊ
изъехало	ɪ z j e x ə ɫ ə
мочевина	m ə t͡ɕ ɪ vʲ i n ə
дорожавши	d ə r ɐ ʐ a f ʂ ɨ
стихаем	sʲ tʲ ɪ x a j ɪ m
ойкнувший	o j k n ʊ f ʂ ɨ j
азиками	a zʲ ɪ k ə mʲ ɪ
чувствованием	t͡ɕ u s t v ə v ə nʲ ɪ j ɪ m
неявкой	nʲ ɪ j a f k ə j
потасовками	p ə t ɐ s o f k ə mʲ ɪ
опробованный	ɐ p r o b ə v ə nː ɨ j
соревнуйтесь	s ə rʲ ɪ v n u j tʲ ɪ sʲ
запираюсь	z ə pʲ ɪ r a j ʉ sʲ
должку	d ɐ ɫ ʂ k u
заработало	z ə r ɐ b o t ə ɫ ə
золотистым	z ə ɫ ɐ tʲ i s t ɨ m
снадобьями	s n a d ə b ⁽ʲ ⁾ j ə mʲ ɪ
предпочтению	p rʲ ɪ t p ɐ t͡ɕ tʲ e nʲ ɪ j ʊ
маскируетесь	m ə s kʲ ɪ r u j ɪ tʲ ɪ sʲ
растворителя	r ə s t v ɐ rʲ i tʲ ɪ lʲ ə
чучой	t͡ɕ ʉ t͡ɕ ɵ j
чунями	t͡ɕ ʉ nʲ ə mʲ ɪ
лязгнуло	lʲ a z ɡ n ʊ ɫ ə
выправлять	v ɨ p r ɐ v lʲ æ tʲ
картинно	k ɐ r tʲ i nː ə
четвёртый	t͡ɕ ɪ t vʲ ɵ r t ɨ j
адекватностях	ɐ d ɨ k v a t n ə sʲ tʲ ə x
красно	k r a s n ə
восстанут	v ɐ sː t a n ʊ t
задремлют	z ɐ d rʲ e m lʲ ʊ t
изящный	ɪ zʲ æ ɕː n ɨ j
свалками	s v a ɫ k ə mʲ ɪ
вонзаешь	v ɐ n z a j ɪ ʂ
сгрудись	z ɡ r ʊ dʲ i sʲ
искупления	ɪ s k ʊ p lʲ e nʲ ɪ j ə
превозмогаешь	p rʲ ɪ v ə z m ɐ ɡ a j ɪ ʂ
выплативший	v ɨ p ɫ ə tʲ ɪ f ʂ ɨ j
колеблющий	k ɐ lʲ e b lʲ ʉ ɕː ɪ j
командиров	k ə m ɐ nʲ dʲ i r ə f
ростовой	r ə s t ɐ v o j
нынешний	n ɨ nʲ ɪ ʂ nʲ ɪ j
дымился	d ɨ mʲ i ɫ s ⁽ʲ ⁾ ə
хуёвина	x ʊ j ɵ vʲ ɪ n ə
продержим	p r ɐ dʲ e r ʐ ɨ m
акойт	ɐ k o j t
наркомтяжпром	n ə r k ə m tʲ ɪ ʂ p r o m
приделать	p rʲ ɪ dʲ e ɫ ə tʲ
секунды	sʲ ɪ k u n d ɨ
холостяке	x ə ɫ ə sʲ tʲ ɪ kʲ e
явственно	j a f s t vʲ ɪ nː ə
говоруне	ɡ ə v ə r ʊ nʲ e
высохнешь	v ɨ s ə x nʲ ɪ ʂ
мыслятся	m ɨ s ⁽ʲ ⁾ lʲ ə t͡s ə
правобережный	p r a v ə bʲ ɪ rʲ e ʐ n ɨ j
наладимся	n ɐ ɫ a dʲ ɪ m sʲ ə
хранило	x r ɐ nʲ i ɫ ə
переливало	pʲ ɪ rʲ ɪ lʲ ɪ v a ɫ ə
отеческий	ɐ tʲ e t͡ɕ ɪ s kʲ ɪ j
перекладывайте	pʲ ɪ rʲ ɪ k ɫ a d ɨ v ə j tʲ e
администрациях	ɐ d mʲ ɪ nʲ ɪ s t r a t͡s ɨ j ə x
ускоришься	ʊ s k o rʲ ɪ ʂ sʲ ə
обучавшийся	ɐ b ʊ t͡ɕ a f ʂ ɨ j sʲ ə
изменяло	ɪ z mʲ ɪ nʲ a ɫ ə
вскипали	f s kʲ ɪ p a lʲ ɪ
ремешкам	rʲ ɪ mʲ ɪ ʂ k a m
охнувший	o x n ʊ f ʂ ɨ j
копило	k ɐ pʲ i ɫ ə
прожигаем	p r ə ʐ ɨ ɡ a j ɪ m
террористе	t ɨ r ɐ rʲ i sʲ tʲ e
заискивали	z ɐ i s kʲ ɪ v ə lʲ ɪ
тускневши	t ʊ s k nʲ e f ʂ ɨ
возведши	v ɐ z vʲ e t͡ʂ ʂ ɨ
вертелось	vʲ ɪ r tʲ e ɫ ə sʲ
отягощавши	ɐ tʲ ɪ ɡ ɐ ɕː a f ʂ ɨ
сужений	s ʊ ʐ ɛ nʲ ɪ j
промахивался	p r ɐ m a xʲ ɪ v ə ɫ s ⁽ʲ ⁾ ə
затешешь	z ɐ tʲ e ʂ ɨ ʂ
механизатор	mʲ ɪ x ə nʲ ɪ z a t ə r
парадигмам	p ə r ɐ dʲ i ɡ m ə m
оттиски	o tʲː ɪ s kʲ ɪ
нахлынувший	n ɐ x ɫ ɨ n ʊ f ʂ ɨ j
скрепляя	s k rʲ ɪ p lʲ æ j ə
повысите	p ɐ v ɨ sʲ ɪ tʲ e
пойменный	p o j mʲ ɪ nː ɨ j
претворить	p rʲ ɪ t v ɐ rʲ i tʲ
заменялись	z ə mʲ ɪ nʲ æ lʲ ɪ sʲ
неумерен	nʲ ɪ ʊ mʲ e rʲ ɪ n
паприках	p a p rʲ ɪ k ə x
растолковывать	r ə s t ɐ ɫ k o v ɨ v ə tʲ
одинока	ɐ dʲ ɪ n o k ə
потру	p ɐ t r u
доняло	d o nʲ ɪ ɫ ə
эйсом	ɛ j s ə m
завершало	z ə vʲ ɪ r ʂ a ɫ ə
твердеющий	t vʲ ɪ r dʲ e j ʉ ɕː ɪ j
сертификата	sʲ ɪ r tʲ ɪ fʲ ɪ k a t ə
проигрывал	p r ɐ i ɡ r ɨ v ə ɫ
пропитывав	p r ɐ pʲ i t ɨ v ə f
прислужили	p rʲ ɪ s ɫ ʊ ʐ ɨ lʲ ɪ
оцепеневший	ɐ t͡s ɨ pʲ ɪ nʲ e f ʂ ɨ j
принуждает	p rʲ ɪ n ʊ ʐ d a j ɪ t
стогами	s t ɐ ɡ a mʲ ɪ
тойтерьер	t ə j t ɨ rʲ j e r
подножьям	p ɐ d n o ʐ j ə m
запугав	z ə p ʊ ɡ a f
оттаскивай	ɐ tː a s kʲ ɪ v ə j
отваживаемся	ɐ t v a ʐ ɨ v ə j ɪ m sʲ ə
глумлениях	ɡ ɫ ʊ m lʲ e nʲ ɪ j ə x
забил	z ɐ bʲ i ɫ
пастеризациями	p ə s t ɨ rʲ ɪ z a t͡s ɨ j ə mʲ ɪ
зелёном	zʲ ɪ lʲ ɵ n ə m
нелепицею	nʲ ɪ lʲ e pʲ ɪ t͡s ɨ j ʊ
льдинок	lʲ dʲ i n ə k
забрызжите	z ɐ b r ɨ ʐː ɨ tʲ e
погреетесь	p ɐ ɡ rʲ e j ɪ tʲ ɪ sʲ
загрязнив	z ə ɡ rʲ ɪ zʲ nʲ i f
утопаем	ʊ t o p ə j ɪ m
окружностей	ɐ k r u ʐ n ə sʲ tʲ ɪ j
кинофестивалям	kʲ ɪ n ə fʲ ɪ sʲ tʲ ɪ v a lʲ ə m
подделывали	p ɐ dʲː e ɫ ɨ v ə lʲ ɪ
прожидях	p r o ʐ ɨ dʲ ə x
вскидывалась	f s kʲ i d ɨ v ə ɫ ə sʲ
сигналите	sʲ ɪ ɡ n a lʲ ɪ tʲ e
истопим	ɪ s t o pʲ ɪ m
налегке	n ə lʲ ɪ xʲ kʲ e
распевавший	r ə s pʲ ɪ v a f ʂ ɨ j
мирив	mʲ ɪ rʲ i f
обуздывают	ɐ b u z d ɨ v ə j ʊ t
пропитайтесь	p r ə pʲ ɪ t a j tʲ ɪ sʲ
поджидала	p ə d͡ʐ ʐ ɨ d a ɫ ə
приправе	p rʲ ɪ p r a vʲ e
толкнёшь	t ɐ ɫ k nʲ ɵ ʂ
транспортам	t r a n s p ə r t ə m
рдев	r dʲ e f
врачах	v r ɐ t͡ɕ a x
зверюшки	z vʲ ɪ rʲ u ʂ kʲ ɪ
формантой	f ɐ r m a n t ə j
причитают	p rʲ ɪ t͡ɕ ɪ t a j ʊ t
декларировав	dʲ ɪ k ɫ ɐ rʲ i r ə v ə f
тропинок	t r ɐ pʲ i n ə k
добивавшийся	d ə bʲ ɪ v a f ʂ ɨ j sʲ ə
постукивающий	p ɐ s t u kʲ ɪ v ə j ʉ ɕː ɪ j
взведите	v z vʲ ɪ dʲ i tʲ e
лженаука	ɫ ʐ ɨ n ɐ u k ə
выплачивала	v ɨ p ɫ a t͡ɕ ɪ v ə ɫ ə
перельются	pʲ ɪ rʲ ɪ lʲ j u t͡sː ə
противоположу	p r o tʲ ɪ v ə p ə ɫ ɐ ʐ u
урону	ʊ r o n ʊ
негодованию	nʲ ɪ ɡ ə d ɐ v a nʲ ɪ j ʊ
поэтика	p ɐ ɛ tʲ ɪ k ə
проводкой	p r ɐ v o t k ə j
обстригаемый	ɐ p s t rʲ ɪ ɡ a j ɪ m ɨ j
уговаривая	ʊ ɡ ɐ v a rʲ ɪ v ə j ə
исследовательницам	ɪ s ⁽ʲ ⁾ː lʲ e d ə v ə tʲ ɪ lʲ nʲ ɪ t͡s ə m
еловый	j ɪ ɫ o v ɨ j
майонезы	m ə j ɪ n ɛ z ɨ
фальсификациею	f ə lʲ sʲ ɪ fʲ ɪ k a t͡s ɨ j ɪ j ʊ
размягчаемый	r ə z mʲ ɪ x t͡ɕ æ j ɪ m ɨ j
настань	n ɐ s t a nʲ
пристёгивай	p rʲ ɪ sʲ tʲ ɵ ɡʲ ɪ v ə j
коллективизацией	k ə lʲ ɪ k tʲ ɪ vʲ ɪ z a t͡s ɨ j ɪ j
ринусь	rʲ i n ʊ sʲ
забывался	z ə b ɨ v a ɫ s ⁽ʲ ⁾ ə
духовниках	d ʊ x ə v nʲ ɪ k a x
образчиком	ɐ b r a ɕː ɪ k ə m
конопатят	k ə n ɐ p a tʲ ə t
акцентам	ɐ k t͡s ɛ n t ə m
маркиза	m ɐ r kʲ i z ə
покинут	p ɐ kʲ i n ʊ t
полуподвала	p o ɫ ʊ p ɐ d v a ɫ ə
изводить	ɪ z v ɐ dʲ i tʲ
абаданце	ɐ b ɐ d a n t͡s ɨ
отдаляемый	ɐ dː ɐ lʲ æ j ɪ m ɨ j
опушавшись	ɐ p ʊ ʂ a f ʂ ɨ sʲ
маневренностями	m ɐ nʲ e v rʲ ɪ nː ə sʲ tʲ ə mʲ ɪ
вариантах	v ə rʲ ɪ a n t ə x
патронажах	p ə t r ɐ n a ʐ ə x
допустимость	d ə p ʊ sʲ tʲ i m ə sʲ tʲ
восхождений	v ə s x ɐ ʐ dʲ e nʲ ɪ j
бантов	b a n t ə f
притворись	p rʲ ɪ t v ɐ rʲ i sʲ
восточный	v ɐ s t o t͡ɕ n ɨ j
соизволив	s ə ɪ z v o lʲ ɪ f
изольются	ɪ z ɐ lʲ j u t͡sː ə
доводящий	d ə v ɐ dʲ æ ɕː ɪ j
проверив	p r ɐ vʲ e rʲ ɪ f
промышляло	p r ə m ɨ ʂ lʲ a ɫ ə
зацепитесь	z ɐ t͡s ɛ pʲ ɪ tʲ ɪ sʲ
маркировками	m ə r kʲ ɪ r o f k ə mʲ ɪ
малютки	m ɐ lʲ u t kʲ ɪ
проткнуло	p r ɐ t k n u ɫ ə
уволю	ʊ v o lʲ ʊ
искорёжило	ɪ s k ɐ rʲ ɵ ʐ ɨ ɫ ə
фотокарточку	f ə t ɐ k a r t ə t͡ɕ k ʊ
волочилось	v ə ɫ ɐ t͡ɕ i ɫ ə sʲ
расчёсывалась	r ɐ ɕ t͡ɕ ɵ s ɨ v ə ɫ ə sʲ
выучиваясь	v ɨ u t͡ɕ ɪ v ə j ɪ sʲ
обводивши	ɐ b v ɐ dʲ i f ʂ ɨ
своровавший	s v ə r ɐ v a f ʂ ɨ j
осматривавшийся	ɐ s m a t rʲ ɪ v ə f ʂ ɨ j sʲ ə
отповедям	o t p ə vʲ ɪ dʲ ə m
алкаете	ɐ ɫ k a j ɪ tʲ e
толка	t o ɫ k ə
лапали	ɫ a p ə lʲ ɪ
болтали	b ɐ ɫ t a lʲ ɪ
подводники	p ɐ d v o dʲ nʲ ɪ kʲ ɪ
главенствовали	ɡ ɫ ɐ vʲ e n s t v ə v ə lʲ ɪ
ола	o ɫ ə
глушил	ɡ ɫ ʊ ʂ ɨ ɫ
замарывай	z ɐ m a r ɨ v ə j
бутилируют	b ʊ tʲ ɪ lʲ i r ʊ j ʊ t
сталкиваюсь	s t a ɫ kʲ ɪ v ə j ʉ sʲ
сомнёмся	s ɐ m nʲ ɵ m sʲ ə
доделаем	d ɐ dʲ e ɫ ə j ɪ m
представлений	p rʲ ɪ t͡s t ɐ v lʲ e nʲ ɪ j
модернизированный	m ə d ɨ r nʲ ɪ zʲ i r ə v ə nː ɨ j
переливает	pʲ ɪ rʲ ɪ lʲ ɪ v a j ɪ t
кататься	k ɐ t a t͡sː ə
жидкостями	ʐ ɨ t k ə sʲ tʲ ə mʲ ɪ
хищничестве	xʲ i ɕː nʲ ɪ t͡ɕ ɪ s t vʲ e
выставляясь	v ɨ s t ɐ v lʲ æ j ɪ sʲ
спортивны	s p ɐ r tʲ i v n ɨ
сверхприбылью	s vʲ e r x p rʲ i b ɨ lʲ j ʊ
закипим	z ə kʲ ɪ pʲ i m
изготовлением	ɪ z ɡ ə t ɐ v lʲ e nʲ ɪ j ɪ m
богословы	b ə ɡ ɐ s ɫ o v ɨ
заговаривайтесь	z ə ɡ ɐ v a rʲ ɪ v ə j tʲ ɪ sʲ
автоматонах	ɐ f t ə m ɐ t o n ə x
осмысляем	ɐ s m ɨ s ⁽ʲ ⁾ lʲ æ j ɪ m
призываешь	p rʲ ɪ z ɨ v a j ɪ ʂ
негодяя	nʲ ɪ ɡ ɐ dʲ æ j ə
померещишься	p ə mʲ ɪ rʲ e ɕː ɪ ʂ sʲ ə
дотаскав	d ə t ɐ s k a f
залепляю	z ə lʲ ɪ p lʲ æ j ʊ
настучав	n ə s t ʊ t͡ɕ a f
наклонности	n ɐ k ɫ o nː ə sʲ tʲ ɪ
булавкой	b ʊ ɫ a f k ə j
дознании	d ɐ z n a nʲ ɪ ɪ
шумов	ʂ u m ə f
вскрику	f s k rʲ i k ʊ
договариваются	d ə ɡ ɐ v a rʲ ɪ v ə j ʊ t͡s ə
сетованию	sʲ e t ə v ə nʲ ɪ j ʊ
впоследствии	f p ɐ s ⁽ʲ ⁾ lʲ e t͡s t vʲ ɪ ɪ
табу	t ɐ b u
ватка	v a t k ə
буккеры	b u kʲ ɪ r ɨ
ахи	a xʲ ɪ
дураков	d ʊ r ɐ k o f
захлопывайся	z ɐ x ɫ o p ɨ v ə j sʲ ə
ручейник	r ʊ t͡ɕ e j nʲ ɪ k
рубки	r u p kʲ ɪ
смудрит	s m ʊ d rʲ i t
шевельнётесь	ʂ ɨ vʲ ɪ lʲ nʲ ɵ tʲ ɪ sʲ
безмолвиями	bʲ ɪ z m o ɫ vʲ ɪ j ə mʲ ɪ
ломись	ɫ ɐ mʲ i sʲ
абгомотопии	ɐ b ɡ ə m ɐ t o pʲ ɪ ɪ
присчитывай	p rʲ ɪ ɕː i t ɨ v ə j
раздельно	r ɐ zʲ dʲ e lʲ n ə
подставила	p ɐ t͡s s t a vʲ ɪ ɫ ə
сгрудьтесь	z ɡ r u tʲː ɪ sʲ
толковании	t ə ɫ k ɐ v a nʲ ɪ ɪ
крепчают	k rʲ ɪ p t͡ɕ æ j ʊ t
заимеет	z ə ɪ mʲ e j ɪ t
двуперстия	d v ʊ pʲ e r s ⁽ʲ ⁾ tʲ ɪ j ə
покроя	p ɐ k r o j ə
гранит	ɡ r ɐ nʲ i t
театре	tʲ ɪ a t ə rʲ e
разочтусь	r ə z ɐ t͡ɕ t u sʲ
защищавшийся	z ə ɕː ɪ ɕː a f ʂ ɨ j sʲ ə
оговориться	ɐ ɡ ə v ɐ rʲ i t͡sː ə
пробоя	p r ɐ b o j ə
выкраиваются	v ɨ k r a ɪ v ə j ʊ t͡s ə
тулии	t u lʲ ɪ ɪ
аллеях	ɐ lʲ e j ə x
размежевавши	r ə z mʲ ɪ ʐ ɨ v a f ʂ ɨ
сушатся	s u ʂ ə t͡s ə
камышниц	k ɐ m ɨ ʂ nʲ ɪ t͡s
вальцующий	v ɐ lʲ t͡s u j ʉ ɕː ɪ j
зажил	z a ʐ ɨ ɫ
гнобите	ɡ n ɐ bʲ i tʲ e
вуй	v u j
старое	s t a r ə j ə
удавливают	ʊ d a v lʲ ɪ v ə j ʊ t
повидать	p ə vʲ ɪ d a tʲ
вырыв	v ɨ r ɨ f
дрессировок	d rʲ ɪ sʲ ɪ r o v ə k
гостю	ɡ o sʲ tʲ ʊ
варьируют	v ɐ rʲ j i r ʊ j ʊ t
ревел	rʲ ɪ vʲ e ɫ
подослало	p ə d ɐ s ɫ a ɫ ə
вгибал	v ɡʲ ɪ b a ɫ
берегами	bʲ ɪ rʲ ɪ ɡ a mʲ ɪ
обатуром	ɐ b a t ʊ r ə m
всевышним	f sʲ ɪ v ɨ ʂ nʲ ɪ m
нанизывает	n ɐ nʲ i z ɨ v ə j ɪ t
стилисту	sʲ tʲ ɪ lʲ i s t ʊ
оросил	ɐ r ɐ sʲ i ɫ
исполкому	ɪ s p ɐ ɫ k o m ʊ
благодарностью	b ɫ ə ɡ ɐ d a r n ə sʲ tʲ j ʊ
пястях	pʲ æ sʲ tʲ ə x
лишках	lʲ i ʂ k ə x
колосьям	k ɐ ɫ o sʲ j ə m
семиугольника	sʲ ɪ mʲ ɪ ʊ ɡ o lʲ nʲ ɪ k ə
мегаэрги	mʲ ɪ ɡ ɐ ɛ r ɡʲ ɪ
молвила	m o ɫ vʲ ɪ ɫ ə
айрум	ɐ j r u m
думаем	d u m ə j ɪ m
язвивши	j ɪ z vʲ i f ʂ ɨ
силиконы	sʲ ɪ lʲ ɪ k o n ɨ
гирей	ɡʲ i rʲ ɪ j
погону	p ɐ ɡ o n ʊ
умножаем	ʊ m n ɐ ʐ a j ɪ m
ракша	r a k ʂ ə
отъедешь	ɐ t j e dʲ ɪ ʂ
хусткою	x u s t k ə j ʊ
затянемся	z ɐ tʲ æ nʲ ɪ m sʲ ə
встававши	f s t ɐ v a f ʂ ɨ
расхлёбываем	r ɐ s x lʲ ɵ b ɨ v ə j ɪ m
подавляют	p ə d ɐ v lʲ æ j ʊ t
поманили	p ə m ɐ nʲ i lʲ ɪ
обакш	ɐ b a k ʂ
тавре	t ɐ v rʲ e
построит	p ɐ s t r o ɪ t
покупающий	p ə k ʊ p a j ʉ ɕː ɪ j
переступавший	pʲ ɪ rʲ ɪ s t ʊ p a f ʂ ɨ j
апелляцию	ɐ pʲ ɪ lʲ a t͡s ɨ j ʊ
акмеизма	ɐ k mʲ ɪ i z m ə
башке	b ɐ ʂ kʲ e
отлежалась	ɐ t lʲ ɪ ʐ a ɫ ə sʲ
деспотизм	dʲ ɪ s p ɐ tʲ i z m
сроднивший	s r ɐ dʲ nʲ i f ʂ ɨ j
шлицам	ʂ lʲ i t͡s ə m
отрезаю	ɐ t rʲ ɪ z a j ʊ
оттискиваем	ɐ tʲː i s kʲ ɪ v ə j ɪ m
злоключением	z ɫ ə k lʲ ʉ t͡ɕ e nʲ ɪ j ɪ m
пользованиях	p o lʲ z ə v ə nʲ ɪ j ə x
посещениях	p ə sʲ ɪ ɕː e nʲ ɪ j ə x
павлинах	p ɐ v lʲ i n ə x
неформально	nʲ ɪ f ɐ r m a lʲ n ə
рассказывавшийся	r ɐ sː k a z ɨ v ə f ʂ ɨ j sʲ ə
опаску	ɐ p a s k ʊ
самосвалах	s ə m ɐ s v a ɫ ə x
заявительнице	z ə j ɪ vʲ i tʲ ɪ lʲ nʲ ɪ t͡s ɨ
напрашиваетесь	n ɐ p r a ʂ ɨ v ə j ɪ tʲ ɪ sʲ
причастилось	p rʲ ɪ t͡ɕ ɪ sʲ tʲ i ɫ ə sʲ
метафизика	mʲ ɪ t ɐ fʲ i zʲ ɪ k ə
присмотревши	p rʲ ɪ s m ɐ t rʲ e f ʂ ɨ
лосьонам	ɫ ɐ sʲ j ɵ n ə m
светиться	s vʲ ɪ tʲ i t͡sː ə
совещаешься	s ə vʲ ɪ ɕː æ j ɪ ʂ sʲ ə
кончали	k ɐ nʲ t͡ɕ æ lʲ ɪ
планированиям	p ɫ ɐ nʲ i r ə v ə nʲ ɪ j ə m
какую	k ɐ k u j ʊ
краткам	k r a t k ə m
поведываете	p ɐ vʲ e d ɨ v ə j ɪ tʲ e
тихвинский	tʲ i x vʲ ɪ n s kʲ ɪ j
обносишь	ɐ b n o sʲ ɪ ʂ
ознакомляем	ɐ z n ə k ɐ m lʲ æ j ɪ m
крупинкой	k r ʊ pʲ i n k ə j
наворачивает	n ə v ɐ r a t͡ɕ ɪ v ə j ɪ t
капотажами	k ə p ɐ t a ʐ ə mʲ ɪ
сопроводишь	s ə p r ə v ɐ dʲ i ʂ
изобретая	ɪ z ə b rʲ ɪ t a j ə
задремлешь	z ɐ d rʲ e m lʲ ɪ ʂ
вдохнули	v d ɐ x n u lʲ ɪ
заслышит	z ɐ s ɫ ɨ ʂ ɨ t
крикнул	k rʲ i k n ʊ ɫ
разживалась	r ə ʐː ɨ v a ɫ ə sʲ
закладывай	z ɐ k ɫ a d ɨ v ə j
шелковистый	ʂ ɨ ɫ k ɐ vʲ i s t ɨ j
садку	s ɐ t k u
тезисов	t ɛ zʲ ɪ s ə f
разворачиваю	r ə z v ɐ r a t͡ɕ ɪ v ə j ʊ
подобострастие	p ə d ə b ɐ s t r a sʲ tʲ ɪ j e
мастодонтов	m ə s t ɐ d o n t ə f
исказится	ɪ s k ɐ zʲ i t͡sː ə
отпраздновал	ɐ t p r a z n ə v ə ɫ
отыгрывалось	ɐ t ɨ ɡ r ɨ v ə ɫ ə sʲ
навлекали	n ə v lʲ ɪ k a lʲ ɪ
зайдя	z ɐ j dʲ a
замочками	z ɐ m o t͡ɕ k ə mʲ ɪ
пригородом	p rʲ i ɡ ə r ə d ə m
выправляйте	v ɨ p r ɐ v lʲ æ j tʲ e
бельму	bʲ ɪ lʲ m u
деспотами	dʲ e s p ə t ə mʲ ɪ
обмираю	ɐ b mʲ ɪ r a j ʊ
баблосы	b ɐ b ɫ o s ɨ
выкапывали	v ɨ k a p ɨ v ə lʲ ɪ
пупку	p ʊ p k u
кастаньеты	k ə s t ɐ nʲ j e t ɨ
проебём	p r ə j ɪ bʲ ɵ m
пройдусь	p r ɐ j d u sʲ
раскручивало	r ɐ s k r u t͡ɕ ɪ v ə ɫ ə
отбудьте	ɐ d b u tʲː e
вырисовываться	v ɨ rʲ ɪ s o v ɨ v ə t͡s ə
опасения	ɐ p ɐ sʲ e nʲ ɪ j ə
сливами	s ⁽ʲ ⁾ lʲ i v ə mʲ ɪ
опушайся	ɐ p ʊ ʂ a j sʲ ə
похвалилась	p ə x v ɐ lʲ i ɫ ə sʲ
околёсицах	ɐ k ɐ lʲ ɵ sʲ ɪ t͡s ə x
дополнивший	d ɐ p o ɫ nʲ ɪ f ʂ ɨ j
понудит	p ɐ n u dʲ ɪ t
воздевший	v ɐ zʲ dʲ e f ʂ ɨ j
урезывав	ʊ rʲ e z ɨ v ə f
растревоживая	r ə s t rʲ ɪ v o ʐ ɨ v ə j ə
расправа	r ɐ s p r a v ə
ризе	rʲ i zʲ e
гостьей	ɡ o sʲ tʲ j ɪ j
ранетки	r ɐ nʲ e t kʲ ɪ
прорежется	p r ɐ rʲ e ʐ ɨ t͡s ə
сеновал	sʲ ɪ n ɐ v a ɫ
ангстрем	a n k s t r ɨ m
мазом	m a z ə m
ку	k u
баклага	b ɐ k ɫ a ɡ ə
изведав	ɪ z vʲ e d ə f
свинина	s vʲ ɪ nʲ i n ə
вскинул	f s kʲ i n ʊ ɫ
натянешься	n ɐ tʲ æ nʲ ɪ ʂ sʲ ə
звенеть	z vʲ ɪ nʲ e tʲ
рябинам	rʲ æ bʲ ɪ n ə m
прокрадываетесь	p r ɐ k r a d ɨ v ə j ɪ tʲ ɪ sʲ
удостоверял	ʊ d ə s t ə vʲ ɪ rʲ a ɫ
рельефам	rʲ ɪ lʲ j e f ə m
ставивши	s t a vʲ ɪ f ʂ ɨ
эклер	ɪ k lʲ e r
обрушивают	ɐ b r u ʂ ɨ v ə j ʊ t
переутомлении	pʲ ɪ rʲ ɪ ʊ t ɐ m lʲ e nʲ ɪ ɪ
обнадёживай	ɐ b n ɐ dʲ ɵ ʐ ɨ v ə j
прошлось	p r ɐ ʂ ɫ o sʲ
текилах	tʲ ɪ kʲ i ɫ ə x
довлело	d ɐ v lʲ e ɫ ə
зимовав	zʲ ɪ m ɐ v a f
проиграешь	p r ə ɪ ɡ r a j ɪ ʂ
ошарашить	ɐ ʂ ɐ r a ʂ ɨ tʲ
установит	ʊ s t ɐ n o vʲ ɪ t
темпераментами	tʲ ɪ m ⁽ʲ ⁾ pʲ ɪ r a mʲ ɪ n t ə mʲ ɪ
потребностях	p ɐ t rʲ e b n ə sʲ tʲ ə x
абстракционистский	ɐ p s t r ə k t͡s ɨ ɐ nʲ i s t͡s kʲ ɪ j
повторяющийся	p ə f t ɐ rʲ æ j ʉ ɕː ɪ j sʲ ə
сжалятся	ʐː a lʲ ə t͡s ə
мантиями	m a nʲ tʲ ɪ j ə mʲ ɪ
раскрадывают	r ɐ s k r a d ɨ v ə j ʊ t
западало	z ɐ p a d ə ɫ ə
запрудой	z ɐ p r u d ə j
шампуня	ʂ ɐ m p u nʲ ə
триатлонов	t rʲ ɪ ɐ t ɫ o n ə f
ознакомлюсь	ɐ z n ɐ k o m lʲ ʉ sʲ
тучности	t u t͡ɕ n ə sʲ tʲ ɪ
дозрею	d ɐ z rʲ e j ʊ
балдел	b ɐ ɫ dʲ e ɫ
видайся	vʲ ɪ d a j sʲ ə
киноаппаратом	kʲ ɪ n ɐ ɐ p ɐ r a t ə m
клюсям	k lʲ ʉ sʲ ə m
всклокоченный	f s k ɫ ɐ k o t͡ɕ ɪ nː ɨ j
тупишь	t u pʲ ɪ ʂ
накачиваешь	n ɐ k a t͡ɕ ɪ v ə j ɪ ʂ
невежественна	nʲ ɪ vʲ e ʐ ɨ s t vʲ ɪ nː ə
дорыла	d ɐ r ɨ ɫ ə
тахометра	t ɐ x o mʲ ɪ t r ə
юлиана	j ʉ lʲ ɪ a n ə
припарка	p rʲ ɪ p a r k ə
барбершопу	b ə r bʲ ɪ r ʂ o p ʊ
печалиться	pʲ ɪ t͡ɕ æ lʲ ɪ t͡s ə
дружила	d r ʊ ʐ ɨ ɫ ə
сколиоза	s k ə lʲ ɪ o z ə
простите	p r ɐ sʲ tʲ i tʲ e
кибиток	kʲ ɪ bʲ i t ə k
общо	ɐ p ɕː ɵ
сослагаете	s ə s ɫ ɐ ɡ a j ɪ tʲ e
чернуху	t͡ɕ ɪ r n u x ʊ
истребишь	ɪ s t rʲ ɪ bʲ i ʂ
лаская	ɫ ɐ s k a j ə
летящий	lʲ ɪ tʲ æ ɕː ɪ j
мнусь	m n u sʲ
втиснуть	f tʲ i s n ʊ tʲ
нагревают	n ə ɡ rʲ ɪ v a j ʊ t
поубавься	p ə ʊ b a f ⁽ʲ ⁾ sʲ ə
обложитесь	ɐ b ɫ o ʐ ɨ tʲ ɪ sʲ
варшавянин	v ə r ʂ ɐ vʲ æ nʲ ɪ n
подданству	p o dː ə n s t v ʊ
манипуляция	m ə nʲ ɪ p ʊ lʲ a t͡s ɨ j ə
борющийся	b o rʲ ʉ ɕː ɪ j sʲ ə
затащу	z ə t ɐ ɕː u
лайкнувший	ɫ a j k n ʊ f ʂ ɨ j
капиталовложениями	k ə pʲ ɪ t ə ɫ ə v ɫ ɐ ʐ ɛ nʲ ɪ j ə mʲ ɪ
холодавши	x ə ɫ ɐ d a f ʂ ɨ
отчисляем	ɐ t͡ɕː ɪ s ⁽ʲ ⁾ lʲ æ j ɪ m
отчужу	ɐ t͡ɕː ʊ ʐ u
неверными	nʲ ɪ vʲ e r n ɨ mʲ ɪ
поклонничество	p ɐ k ɫ o nʲː ɪ t͡ɕ ɪ s t v ə
фонами	f o n ə mʲ ɪ
переносиц	pʲ ɪ rʲ ɪ n o sʲ ɪ t͡s
вбегаю	v ⁽ʲ ⁾ bʲ ɪ ɡ a j ʊ
щитам	ɕː ɪ t a m
бомбистах	b ɐ m ⁽ʲ ⁾ bʲ i s t ə x
новоангличанах	n o v ɐ ɐ n ɡ lʲ ɪ t͡ɕ a n ə x
певчих	pʲ e f t͡ɕ ɪ x
убив	ʊ bʲ i f
лебедята	lʲ ɪ bʲ ɪ dʲ a t ə
заносу	z ɐ n o s ʊ
обыгравший	ɐ b ɨ ɡ r a f ʂ ɨ j
волкодава	v ə ɫ k ɐ d a v ə
предписываться	p rʲ ɪ t pʲ i s ɨ v ə t͡s ə
пакистанцы	p ə kʲ ɪ s t a n t͡s ɨ
смрадишь	s m r a dʲ ɪ ʂ
отборы	ɐ d b o r ɨ
разрознивши	r ɐ z r o zʲ nʲ ɪ f ʂ ɨ
пригибают	p rʲ ɪ ɡʲ ɪ b a j ʊ t
толщами	t o ɫ ɕː ə mʲ ɪ
разыгрывайся	r ɐ z ɨ ɡ r ɨ v ə j sʲ ə
упираюсь	ʊ pʲ ɪ r a j ʉ sʲ
маточный	m a t ə t͡ɕ n ɨ j
весёлостью	vʲ ɪ sʲ ɵ ɫ ə sʲ tʲ j ʊ
затворять	z ə t v ɐ rʲ æ tʲ
сплетавший	s p lʲ ɪ t a f ʂ ɨ j
слобода	s ɫ ə b ɐ d a
ожидая	ɐ ʐ ɨ d a j ə
прогудевший	p r ə ɡ ʊ dʲ e f ʂ ɨ j
обкатываю	ɐ p k a t ɨ v ə j ʊ
выпечкам	v ɨ pʲ ɪ t͡ɕ k ə m
бездн	bʲ e z d n
прожёвываемый	p r ɐ ʐ o v ɨ v ə j ɪ m ɨ j
каске	k a s kʲ e
княжества	k nʲ a ʐ ɨ s t v ə
впущенный	f p u ɕː ɪ nː ɨ j
выкраивал	v ɨ k r a ɪ v ə ɫ
самоконтроль	s ə m ə k ɐ n t r o lʲ
натерпелся	n ə tʲ ɪ r pʲ e ɫ s ⁽ʲ ⁾ ə
шлемами	ʂ lʲ e m ə mʲ ɪ
пестуйте	pʲ e s t ʊ j tʲ e
закидонами	z ə kʲ ɪ d o n ə mʲ ɪ
закусила	z ə k ʊ sʲ i ɫ ə
поджигательницы	p ə d͡ʐ ʐ ɨ ɡ a tʲ ɪ lʲ nʲ ɪ t͡s ɨ
причинить	p rʲ ɪ t͡ɕ ɪ nʲ i tʲ
губерниях	ɡ ʊ bʲ e r nʲ ɪ j ə x
курилось	k ʊ rʲ i ɫ ə sʲ
увольняющий	ʊ v ɐ lʲ nʲ æ j ʉ ɕː ɪ j
мигаешь	mʲ ɪ ɡ a j ɪ ʂ
бабахал	b ɐ b a x ə ɫ
тварях	t v a rʲ ə x
сердцебиениях	sʲ ɪ r t͡s ɨ bʲ ɪ j e nʲ ɪ j ə x
лесоматериалам	lʲ e s ə m ə tʲ ɪ rʲ ɪ a ɫ ə m
всовавши	f s ɐ v a f ʂ ɨ
окаю	o k ə j ʊ
скатываешься	s k a t ɨ v ə j ɪ ʂ sʲ ə
феминизмом	fʲ ɪ mʲ ɪ nʲ i z m ə m
жанров	ʐ a n r ə f
заверещать	z ə vʲ ɪ rʲ ɪ ɕː æ tʲ
телетекстах	tʲ e lʲ ɪ tʲ e k s t ə x
отворачивай	ɐ t v ɐ r a t͡ɕ ɪ v ə j
поставимся	p ɐ s t a vʲ ɪ m sʲ ə
залепляя	z ə lʲ ɪ p lʲ æ j ə
очертанию	ɐ t͡ɕ ɪ r t a nʲ ɪ j ʊ
чревами	t͡ɕ rʲ e v ə mʲ ɪ
утята	ʊ tʲ a t ə
вжал	v ʐ a ɫ
объедок	ɐ b j e d ə k
воевод	v ə j ɪ v o t
поминках	p ɐ mʲ i n k ə x
раскисла	r ɐ s kʲ i s ɫ ə
заявляешь	z ə j ɪ v lʲ æ j ɪ ʂ
дисгармониею	dʲ ɪ z ɡ ɐ r m o nʲ ɪ j ɪ j ʊ
комиссиями	k ɐ mʲ i sʲ ɪ j ə mʲ ɪ
бренчим	b rʲ ɪ nʲ t͡ɕ i m
отдалась	ɐ dː ɐ ɫ a sʲ
бросьте	b r o sʲ tʲ e
трахнусь	t r a x n ʊ sʲ
дальнобойщиках	d ə lʲ n ɐ b o j ɕː ɪ k ə x
арбалетом	ɐ r b ɐ lʲ e t ə m
бекасу	bʲ ɪ k a s ʊ
хозяева	x ɐ zʲ æ j ɪ v ə
сбербанки	z bʲ ɪ r b a n kʲ ɪ
причитывайте	p rʲ ɪ t͡ɕ i t ɨ v ə j tʲ e
оплыли	ɐ p ɫ ɨ lʲ ɪ
зачёркиваемый	z ɐ t͡ɕ ɵ r kʲ ɪ v ə j ɪ m ɨ j
печататься	pʲ ɪ t͡ɕ a t ə t͡s ə
рекламистами	rʲ ɪ k ɫ ɐ mʲ i s t ə mʲ ɪ
растило	r ɐ sʲ tʲ i ɫ ə
вклинивавшийся	f k lʲ i nʲ ɪ v ə f ʂ ɨ j sʲ ə
рукоположивший	r ʊ k ə p ə ɫ ɐ ʐ ɨ f ʂ ɨ j
мхом	m x o m
киноактрисой	kʲ i n ɐ ɐ k t rʲ i s ə j
компартиях	k ɐ m p a r tʲ ɪ j ə x
дифференциальный	dʲ ɪ fʲ ɪ rʲ ɪ n t͡s ɨ a lʲ n ɨ j
заставав	z ə s t ɐ v a f
преломлял	p rʲ ɪ ɫ ɐ m lʲ a ɫ
колесить	k ə lʲ ɪ sʲ i tʲ
полозьям	p ɐ ɫ o zʲ j ə m
заела	z ɐ j e ɫ ə
смотрелось	s m ɐ t rʲ e ɫ ə sʲ
загар	z ɐ ɡ a r
разраставшись	r ə z r ɐ s t a f ʂ ɨ sʲ
типажах	tʲ ɪ p ɐ ʐ a x
виадуке	vʲ ɪ ɐ d u kʲ e
него	nʲ ɪ v o
поговорите	p ə ɡ ə v ɐ rʲ i tʲ e
заторов	z ɐ t o r ə f
усмотри	ʊ s m ɐ t rʲ i
свистела	s vʲ ɪ sʲ tʲ e ɫ ə
нарекла	n ə rʲ ɪ k ɫ a
опоссумом	ɐ p o s ʊ m ə m
нахмурюсь	n ɐ x m u rʲ ʉ sʲ
выписало	v ɨ pʲ ɪ s ə ɫ ə
питомце	pʲ ɪ t o m t͡s ɨ
пустякам	p ʊ sʲ tʲ ɪ k a m
сочувствовала	s ɐ t͡ɕ u s t v ə v ə ɫ ə
кипите	kʲ ɪ pʲ i tʲ e
наезжала	n ə j ɪ ʐː a ɫ ə
отделается	ɐ dʲː e ɫ ə j ɪ t͡s ə
флексией	f lʲ e k sʲ ɪ j ɪ j
бандеролью	b ə n d ɨ r o lʲ j ʊ
заразятся	z ə r ɐ zʲ a t͡sː ə
распарила	r ɐ s p a rʲ ɪ ɫ ə
бонбоньеркою	b ə n b ɐ nʲ j e r k ə j ʊ
висело	vʲ ɪ sʲ e ɫ ə
тушуй	t ʊ ʂ u j
западаешь	z ɐ p a d ə j ɪ ʂ
шкете	ʂ kʲ e tʲ e
чуме	t͡ɕ ʉ mʲ e
мужской	m ʊ ʂ s k o j
оптимизирует	ɐ p tʲ ɪ mʲ ɪ zʲ i r ʊ j ɪ t
затаптывающий	z ɐ t a p t ɨ v ə j ʉ ɕː ɪ j
осведомляющийся	ɐ s vʲ ɪ d ɐ m lʲ æ j ʉ ɕː ɪ j sʲ ə
совершатся	s ə vʲ ɪ r ʂ a t͡sː ə
заслушиваться	z ɐ s ɫ u ʂ ɨ v ə t͡s ə
разгибаться	r ə z ɡʲ ɪ b a t͡sː ə
освещали	ɐ s vʲ ɪ ɕː æ lʲ ɪ
ощетинила	ɐ ɕː ɪ tʲ i nʲ ɪ ɫ ə
хищения	xʲ ɪ ɕː e nʲ ɪ j ə
разрастался	r ə z r ɐ s t a ɫ s ⁽ʲ ⁾ ə
устрашим	ʊ s t r ɐ ʂ ɨ m
анусах	a n ʊ s ə x
громящий	ɡ r ɐ mʲ æ ɕː ɪ j
ура	ʊ r a
провернуть	p r ə vʲ ɪ r n u tʲ
старцы	s t a r t͡s ɨ
виноделам	vʲ ɪ n ɐ dʲ e ɫ ə m
попеть	p ɐ pʲ e tʲ
минчанками	mʲ ɪ nʲ t͡ɕ a n k ə mʲ ɪ
снисходили	sʲ nʲ ɪ s x ɐ dʲ i lʲ ɪ
генетикам	ɡʲ ɪ n ɛ tʲ ɪ k ə m
придерусь	p rʲ ɪ dʲ ɪ r u sʲ
решалось	rʲ ɪ ʂ a ɫ ə sʲ
обустраивать	ɐ b ʊ s t r a ɪ v ə tʲ
дотягивающийся	d ɐ tʲ æ ɡʲ ɪ v ə j ʉ ɕː ɪ j sʲ ə
мякните	mʲ a k nʲ ɪ tʲ e
нокаута	n ɐ k a ʊ t ə
разноцветен	r ə z n ɐ t͡s vʲ e tʲ ɪ n
убежим	ʊ bʲ ɪ ʐ ɨ m
отворачивающийся	ɐ t v ɐ r a t͡ɕ ɪ v ə j ʉ ɕː ɪ j sʲ ə
кириллицею	kʲ ɪ rʲ i lʲ ɪ t͡s ɨ j ʊ
прыщавый	p r ɨ ɕː a v ɨ j
устраним	ʊ s t r ɐ nʲ i m
комбинируешь	k ə m ⁽ʲ ⁾ bʲ ɪ nʲ i r ʊ j ɪ ʂ
хахари	x a x ə rʲ ɪ
посодействовать	p ə s ɐ dʲ e j s t v ə v ə tʲ
насекомом	n ə sʲ ɪ k o m ə m
крошкою	k r o ʂ k ə j ʊ
ремиксов	rʲ ɪ mʲ i k s ə f
ночники	n ə t͡ɕ nʲ ɪ kʲ i
кромкой	k r o m k ə j
фальшивите	f ɐ lʲ ʂ ɨ vʲ ɪ tʲ e
святою	s vʲ ɪ t o j ʊ
безобразием	bʲ ɪ z ɐ b r a zʲ ɪ j ɪ m
лесосплавами	lʲ ɪ s ɐ s p ɫ a v ə mʲ ɪ
населяв	n ə sʲ ɪ lʲ a f
поросла	p ə r ɐ s ɫ a
мачизмов	m ɐ t͡ɕ i z m ə f
печатании	pʲ ɪ t͡ɕ a t ə nʲ ɪ ɪ
протестуешь	p r ə tʲ ɪ s t u j ɪ ʂ
дугу	d ʊ ɡ u
бутафорией	b ʊ t ɐ f o rʲ ɪ j ɪ j
расслабляться	r ə sː ɫ ɐ b lʲ a t͡sː ə
выловят	v ɨ ɫ ə vʲ ə t
сгущая	z ɡ ʊ ɕː æ j ə
отщепляйте	ɐ t͡ɕ ɕː ɪ p lʲ æ j tʲ e
смахиваю	s m a xʲ ɪ v ə j ʊ
подкормила	p ə t k ɐ r mʲ i ɫ ə
расселив	r ə sʲː ɪ lʲ i f
опушив	ɐ p ʊ ʂ ɨ f
упрятав	ʊ p rʲ a t ə f
воображал	v ɐ ɐ b r ɐ ʐ a ɫ
чуланчиков	t͡ɕ ʊ ɫ a nʲ t͡ɕ ɪ k ə f
дублин	d u b lʲ ɪ n
благоприличиями	b ɫ ə ɡ ə p rʲ ɪ lʲ i t͡ɕ ɪ j ə mʲ ɪ
сослуживший	s ə s ɫ ʊ ʐ ɨ f ʂ ɨ j
проведши	p r ɐ vʲ e t͡ʂ ʂ ɨ
фасолей	f ɐ s o lʲ ɪ j
мироточение	mʲ ɪ r ə t ɐ t͡ɕ e nʲ ɪ j e
миньетчиком	mʲ ɪ nʲ j e t͡ɕː ɪ k ə m
глашу	ɡ ɫ ɐ ʂ u
подвозите	p ɐ d v o zʲ ɪ tʲ e
анализирует	ɐ n ə lʲ ɪ zʲ i r ʊ j ɪ t
вампирах	v ɐ m ⁽ʲ ⁾ pʲ i r ə x
подвыло	p ɐ d v ɨ ɫ ə
лад	ɫ a t
подери	p ə dʲ ɪ rʲ i
повеянный	p ɐ vʲ e j ɪ nː ɨ j
амбарный	ɐ m b a r n ɨ j
потопталось	p ə t ɐ p t a ɫ ə sʲ
катеров	k ə tʲ ɪ r o f
слепнем	s ⁽ʲ ⁾ lʲ e p nʲ ɪ m
попыталось	p ə p ɨ t a ɫ ə sʲ
валенком	v a lʲ ɪ n k ə m
пионеров	pʲ ɪ ɐ nʲ e r ə f
сосками	s o s k ə mʲ ɪ
насыщаюсь	n ə s ɨ ɕː æ j ʉ sʲ
опьянивший	ɐ p ⁽ʲ ⁾ j ɪ nʲ i f ʂ ɨ j
гугл	ɡ u ɡ ɫ
возмужалый	v ə z m ʊ ʐ a ɫ ɨ j
повадились	p ɐ v a dʲ ɪ lʲ ɪ sʲ
сместивший	s mʲ ɪ sʲ tʲ i f ʂ ɨ j
пневмонии	p nʲ ɪ v m ɐ nʲ i ɪ
сгруппировалась	z ɡ r ʊ pʲ ɪ r ɐ v a ɫ ə sʲ
входивши	f x ɐ dʲ i f ʂ ɨ
выплачивавшийся	v ɨ p ɫ a t͡ɕ ɪ v ə f ʂ ɨ j sʲ ə
опешим	ɐ pʲ e ʂ ɨ m
клавдия	k ɫ a v dʲ ɪ j ə
вялостей	vʲ a ɫ ə sʲ tʲ ɪ j
соизволением	s ə ɪ z v ɐ lʲ e nʲ ɪ j ɪ m
владиславом	v ɫ ə dʲ ɪ s ɫ a v ə m
вакансию	v ɐ k a n ⁽ʲ ⁾ sʲ ɪ j ʊ
лодыря	ɫ o d ɨ rʲ ə
разбувшись	r ɐ z b u f ʂ ɨ sʲ
сосуществованиях	s ə s ʊ ɕː ɪ s t v ɐ v a nʲ ɪ j ə x
виолончелях	vʲ ɪ ə ɫ ɐ nʲ t͡ɕ e lʲ ə x
навигация	n ə vʲ ɪ ɡ a t͡s ɨ j ə
пересматривал	pʲ ɪ rʲ ɪ s m a t rʲ ɪ v ə ɫ
африкандерах	ɐ f rʲ ɪ k a n d ɨ r ə x
обогните	ɐ b ɐ ɡ nʲ i tʲ e
мешковиною	mʲ ɪ ʂ k ɐ vʲ i n ə j ʊ
размазывая	r ɐ z m a z ɨ v ə j ə
ручьёв	r ʊ t͡ɕ j ɵ f
властолюбия	v ɫ ə s t ɐ lʲ ʉ bʲ ɪ j ə
зачарует	z ə t͡ɕ ɪ r u j ɪ t
перемычка	pʲ ɪ rʲ ɪ m ɨ t͡ɕ k ə
перебрасывающийся	pʲ ɪ rʲ ɪ b r a s ɨ v ə j ʉ ɕː ɪ j sʲ ə
треклистах	t r ɨ k lʲ ɪ s t a x
жестокий	ʐ ɨ s t o kʲ ɪ j
отстроила	ɐ t͡s s t r o ɪ ɫ ə
нива	nʲ i v ə
кликала	k lʲ i k ə ɫ ə
выплёвывал	v ɨ p lʲ ɵ v ɨ v ə ɫ
пофигизмами	p ə fʲ ɪ ɡʲ i z m ə mʲ ɪ
подмечавший	p ə d mʲ ɪ t͡ɕ a f ʂ ɨ j
кирпич	kʲ ɪ r pʲ i t͡ɕ
заутрень	z ɐ u t rʲ ɪ nʲ
пуза	p u z ə
тарифов	t ɐ rʲ i f ə f
чемпионами	t͡ɕ ɪ m ⁽ʲ ⁾ pʲ ɪ o n ə mʲ ɪ
радары	r ɐ d a r ɨ
сберкнижками	z bʲ ɪ r k nʲ i ʂ k ə mʲ ɪ
диску	dʲ i s k ʊ
оканчивавшись	ɐ k a nʲ t͡ɕ ɪ v ə f ʂ ɨ sʲ
вёсла	vʲ ɵ s ɫ ə
продержится	p r ɐ dʲ e r ʐ ɨ t͡s ə
навьючивший	n ɐ v ⁽ʲ ⁾ j ʉ t͡ɕ ɪ f ʂ ɨ j
просвире	p r ə s vʲ ɪ rʲ e
пролетария	p r ə lʲ ɪ t a rʲ ɪ j ə
шарахать	ʂ ɐ r a x ə tʲ
дозоров	d ɐ z o r ə f
сынок	s ɨ n o k
лесокатки	lʲ e s ɐ k a t kʲ ɪ
рефераты	rʲ ɪ fʲ ɪ r a t ɨ
бельгия	bʲ e lʲ ɡʲ ɪ j ə
ознакомляемся	ɐ z n ə k ɐ m lʲ æ j ɪ m sʲ ə
плацах	p ɫ a t͡s ə x
совершенный	s ə vʲ ɪ r ʂ ɛ nː ɨ j
интегралом	ɪ n t ɨ ɡ r a ɫ ə m
теплотрассе	tʲ ɪ p ɫ ɐ t r a sʲː e
британцев	b rʲ ɪ t a n t͡s ɨ f
уединявшись	ʊ j ɪ dʲ ɪ nʲ a f ʂ ɨ sʲ
буферах	b ʊ fʲ ɪ r a x
технократию	tʲ ɪ x n ɐ k r a tʲ ɪ j ʊ
кристаллизуй	k rʲ ɪ s t ə lʲ ɪ z u j
моем	m o j ɪ m
благословимся	b ɫ ə ɡ ə s ɫ ɐ vʲ i m sʲ ə
тротуару	t r ə t ʊ a r ʊ
лицензиар	lʲ ɪ t͡s ɨ n ⁽ʲ ⁾ zʲ ɪ a r
накрахмаливала	n ə k r ɐ x m a lʲ ɪ v ə ɫ ə
ударяемся	ʊ d ɐ rʲ æ j ɪ m sʲ ə
литром	lʲ i t r ə m
заправляем	z ə p r ɐ v lʲ æ j ɪ m
буржуазны	b ʊ r ʐ ʊ a z n ɨ
рожаете	r ɐ ʐ a j ɪ tʲ e
речёвках	rʲ ɪ t͡ɕ ɵ f k ə x
просветлевший	p r ə s vʲ ɪ t lʲ e f ʂ ɨ j
накрахмальте	n ə k r ɐ x m a lʲ tʲ e
видывали	vʲ i d ɨ v ə lʲ ɪ
подтянитесь	p ə tʲː ɪ nʲ i tʲ ɪ sʲ
нёсши	nʲ ɵ ʂː ɨ
беспощадно	bʲ ɪ s p ɐ ɕː a d n ə
бризантностях	b rʲ ɪ z a n t n ə sʲ tʲ ə x
обретайтесь	ɐ b rʲ ɪ t a j tʲ ɪ sʲ
вметут	v mʲ ɪ t u t
мыслителях	m ɨ s ⁽ʲ ⁾ lʲ i tʲ ɪ lʲ ə x
стойлами	s t o j ɫ ə mʲ ɪ
сковывай	s k o v ɨ v ə j
фейсконтролей	f ɛ j s k ɐ n t r o lʲ ɪ j
душевыми	d ʊ ʂ ɨ v ɨ mʲ ɪ
редакция	rʲ ɪ d a k t͡s ɨ j ə
поблагодарить	p ə b ɫ ə ɡ ə d ɐ rʲ i tʲ
узлом	ʊ z ɫ o m
прочувствовало	p r ɐ t͡ɕ u s t v ə v ə ɫ ə
искалечило	ɪ s k ɐ lʲ e t͡ɕ ɪ ɫ ə
параллелен	p ə r ɐ lʲ e lʲ ɪ n
наморщите	n ɐ m o r ɕː ɪ tʲ e
коренившись	k ə rʲ ɪ nʲ i f ʂ ɨ sʲ
понадеются	p ə n ɐ dʲ e j ʊ t͡s ə
зарастите	z ə r ɐ sʲ tʲ i tʲ e
ободам	o b ə d ə m
устремлённостей	ʊ s t rʲ ɪ m lʲ ɵ nː ə sʲ tʲ ɪ j
объезжав	ɐ b j ɪ ʐː a f
обличав	ɐ b lʲ ɪ t͡ɕ a f
энергоносители	ɪ n ɛ r ɡ ə n ɐ sʲ i tʲ ɪ lʲ ɪ
исписывало	ɪ s pʲ i s ɨ v ə ɫ ə
киноплёнках	kʲ ɪ n ɐ p lʲ ɵ n k ə x
куриц	k u rʲ ɪ t͡s
афты	a f t ɨ
тушёнками	t ʊ ʂ o n k ə mʲ ɪ
порастёт	p ə r ɐ sʲ tʲ ɵ t
отношению	ɐ t n ɐ ʂ ɛ nʲ ɪ j ʊ
появиться	p ə j ɪ vʲ i t͡sː ə
постылевший	p ɐ s t ɨ lʲ ɪ f ʂ ɨ j
объедаемый	ɐ b j ɪ d a j ɪ m ɨ j
упомянитесь	ʊ p ə mʲ ɪ nʲ i tʲ ɪ sʲ
излияниями	ɪ z ⁽ʲ ⁾ lʲ ɪ j æ nʲ ɪ j ə mʲ ɪ
проводница	p r ə v ɐ dʲ nʲ i t͡s ə
птаха	p t a x ə
отменимся	ɐ t mʲ e nʲ ɪ m sʲ ə
приводили	p rʲ ɪ v ɐ dʲ i lʲ ɪ
скороговорка	s k ə r ə ɡ ɐ v o r k ə
околицы	ɐ k o lʲ ɪ t͡s ɨ
штурмовой	ʂ t ʊ r m ɐ v o j
отповедь	o t p ə vʲ ɪ tʲ
полтаблетки	p o ɫ t ɐ b lʲ e t kʲ ɪ
курский	k u r s kʲ ɪ j
похожестях	p ɐ x o ʐ ɨ sʲ tʲ ə x
брайан	b r a j ɪ n
заблагорассудил	z ə b ɫ ə ɡ ə r ɐ sː u dʲ ɪ ɫ
свечнике	s vʲ ɪ t͡ɕ nʲ ɪ kʲ e
зондируем	z ɐ nʲ dʲ i r ʊ j ɪ m
патологоанатомию	p ɐ t o ɫ ə ɡ ɐ ɐ n ɐ t o mʲ ɪ j ʊ
изъяснят	ɪ z j ɪ sʲ nʲ a t
привинти	p rʲ ɪ vʲ ɪ nʲ tʲ i
годы	ɡ o d ɨ
ренессанса	r ɨ n ɨ s a n s ə
вклиниваемый	f k lʲ i nʲ ɪ v ə j ɪ m ɨ j
слиться	s ⁽ʲ ⁾ lʲ i t͡sː ə
недержания	nʲ ɪ dʲ ɪ r ʐ a nʲ ɪ j ə
отводившийся	ɐ t v ɐ dʲ i f ʂ ɨ j sʲ ə
уязвляя	ʊ j ɪ z v lʲ æ j ə
граничила	ɡ r ɐ nʲ i t͡ɕ ɪ ɫ ə
напряжённа	n ə p rʲ ɪ ʐ o nː ə
мотылькам	m ə t ɨ lʲ k a m
стремительно	s t rʲ ɪ mʲ i tʲ ɪ lʲ n ə
аккредитива	ɐ k rʲ ɪ dʲ ɪ tʲ i v ə
щепок	ɕː e p ə k
дружественен	d r u ʐ ɨ s t vʲ ɪ nʲ ɪ n
закопушкой	z ə k ɐ p u ʂ k ə j
звонарях	z v ə n ɐ rʲ a x
длительный	d lʲ i tʲ ɪ lʲ n ɨ j
лесоустройством	lʲ e s ə ʊ s t r o j s t v ə m
клянчу	k lʲ æ nʲ t͡ɕ ʊ
умеет	ʊ mʲ e j ɪ t
взяточниках	v zʲ a t ə t͡ɕ nʲ ɪ k ə x
обветренный	ɐ b vʲ e t rʲ ɪ nː ɨ j
множим	m n o ʐ ɨ m
заполонённый	z ə p ə ɫ ɐ nʲ ɵ nː ɨ j
апофизою	ɐ p ɐ fʲ i z ə j ʊ
тратите	t r a tʲ ɪ tʲ e
стряпухой	s t rʲ ɪ p u x ə j
клади	k ɫ a dʲ ɪ
эпифизах	ɪ pʲ ɪ fʲ i z ə x
новосельем	n ə v ɐ sʲ e lʲ j ɪ m
пупсиков	p u p sʲ ɪ k ə f
сущностью	s u ɕː n ə sʲ tʲ j ʊ
перевесила	pʲ ɪ rʲ ɪ vʲ e sʲ ɪ ɫ ə
влачимый	v ɫ ɐ t͡ɕ i m ɨ j
сманеврируют	s m ə nʲ ɪ v rʲ i r ʊ j ʊ t
сквозняке	s k v ə zʲ nʲ ɪ kʲ e
сузила	s u zʲ ɪ ɫ ə
поели	p ɐ j e lʲ ɪ
обвил	ɐ b vʲ i ɫ
двигают	d vʲ i ɡ ə j ʊ t
сокрушаясь	s ə k r ʊ ʂ a j ɪ sʲ
столетний	s t ɐ lʲ e tʲ nʲ ɪ j
родимся	r ɐ dʲ i m sʲ ə
выявишься	v ɨ j ɪ vʲ ɪ ʂ sʲ ə
родильный	r ɐ dʲ i lʲ n ɨ j
почуете	p ɐ t͡ɕ ʉ j ɪ tʲ e
красив	k r a sʲ ɪ f
насчёт	n ɐ ɕː ɵ t
сподвижник	s p ɐ d vʲ i ʐ nʲ ɪ k
владислава	v ɫ ə dʲ ɪ s ɫ a v ə
тамильским	t ɐ mʲ i lʲ s kʲ ɪ m
полетать	p ə lʲ ɪ t a tʲ
затопляемый	z ə t ɐ p lʲ æ j ɪ m ɨ j
плутон	p ɫ ʊ t o n
возглавляемый	v ə z ɡ ɫ ɐ v lʲ æ j ɪ m ɨ j
рассказикам	r ɐ sː k a zʲ ɪ k ə m
расходовали	r ɐ s x o d ə v ə lʲ ɪ
бороздим	b ə r ɐ zʲ dʲ i m
презумпциями	p rʲ ɪ z u m p t͡s ɨ j ə mʲ ɪ
гобелене	ɡ ə bʲ ɪ lʲ e nʲ e
военнослужащих	v ɐ j e nː ɐ s ɫ u ʐ ə ɕː ɪ x
воспетый	v ɐ s pʲ e t ɨ j
цедишь	t͡s ɛ dʲ ɪ ʂ
отстранявшись	ɐ t͡s s t r ɐ nʲ a f ʂ ɨ sʲ
приговаривайтесь	p rʲ ɪ ɡ ɐ v a rʲ ɪ v ə j tʲ ɪ sʲ
отопрём	ɐ t ɐ p rʲ ɵ m
мастерством	m ə sʲ tʲ ɪ r s t v o m
пирожник	pʲ ɪ r o ʐ nʲ ɪ k
поладив	p ɐ ɫ a dʲ ɪ f
волноломы	v ə ɫ n ɐ ɫ o m ɨ
труни	t r ʊ nʲ i
зарёк	z ɐ rʲ ɵ k
оробевший	ɐ r ɐ bʲ e f ʂ ɨ j
героинях	ɡʲ ɪ r ɐ i nʲ ə x
опоражнивала	ɐ p ɐ r a ʐ nʲ ɪ v ə ɫ ə
гуглите	ɡ u ɡ lʲ ɪ tʲ e
плюхайтесь	p lʲ u x ə j tʲ ɪ sʲ
волжан	v ɐ ɫ ʐ a n
водоснабжениях	v ə d ə s n ɐ b ʐ ɛ nʲ ɪ j ə x
стар	s t a r
изготовителя	ɪ z ɡ ə t ɐ vʲ i tʲ ɪ lʲ ə
разрешимый	r ə z rʲ ɪ ʂ ɨ m ɨ j
брюссельский	b rʲ ʉ sʲ e lʲ s kʲ ɪ j
строителю	s t r ɐ i tʲ ɪ lʲ ʊ
вытряхивает	v ɨ t rʲ æ xʲ ɪ v ə j ɪ t
кудесу	k ʊ dʲ e s ʊ
расшифровывал	r ə ʂː ɨ f r o v ɨ v ə ɫ
ручниками	r ʊ t͡ɕ nʲ ɪ k a mʲ ɪ
прогреть	p r ɐ ɡ rʲ e tʲ
снежки	sʲ nʲ ɪ ʂ kʲ i
вытряхнешь	v ɨ t rʲ ɪ x nʲ ɪ ʂ
подстраховал	p ə t͡s s t r ə x ɐ v a ɫ
распускавшись	r ə s p ʊ s k a f ʂ ɨ sʲ
досматривают	d ɐ s m a t rʲ ɪ v ə j ʊ t
бедняке	bʲ ɪ dʲ nʲ ɪ kʲ e
промашкам	p r ɐ m a ʂ k ə m
бомбометаниям	b o m b ə mʲ ɪ t a nʲ ɪ j ə m
токсичный	t ɐ k sʲ i t͡ɕ n ɨ j
впитываниями	f ⁽ʲ ⁾ pʲ i t ɨ v ə nʲ ɪ j ə mʲ ɪ
обхватов	ɐ p x v a t ə f
выскабливая	v ɨ s k a b lʲ ɪ v ə j ə
спокойствии	s p ɐ k o j s t vʲ ɪ ɪ
примеряйтесь	p rʲ ɪ mʲ e rʲ ɪ j tʲ ɪ sʲ
поучаствуете	p ə ʊ t͡ɕ a s t v ʊ j ɪ tʲ e
добавляться	d ə b ɐ v lʲ a t͡sː ə
проектировщики	p r ə ɪ k tʲ ɪ r o f ɕː ɪ kʲ ɪ
увенчался	ʊ vʲ ɪ nʲ t͡ɕ a ɫ s ⁽ʲ ⁾ ə
взмолились	v z m ɐ lʲ i lʲ ɪ sʲ
нидерландского	nʲ ɪ dʲ ɪ r ɫ a n t s k ə v ə
подворотне	p ə d v ɐ r o tʲ nʲ e
шоссейник	ʂ ɐ s ɛ j nʲ ɪ k
шахназаров	ʂ ə x n ɐ z a r ə f
асинхронный	ɐ sʲ ɪ n x r o nː ɨ j
кроет	k r o j ɪ t
нечеловеческий	nʲ ɪ t͡ɕ ɪ ɫ ɐ vʲ e t͡ɕ ɪ s kʲ ɪ j
сплетениями	s p lʲ ɪ tʲ e nʲ ɪ j ə mʲ ɪ
гостьях	ɡ o sʲ tʲ j ə x
осклабила	ɐ s k ɫ a bʲ ɪ ɫ ə
неустроенностям	nʲ ɪ ʊ s t r o j ɪ nː ə sʲ tʲ ə m
вкрался	f k r a ɫ s ⁽ʲ ⁾ ə
тормознув	t ə r m ɐ z n u f
хатах	x a t ə x
найдёнышей	n ɐ j dʲ ɵ n ɨ ʂ ɨ j
тружусь	t r ʊ ʐ u sʲ
затаптывавши	z ɐ t a p t ɨ v ə f ʂ ɨ
катафалке	k ə t ɐ f a ɫ kʲ e
узрю	ʊ z rʲ u
выливался	v ɨ lʲ ɪ v a ɫ s ⁽ʲ ⁾ ə
основе	ɐ s n o vʲ e
роках	r o k ə x
разветвляешь	r ə z vʲ ɪ t v lʲ æ j ɪ ʂ
наноса	n ɐ n o s ə
понизишься	p ɐ nʲ i zʲ ɪ ʂ sʲ ə
перемежало	pʲ ɪ rʲ ɪ mʲ ɪ ʐ a ɫ ə
охлопать	ɐ x ɫ o p ə tʲ
покрышка	p ɐ k r ɨ ʂ k ə
патокам	p a t ə k ə m
спорткомплексах	s p o r t k o m p lʲ ɪ k s ə x
подметайте	p ə d mʲ ɪ t a j tʲ e
непогрешимый	nʲ ɪ p ə ɡ rʲ ɪ ʂ ɨ m ɨ j
посовещаются	p ə s ə vʲ ɪ ɕː æ j ʊ t͡s ə
стипендий	sʲ tʲ ɪ pʲ e nʲ dʲ ɪ j
интриган	ɪ n t rʲ ɪ ɡ a n
переболевала	pʲ ɪ rʲ ɪ b ə lʲ ɪ v a ɫ ə
сходна	s x o d n ə
чтение	t͡ɕ tʲ e nʲ ɪ j e
учугов	ʊ t͡ɕ u ɡ ə f
утоли	ʊ t ɐ lʲ i
усиженный	ʊ sʲ i ʐ ɨ nː ɨ j
вседозволенностях	f sʲ ɪ d ɐ z v o lʲ ɪ nː ə sʲ tʲ ə x
верёвке	vʲ ɪ rʲ ɵ f kʲ e
проложивши	p r ə ɫ ɐ ʐ ɨ f ʂ ɨ
нахальничаете	n ɐ x a lʲ nʲ ɪ t͡ɕ ɪ j ɪ tʲ e
милитаризируя	mʲ ɪ lʲ ɪ t ə rʲ ɪ zʲ i r ʊ j ə
шайбах	ʂ a j b ə x
отвесим	ɐ t vʲ e sʲ ɪ m
отекаю	ɐ tʲ ɪ k a j ʊ
обнявши	ɐ b nʲ a f ʂ ɨ
прокладывающий	p r ɐ k ɫ a d ɨ v ə j ʉ ɕː ɪ j
приплясывать	p rʲ ɪ p lʲ a s ɨ v ə tʲ
уют	ʊ j u t
лишивший	lʲ ɪ ʂ ɨ f ʂ ɨ j
переиграешь	pʲ ɪ rʲ ɪ ɪ ɡ r a j ɪ ʂ
реликта	rʲ ɪ lʲ i k t ə
толщах	t o ɫ ɕː ə x
сачкуйте	s ɐ t͡ɕ k u j tʲ e
поносивший	p ə n ɐ sʲ i f ʂ ɨ j
завлечём	z ə v lʲ ɪ t͡ɕ ɵ m
больнаи	b ɐ lʲ n a ɪ
разработайте	r ə z r ɐ b o t ə j tʲ e
воображаем	v ɐ ɐ b r ɐ ʐ a j ɪ m
кроссовках	k r ɐ s o f k ə x
стрясавший	s t rʲ ɪ s a f ʂ ɨ j
афганского	ɐ v ɡ a n s k ə v ə
гримировкам	ɡ rʲ ɪ mʲ ɪ r o f k ə m
подкормке	p ɐ t k o r m kʲ e
вышибалу	v ɨ ʂ ɨ b a ɫ ʊ
обстановку	ɐ p s t ɐ n o f k ʊ
маток	m a t ə k
сумасброды	s ʊ m ɐ z b r o d ɨ
наносекундах	n a n ə sʲ ɪ k u n d ə x
светилось	s vʲ ɪ tʲ i ɫ ə sʲ
машите	m ɐ ʂ ɨ tʲ e
оскверняю	ɐ s k vʲ ɪ r nʲ æ j ʊ
изодрали	ɪ z ɐ d r a lʲ ɪ
радиями	r a dʲ ɪ j ə mʲ ɪ
промолвлю	p r ɐ m o ɫ v lʲ ʊ
выгрузчиками	v ɨ ɡ r ʊ ɕː ɪ k ə mʲ ɪ
простроилось	p r ɐ s t r o ɪ ɫ ə sʲ
стлались	s t ɫ a lʲ ɪ sʲ
стукнулся	s t u k n ʊ ɫ s ⁽ʲ ⁾ ə
отворачиваюсь	ɐ t v ɐ r a t͡ɕ ɪ v ə j ʉ sʲ
повалила	p ə v ɐ lʲ i ɫ ə
репликою	rʲ e p lʲ ɪ k ə j ʊ
ветшаем	vʲ ɪ t͡ʂ ʂ a j ɪ m
притягаете	p rʲ ɪ tʲ ɪ ɡ a j ɪ tʲ e
накачавший	n ə k ɐ t͡ɕ a f ʂ ɨ j
горгульею	ɡ ɐ r ɡ u lʲ j ɪ j ʊ
выдают	v ɨ d ɐ j u t
докатитесь	d ɐ k a tʲ ɪ tʲ ɪ sʲ
полутьмах	p ə ɫ ʊ tʲ m a x
спросонок	s p r ɐ s o n ə k
грызло	ɡ r ɨ z ɫ ə
развеивавши	r ɐ z vʲ e ɪ v ə f ʂ ɨ
компьютеризаций	k ə m ⁽ʲ ⁾ p ⁽ʲ ⁾ j ʊ t ɨ rʲ ɪ z a t͡s ɨ j
задумчивостями	z ɐ d u m t͡ɕ ɪ v ə sʲ tʲ ə mʲ ɪ
провидца	p r ɐ vʲ i t͡sː ə
призмой	p rʲ i z m ə j
анграпа	ɐ n ɡ r a p ə
ухаживавши	ʊ x a ʐ ɨ v ə f ʂ ɨ
патлам	p a t ɫ ə m
префикса	p rʲ e fʲ ɪ k s ə
умыслив	ʊ m ɨ s ⁽ʲ ⁾ lʲ ɪ f
рожью	r o ʐ j ʊ
обуевала	ɐ b ʊ j ɪ v a ɫ ə
усиках	u sʲ ɪ k ə x
сразив	s r ɐ zʲ i f
сигналю	sʲ ɪ ɡ n a lʲ ʊ
студнями	s t u dʲ nʲ ə mʲ ɪ
поджогами	p ɐ d͡ʐ ʐ o ɡ ə mʲ ɪ
бастурмою	b ə s t ʊ r m o j ʊ
лосося	ɫ ɐ s o sʲ ə
ябедой	j æ bʲ ɪ d ə j
товаропроизводителе	t ɐ v a r ə p r ə ɪ z v ɐ dʲ i tʲ ɪ lʲ e
предостерегать	p rʲ ɪ d ə sʲ tʲ ɪ rʲ ɪ ɡ a tʲ
полегай	p ə lʲ ɪ ɡ a j
оперативностью	ɐ pʲ ɪ r ɐ tʲ i v n ə sʲ tʲ j ʊ
сладким	s ɫ a t kʲ ɪ m
лепя	lʲ ɪ pʲ a
камням	k a m nʲ ə m
гуманизме	ɡ ʊ m ɐ nʲ i z mʲ e
охранило	ɐ x r ɐ nʲ i ɫ ə
харчем	x a r t͡ɕ ɪ m
обеспокоил	ɐ bʲ ɪ s p ɐ k o ɪ ɫ
моделировали	m ə d ɨ lʲ i r ə v ə lʲ ɪ
отловлю	ɐ t ɫ ɐ v lʲ u
люкс	lʲ u k s
запретам	z ɐ p rʲ e t ə m
расправилось	r ɐ s p r a vʲ ɪ ɫ ə sʲ
приколоть	p rʲ ɪ k ɐ ɫ o tʲ
завоюет	z ə v ɐ j ʉ j ɪ t
буквам	b u k v ə m
колбасите	k ɐ ɫ b a sʲ ɪ tʲ e
осмысливаемый	ɐ s m ɨ s ⁽ʲ ⁾ lʲ ɪ v ə j ɪ m ɨ j
природе	p rʲ ɪ r o dʲ e
бронетехникою	b r o nʲ ɪ tʲ e x nʲ ɪ k ə j ʊ
погоняем	p ə ɡ ɐ nʲ æ j ɪ m
загадит	z ɐ ɡ a dʲ ɪ t
нервничавший	nʲ e r v nʲ ɪ t͡ɕ ɪ f ʂ ɨ j
пуншах	p u n ʂ ə x
кошелях	k ə ʂ ɨ lʲ a x
развернувший	r ə z vʲ ɪ r n u f ʂ ɨ j
трудовой	t r ʊ d ɐ v o j
взмётываемый	v z mʲ ɵ t ɨ v ə j ɪ m ɨ j
перетягивавши	pʲ ɪ rʲ ɪ tʲ æ ɡʲ ɪ v ə f ʂ ɨ
похоронишь	p ə x ɐ r o nʲ ɪ ʂ
разгласят	r ə z ɡ ɫ ɐ sʲ a t
залепляла	z ə lʲ ɪ p lʲ a ɫ ə
юмористическая	j ʊ m ə rʲ ɪ sʲ tʲ i t͡ɕ ɪ s k ə j ə
застрелив	z ə s t rʲ ɪ lʲ i f
укрылся	ʊ k r ɨ ɫ s ⁽ʲ ⁾ ə
грозясь	ɡ r ɐ zʲ æ sʲ
разыгрался	r ə z ɨ ɡ r a ɫ s ⁽ʲ ⁾ ə
генпрокурорам	ɡʲ e n p r ə k ʊ r o r ə m
абстрактам	ɐ p s t r a k t ə m
блогер	b ɫ o ɡʲ ɪ r
кормёжками	k ɐ r mʲ ɵ ʂ k ə mʲ ɪ
контузим	k ɐ n t u zʲ ɪ m
перевешиваю	pʲ ɪ rʲ ɪ vʲ e ʂ ɨ v ə j ʊ
диагнозу	dʲ ɪ a ɡ n ə z ʊ
гривам	ɡ rʲ i v ə m
затирая	z ə tʲ ɪ r a j ə
направляющий	n ə p r ɐ v lʲ æ j ʉ ɕː ɪ j
хлопоты	x ɫ o p ə t ɨ
дорожкою	d ɐ r o ʂ k ə j ʊ
оспариваете	ɐ s p a rʲ ɪ v ə j ɪ tʲ e
разводились	r ə z v ɐ dʲ i lʲ ɪ sʲ
облюю	ɐ b lʲ ʉ j u
разгадкам	r ɐ z ɡ a t k ə m
засорю	z ə s ɐ rʲ u
коллажах	k ɐ ɫ a ʐ ə x
руководств	r ʊ k ɐ v o t͡s t f
отгадывай	ɐ d ɡ a d ɨ v ə j
кремниев	k rʲ e m nʲ ɪ j ɪ f
наместника	n ɐ mʲ e sʲ nʲ ɪ k ə
честнее	t͡ɕ ɪ sʲ nʲ e j e
надрывало	n ə d r ɨ v a ɫ ə
кочевнике	k ɐ t͡ɕ e v nʲ ɪ kʲ e
лярве	lʲ a r vʲ e
заносит	z ɐ n o sʲ ɪ t
керосином	kʲ ɪ r ɐ sʲ i n ə m
вышагнувши	v ɨ ʂ ə ɡ n ʊ f ʂ ɨ
распахиваясь	r ɐ s p a xʲ ɪ v ə j ɪ sʲ
капибарами	k ə pʲ ɪ b a r ə mʲ ɪ
катерочках	k ə tʲ ɪ r o t͡ɕ k ə x
атласов	a t ɫ ə s ə f
антидоте	ɐ nʲ tʲ ɪ d o tʲ e
созвать	s ɐ z v a tʲ
чалтыкам	t͡ɕ ɪ ɫ t ɨ k ə m
педиатрией	pʲ ɪ dʲ ɪ ɐ t rʲ i j ɪ j
завернуть	z ə vʲ ɪ r n u tʲ
поднимали	p ə dʲ nʲ ɪ m a lʲ ɪ
приземлилась	p rʲ ɪ zʲ ɪ m lʲ i ɫ ə sʲ
подрастала	p ə d r ɐ s t a ɫ ə
арумынкой	ɐ r ʊ m ɨ n k ə j
вставило	f s t a vʲ ɪ ɫ ə
теребейчук	tʲ ɪ rʲ ɪ bʲ ɪ j t͡ɕ u k
выспрашиваемый	v ɨ s p r a ʂ ɨ v ə j ɪ m ɨ j
фарисеями	f ə rʲ ɪ sʲ e j ə mʲ ɪ
категоричностей	k ə tʲ ɪ ɡ ɐ rʲ i t͡ɕ n ə sʲ tʲ ɪ j
предприимайте	p rʲ ɪ t p rʲ ɪ ɪ m a j tʲ e
закину	z ɐ kʲ i n ʊ
шевельнули	ʂ ɨ vʲ ɪ lʲ n u lʲ ɪ
мировыми	mʲ ɪ r ɐ v ɨ mʲ ɪ
хадиса	x ɐ dʲ i s ə
ущемлениями	ʊ ɕː ɪ m lʲ e nʲ ɪ j ə mʲ ɪ
пердеть	pʲ ɪ r dʲ e tʲ
реек	rʲ e j ɪ k
подъезжавши	p ə d j ɪ ʐː a f ʂ ɨ
упоминаются	ʊ p ə mʲ ɪ n a j ʊ t͡s ə
абазинкою	ɐ b ɐ zʲ i n k ə j ʊ
насытило	n ɐ s ɨ tʲ ɪ ɫ ə
доулах	d o ʊ ɫ ə x
попытками	p ɐ p ɨ t k ə mʲ ɪ
туалетам	t ʊ ɐ lʲ e t ə m
прилепляется	p rʲ ɪ lʲ ɪ p lʲ æ j ɪ t͡s ə
ревизия	rʲ ɪ vʲ i zʲ ɪ j ə
пришпилила	p rʲ ɪ ʂ pʲ i lʲ ɪ ɫ ə
капитализациям	k ə pʲ ɪ t ə lʲ ɪ z a t͡s ɨ j ə m
аврелий	ɐ v rʲ e lʲ ɪ j
бурундуком	b ʊ r ʊ n d ʊ k o m
сшили	ʂː ɨ lʲ ɪ
чуявши	t͡ɕ ʉ j ɪ f ʂ ɨ
испуги	ɪ s p u ɡʲ ɪ
куркумой	k ʊ r k u m ə j
наказаниями	n ə k ɐ z a nʲ ɪ j ə mʲ ɪ
инкубацией	ɪ n k ʊ b a t͡s ɨ j ɪ j
выказать	v ɨ k ə z ə tʲ
харьковчанах	x ə rʲ k ɐ f t͡ɕ a n ə x
раздвинулись	r ɐ z d vʲ i n ʊ lʲ ɪ sʲ
обнимало	ɐ b nʲ ɪ m a ɫ ə
подарочках	p ɐ d a r ə t͡ɕ k ə x
самосвалами	s ə m ɐ s v a ɫ ə mʲ ɪ
извлекут	ɪ z v lʲ ɪ k u t
анахоретов	ɐ n ə x ɐ rʲ e t ə f
уползаете	ʊ p ɐ ɫ z a j ɪ tʲ e
шаттлу	ʂ a t ɫ ʊ
городишь	ɡ ɐ r o dʲ ɪ ʂ
рогаликом	r ɐ ɡ a lʲ ɪ k ə m
выпрямлявшийся	v ɨ p rʲ ɪ m lʲ a f ʂ ɨ j sʲ ə
исцелявши	ɪ s t͡s ɨ lʲ a f ʂ ɨ
вмазывай	v m a z ɨ v ə j
сладкое	s ɫ a t k ə j ə
рефракторе	rʲ ɪ f r a k t ə rʲ e
картонах	k ɐ r t o n ə x
отдалять	ɐ dː ɐ lʲ æ tʲ
одиноко	ɐ dʲ ɪ n o k ə
давлениям	d ɐ v lʲ e nʲ ɪ j ə m
выломлю	v ɨ ɫ ə m lʲ ʊ
накренишь	n ə k rʲ ɪ nʲ i ʂ
олимпийкою	ɐ lʲ ɪ m ⁽ʲ ⁾ pʲ i j k ə j ʊ
уверовать	ʊ vʲ e r ə v ə tʲ
котелки	k ə tʲ ɪ ɫ kʲ i
набирав	n ə bʲ ɪ r a f
забора	z ɐ b o r ə
раскачиваемся	r ɐ s k a t͡ɕ ɪ v ə j ɪ m sʲ ə
возвышенно	v ɐ z v ɨ ʂ ɨ nː ə
туловищем	t u ɫ ə vʲ ɪ ɕː ɪ m
инфраструктурами	ɪ n f r ə s t r ʊ k t u r ə mʲ ɪ
намудри	n ə m ʊ d rʲ i
бондарням	b ɐ n d a r nʲ ə m
заплетайтесь	z ə p lʲ ɪ t a j tʲ ɪ sʲ
матрасами	m ɐ t r a s ə mʲ ɪ
маковках	m a k ə f k ə x
отворяв	ɐ t v ɐ rʲ a f
общагою	ɐ p ɕː a ɡ ə j ʊ
регистрируясь	rʲ ɪ ɡʲ ɪ s t rʲ i r ʊ j ɪ sʲ
заключайтесь	z ə k lʲ ʉ t͡ɕ æ j tʲ ɪ sʲ
деканаты	d ɨ k ɐ n a t ɨ
добывайся	d ə b ɨ v a j sʲ ə
твой	t v o j
пародируешь	p ə r ɐ dʲ i r ʊ j ɪ ʂ
аллергене	ɐ lʲ ɪ r ɡʲ e nʲ e
сигнализаций	sʲ ɪ ɡ n ə lʲ ɪ z a t͡s ɨ j
усваивать	ʊ s v a ɪ v ə tʲ
процедуру	p r ə t͡s ɨ d u r ʊ
облеплять	ɐ b lʲ ɪ p lʲ æ tʲ
взгромождавши	v z ɡ r ə m ɐ ʐ d a f ʂ ɨ
скелеты	s kʲ ɪ lʲ e t ɨ
отмывайте	ɐ t m ɨ v a j tʲ e
палит	p a lʲ ɪ t
подхваченный	p ɐ t x v a t͡ɕ ɪ nː ɨ j
вознамериваются	v ə z n ɐ mʲ e rʲ ɪ v ə j ʊ t͡s ə
пригревающий	p rʲ ɪ ɡ rʲ ɪ v a j ʉ ɕː ɪ j
бенгальский	bʲ ɪ n ɡ a lʲ s kʲ ɪ j
насытите	n ɐ s ɨ tʲ ɪ tʲ e
отказались	ɐ t k ɐ z a lʲ ɪ sʲ
крову	k r o v ʊ
повертит	p ɐ vʲ e r tʲ ɪ t
уполномоченный	ʊ p ə ɫ n ɐ m o t͡ɕ ɪ nː ɨ j
руконожках	r ʊ k ɐ n o ʂ k ə x
родословными	r ə d ɐ s ɫ o v n ɨ mʲ ɪ
флотский	f ɫ o t͡s kʲ ɪ j
укладчиками	ʊ k ɫ a t͡ɕː ɪ k ə mʲ ɪ
мале	m a lʲ e
намечаем	n ə mʲ ɪ t͡ɕ æ j ɪ m
надавайте	n ə d ɐ v a j tʲ e
ложечек	ɫ o ʐ ɨ t͡ɕ ɪ k
грязнуть	ɡ rʲ a z n ʊ tʲ
баловал	b a ɫ ə v ə ɫ
французе	f r ɐ n t͡s u zʲ e
безматку	bʲ ɪ z m a t k ʊ
баянистку	b ə j ɪ nʲ i s t k ʊ
ведавший	vʲ e d ə f ʂ ɨ j
льда	lʲ d a
заворачивающийся	z ə v ɐ r a t͡ɕ ɪ v ə j ʉ ɕː ɪ j sʲ ə
ветютнями	vʲ ɪ tʲ ʉ tʲ nʲ ə mʲ ɪ
скалишь	s k a lʲ ɪ ʂ
сплавы	s p ɫ a v ɨ
дозволение	d ə z v ɐ lʲ e nʲ ɪ j e
созналось	s ɐ z n a ɫ ə sʲ
предрасположите	p rʲ ɪ d r ə s p ɐ ɫ o ʐ ɨ tʲ e
прилетаю	p rʲ ɪ lʲ ɪ t a j ʊ
груздям	ɡ r ʊ zʲ dʲ a m
размежует	r ə z mʲ ɪ ʐ u j ɪ t
поправишь	p ɐ p r a vʲ ɪ ʂ
принимавшись	p rʲ ɪ nʲ ɪ m a f ʂ ɨ sʲ
откалибровывающую	ɐ t k ə lʲ ɪ b r o v ɨ v ə j ʉ ɕː ʉ j ʊ
скорчилась	s k o r t͡ɕ ɪ ɫ ə sʲ
пролепетавший	p r ə lʲ ɪ pʲ ɪ t a f ʂ ɨ j
струй	s t r u j
разглядишь	r ə z ɡ lʲ ɪ dʲ i ʂ
взяточникам	v zʲ a t ə t͡ɕ nʲ ɪ k ə m
подстрекателем	p ə t͡s s t rʲ ɪ k a tʲ ɪ lʲ ɪ m
беспокоить	bʲ ɪ s p ɐ k o ɪ tʲ
нагрянувший	n ɐ ɡ rʲ a n ʊ f ʂ ɨ j
утончаю	ʊ t ɐ nʲ t͡ɕ æ j ʊ
нацист	n ɐ t͡s ɨ s t
бадей	b ɐ dʲ e j
позавтракаю	p ɐ z a f t r ə k ə j ʊ
отопим	ɐ t o pʲ ɪ m
чайковский	t͡ɕ ɪ j k o f s kʲ ɪ j
фотокарточками	f ə t ɐ k a r t ə t͡ɕ k ə mʲ ɪ
запрягут	z ə p rʲ ɪ ɡ u t
попечениях	p ə pʲ ɪ t͡ɕ e nʲ ɪ j ə x
пейджер	p ɛ j d͡ʐ ʐ ɨ r
сохраняете	s ə x r ɐ nʲ æ j ɪ tʲ e
воздействуют	v ɐ zʲ dʲ e j s t v ʊ j ʊ t
барабанщику	b ə r ɐ b a nʲ ɕː ɪ k ʊ
елям	j e lʲ ə m
провайдеры	p r ɐ v a j d ɨ r ɨ
куркумы	k ʊ r k u m ɨ
адмотделом	a d m ɐ dʲː e ɫ ə m
шайтану	ʂ ɐ j t a n ʊ
кляпами	k lʲ a p ə mʲ ɪ
бляшка	b lʲ a ʂ k ə
операция	ɐ pʲ ɪ r a t͡s ɨ j ə
срастусь	s r ɐ s t u sʲ
шпионке	ʂ pʲ ɪ o n kʲ e
сорняком	s ə r nʲ ɪ k o m
продиравши	p r ə dʲ ɪ r a f ʂ ɨ
акцепторы	ɐ k t͡s ɛ p t ə r ɨ
приглядывавшийся	p rʲ ɪ ɡ lʲ a d ɨ v ə f ʂ ɨ j sʲ ə
плешь	p lʲ e ʂ
файликах	f a j lʲ ɪ k ə x
марева	m a rʲ ɪ v ə
уповать	ʊ p ɐ v a tʲ
необязательно	nʲ ɪ ə bʲ ɪ z a tʲ ɪ lʲ n ə
решавши	rʲ ɪ ʂ a f ʂ ɨ
показываясь	p ɐ k a z ɨ v ə j ɪ sʲ
венчания	vʲ ɪ nʲ t͡ɕ æ nʲ ɪ j ə
почти	p ɐ t͡ɕ tʲ i
окрылили	ɐ k r ɨ lʲ i lʲ ɪ
русифицируешься	r ʊ sʲ ɪ fʲ ɪ t͡s ɨ r ʊ j ɪ ʂ sʲ ə
приостанавливающийся	p rʲ ɪ ə s t ɐ n a v lʲ ɪ v ə j ʉ ɕː ɪ j sʲ ə
облупливаются	ɐ b ɫ u p lʲ ɪ v ə j ʊ t͡s ə
подпрыгну	p ɐ t p r ɨ ɡ n ʊ
литовцах	lʲ ɪ t o f t͡s ə x
набираем	n ə bʲ ɪ r a j ɪ m
замяло	z ɐ mʲ a ɫ ə
накалялась	n ə k ɐ lʲ a ɫ ə sʲ
просияло	p r ə sʲ ɪ j a ɫ ə
нарушится	n ɐ r u ʂ ɨ t͡s ə
синкансэном	sʲ ɪ n k ɐ n s ɛ n ə m
полиграфиях	p ə lʲ ɪ ɡ r a fʲ ɪ j ə x
вензаболеваний	vʲ e n z ə b ə lʲ ɪ v a nʲ ɪ j
увещавший	ʊ vʲ ɪ ɕː a f ʂ ɨ j
сложившись	s ɫ ɐ ʐ ɨ f ʂ ɨ sʲ
послушался	p ɐ s ɫ u ʂ ə ɫ s ⁽ʲ ⁾ ə
урочат	ʊ r o t͡ɕ ə t
приглядываем	p rʲ ɪ ɡ lʲ a d ɨ v ə j ɪ m
абецадло	ɐ b ɨ t͡s a d ɫ ə
эвтаназиями	ɪ f t ɐ n a zʲ ɪ j ə mʲ ɪ
помазанников	p ɐ m a z ə nʲː ɪ k ə f
убиенному	ʊ bʲ ɪ j e nː ə m ʊ
кебабах	kʲ ɪ b a b ə x
упроси	ʊ p r ɐ sʲ i
волчицам	v ɐ ɫ t͡ɕ i t͡s ə m
тапочек	t a p ə t͡ɕ ɪ k
смутили	s m ʊ tʲ i lʲ ɪ
ошибётесь	ɐ ʂ ɨ bʲ ɵ tʲ ɪ sʲ
закроет	z ɐ k r o j ɪ t
помидорами	p ə mʲ ɪ d o r ə mʲ ɪ
понимаетесь	p ə nʲ ɪ m a j ɪ tʲ ɪ sʲ
артистка	ɐ r tʲ i s t k ə
вжимаемся	v ʐ ɨ m a j ɪ m sʲ ə
просматриваете	p r ɐ s m a t rʲ ɪ v ə j ɪ tʲ e
вертишейке	vʲ ɪ r tʲ ɪ ʂ ɛ j kʲ e
долготе	d ə ɫ ɡ ɐ tʲ e
донах	d o n ə x
черемшах	t͡ɕ ɪ rʲ ɪ m ʂ a x
управляетесь	ʊ p r ɐ v lʲ æ j ɪ tʲ ɪ sʲ
добыть	d ɐ b ɨ tʲ
отмашу	ɐ t m ɐ ʂ u
суахили	s ʊ ɐ xʲ i lʲ ɪ
сотри	s ɐ t rʲ i
взвешивавши	v z vʲ e ʂ ɨ v ə f ʂ ɨ
добивается	d ə bʲ ɪ v a j ɪ t͡s ə
выметаю	v ɨ mʲ ɪ t a j ʊ
касайтесь	k ɐ s a j tʲ ɪ sʲ
подготовляйте	p ə d ɡ ə t ɐ v lʲ æ j tʲ e
пропитаниях	p r ə pʲ ɪ t a nʲ ɪ j ə x
затворявшийся	z ə t v ɐ rʲ a f ʂ ɨ j sʲ ə
зарегистрируюсь	z ə rʲ ɪ ɡʲ ɪ s t rʲ i r ʊ j ʉ sʲ
синтеза	sʲ i n t ɨ z ə
сдвинутся	z d vʲ i n ʊ t͡s ə
пьянствовало	p ⁽ʲ ⁾ j a n s t v ə v ə ɫ ə
омрачав	ɐ m r ɐ t͡ɕ a f
толстячку	t ə ɫ s ⁽ʲ ⁾ tʲ ɪ t͡ɕ k u
озари	ɐ z ɐ rʲ i
высевок	v ɨ sʲ ɪ v ə k
любовником	lʲ ʊ b o v nʲ ɪ k ə m
грузанёте	ɡ r ʊ z ɐ nʲ ɵ tʲ e
силаче	sʲ ɪ ɫ ɐ t͡ɕ e
субъективностью	s ʊ b j ɪ k tʲ i v n ə sʲ tʲ j ʊ
складен	s k ɫ a dʲ ɪ n
отпугивало	ɐ t p u ɡʲ ɪ v ə ɫ ə
дизентериею	dʲ ɪ zʲ ɪ nʲ tʲ ɪ rʲ i j ɪ j ʊ
расхищав	r ə s xʲ ɪ ɕː a f
нажрёмся	n ɐ ʐ rʲ ɵ m sʲ ə
огорчав	ɐ ɡ ɐ r t͡ɕ a f
