изигран	i z i ɡ r a n
продуценти	p r ɔ d u t͡s e n t i
дочитан	d ɔ t͡ʃ i t a n
охрабрување	ɔ x r a b r u v a ɲ e
заслепувачки	z a s l e p u v a t͡ʃ k i
солена	s ɔ l e n a
непрепречен	n e p r e p r e t͡ʃ e n
ресор	r e s ɔ r
разруши	r a z r u ʃ i
недавање	n e d a v a ɲ e
термодинамички	t e r m ɔ d i n a m i t͡ʃ k i
рангирање	r a ŋ ɡ i ɾ a ɲ e
опатица	ɔ p a t i t͡s a
арубиски	a r u b i s k i
брадиче	b r a d i t͡ʃ e
родовит	r ɔ d ɔ v i t
дошепнуван	d ɔ ʃ e p n u v a n
џудо	d͡ʒ u d ɔ
милување	m i ɫ u v a ɲ e
фактури	f a k t u ɾ a
кореографски	k ɔ ɾ e ɔ ɡ r a f s k i
родовник	r ɔ d ɔ v n i k
довиткување	d ɔ v i t k u v a ɲ e
пречкртување	p r e t͡ʃ k r̩ t u v a ɲ e
синџирче	s i n d͡ʒ i r t͡ʃ e
фенирање	f e n i ɾ a ɲ e
монтажен	m ɔ n t a ʒ e n
ксенофобично	k s e n ɔ f ɔ b i t͡ʃ n ɔ
зашеметеност	z a ʃ e m e t e n ɔ s t
криминолог	k r i m i n ɔ ɫ ɔ k
чизбургер	t͡ʃ i z b u r ɡ e r
калкулира	k a ɫ k u l i ɾ a
стандардизиран	s t a n d a r d i z i ɾ a n
непрекажан	n e p r e k a ʒ a n
породилно	p ɔ r ɔ d i ɫ n ɔ
нуспроизвод	n u s p r ɔ i z v ɔ t
трореден	t r ɔ ɾ e d e n
рекетиран	r e k e t i ɾ a n
ракопис	r a k ɔ p i s
одвлекува	ɔ d v l e k u v a
зол	z ɔ ɫ
сенце	s e n t͡s e
отсуство	ɔ t s u s t v ɔ
поништен	p ɔ n i ʃ t e n
некриминализирање	n e k r i m i n a l i z i ɾ a ɲ e
нагласува	n a ɡ ɫ a s u v a
изнуден	i z n u d e n
брава	b r a v a
славољубивост	s ɫ a v ɔ ʎ u b i v ɔ s t
коскен	k ɔ s k e n
обичаи	ɔ b i t͡ʃ a i
камилица	k a m i l i t͡s a
противвоспалителен	p r ɔ t i v v ɔ s p a l i t e l e n
забарски	z a b a r s k i
дрнка	d r̩ ŋ k a
плускав	p ɫ u s k a f
рачуле	r a t͡ʃ u l e
харковски	x a r k ɔ f s k i
ненаситно	n e n a s i t n ɔ
спојува	s p ɔ j u v a
серолошки	s e r ɔ ɫ ɔ ʃ k i
произведе	p r ɔ i z v e d e
нададе	n a d a d e
циник	t͡s i n i k
здивне	z d i v n e
девет	d e v e t
бекнува	b e k n u v a
бессончев	b e s s ɔ n t͡ʃ e f
изразување	i z r a z u v a ɲ e
налепници	n a l e p n i t͡s i
ет	e t
тиња	t i ɲ a
кружно	k r u ʒ n ɔ
граничење	ɡ r a n i t͡ʃ e ɲ e
избројан	i z b r ɔ j a n
слезе	s l e z e
распуштено	r a s p u ʃ t e n ɔ
гурабии	ɡ u r a b i i
чачкање	t͡ʃ a t͡ʃ k a ɲ e
владар	v ɫ a d a r
добрка	d ɔ b r̩ k a
времиња	v r e m i ɲ a
утрапува	u t r a p u v a
прилошки	p r i ɫ ɔ ʃ k i
конзистентен	k ɔ n z i s t e n t e n
водоземен	v ɔ d ɔ z e m e n
орјатка	ɔ r j a t k a
нокширче	n ɔ k ʃ i r t͡ʃ e
неусогласено	n e u s ɔ ɡ ɫ a s e n ɔ
матеа	m a t e a
бирање	b i ɾ a ɲ e
необјаснување	n e ɔ b j a s n u v a ɲ e
курвање	k u r v a ɲ e
сјај	s j a j
конгоанец	k ɔ ŋ ɡ ɔ a n e t͡s
ригански	r i ɡ a n s k i
штурмовик	ʃ t u r m ɔ v i k
легално	l e ɡ a ɫ n ɔ
зарѓави	z a r̩ ɟ a v i
столици	s t ɔ l i t͡s i
џавкајќи	d͡ʒ a f k a j c i
велипеток	v e l i p e t ɔ k
шашлив	ʃ a ʃ l i f
ободрувачки	ɔ b ɔ d r u v a t͡ʃ k i
шура	ʃ u ɾ a
урниса	u r n i s a
ас	a s
непоминат	n e p ɔ m i n a t
шпиун	ʃ p i j u n
калабриски	k a ɫ a b r i s k i
спонзориште	s p ɔ n z ɔ ɾ i ʃ t e
хиероглиф	x i j e ɾ ɔ ɡ l i f
рамнодушно	r a m n ɔ d u ʃ n ɔ
заљубува	z a ʎ u b u v a
цуцкање	t͡s u t͡s k a ɲ e
охридски	ɔ x r i t s k i
книжевен	k n i ʒ e v e n
бадемов	b a d e m ɔ f
колнење	k ɔ ɫ n e ɲ e
воздивне	v ɔ z d i v n e
настојува	n a s t ɔ j u v a
критикуван	k r i t i k u v a n
рецептор	r e t͡s e p t ɔ r
пореметуван	p ɔ ɾ e m e t u v a n
киевјанка	k i e v j a ŋ k a
ретроспективност	r e t r ɔ s p e k t i v n ɔ s t
врвка	v r̩ f k a
пишува	p i ʃ u v a
експеримент	e k s p e ɾ i m e n t
патешественици	p a t e ʃ e s t v e n i t͡s i
скејтер	s k e j t e r
загушен	z a ɡ u ʃ e n
транспониран	t r a n s p ɔ n i ɾ a n
невлезен	n e v l e z e n
двосмислен	d v ɔ s m i s l e n
несмасно	n e s m a s n ɔ
тросед	t r ɔ s e t
диоптер	d i ɔ p t e r
колоквиум	k ɔ ɫ ɔ k v i j u m
дотрошуван	d ɔ t r ɔ ʃ u v a n
избуши	i z b u ʃ i
заситеност	z a s i t e n ɔ s t
виничанче	v i n i t͡ʃ a n t͡ʃ e
тежиште	t e ʒ i ʃ t e
впери	f p e ɾ i
женчуле	ʒ e n t͡ʃ u l e
маврициец	m a v r i t͡s i j e t͡s
чепови	t͡ʃ e p ɔ v i
неприродност	n e p r i ɾ ɔ d n ɔ s t
трпање	t r̩ p a ɲ e
возвеличување	v ɔ z v e l i t͡ʃ u v a ɲ e
бигоросување	b i ɡ ɔ ɾ ɔ s u v a ɲ e
реинкарнација	r e i ŋ k a r n a t͡s i j a
суеверие	s u e v e ɾ i j e
мажественост	m a ʒ e s t v e n ɔ s t
разбремени	r a z b r e m e n i
мотоциклистички	m ɔ t ɔ t͡s i k l i s t i t͡ʃ k i
поддржувач	p ɔ d d r̩ ʒ u v a t͡ʃ
кошаркар	k ɔ ʃ a r k a r
кришум	k r i ʃ u m
отсутно	ɔ t s u t n ɔ
сеница	s e n i t͡s a
обвивка	ɔ b v i f k a
али	a l i
истурен	i s t u ɾ e n
бокалче	b ɔ k a ɫ t͡ʃ e
изгине	i z ɡ i n e
стотче	s t ɔ t t͡ʃ e
вика	v i k a
џамиште	d͡ʒ a m i ʃ t e
фетишист	f e t i ʃ i s t
газиран	ɡ a z i ɾ a n
облее	ɔ b l e e
внедруван	v n e d r u v a n
нетолкување	n e t ɔ ɫ k u v a ɲ e
разбистрување	r a z b i s t r u v a ɲ e
троа	t r ɔ a
распали	r a s p a l i
неподмитливост	n e p ɔ d m i t l i v ɔ s t
штеден	ʃ t e d e n
ориентациски	ɔ ɾ i j e n t a t͡s i s k i
оживее	ɔ ʒ i v e e
пишман	p i ʃ m a n
материјалистка	m a t e ɾ i j a l i s t k a
згаснување	z ɡ a s n u v a ɲ e
сталеж	s t a l e ʃ
лилаков	l i ɫ a k ɔ f
испипан	i s p i p a n
дневно	d n e v n ɔ
сркан	s r̩ k a n
неблокиран	n e b ɫ ɔ k i ɾ a n
тегови	t e ɡ ɔ v i
феникиец	f e n i k i j e t͡s
обзнанет	ɔ b z n a n e t
бушилка	b u ʃ i ɫ k a
сликнат	s l i k n a t
догребување	d ɔ ɡ r e b u v a ɲ e
тимар	t i m a r
привлекуван	p r i v l e k u v a n
воздигање	v ɔ z d i ɡ a ɲ e
заврне	z a v r̩ n e
исплевен	i s p l e v e n
штампа	ʃ t a m p a
ломе	ɫ ɔ m e
компонирање	k ɔ m p ɔ n i ɾ a ɲ e
стажантка	s t a ʒ a n t k a
лоботомија	ɫ ɔ b ɔ t ɔ m i j a
туткање	t u t k a ɲ e
килимарски	k i l i m a r s k i
обземе	ɔ b z e m e
згоден	z ɡ ɔ d e n
трне	t r̩ n e
горица	ɡ ɔ ɾ i t͡s a
исушува	i s u ʃ u v a
гулабов	ɡ u ɫ a b ɔ f
дизелаш	d i z e ɫ a ʃ
петмина	p e t m i n a
оставка	ɔ s t a f k a
крекнување	k r e k n u v a ɲ e
неисечен	n e i s e t͡ʃ e n
евентуално	e v e n t u a ɫ n ɔ
претшколски	p r e t ʃ k ɔ ɫ s k i
бришен	b r i ʃ e n
ратови	r a t ɔ v i
итрина	i t r i n a
антагонизам	a n t a ɡ ɔ n i z a m
избавен	i z b a v e n
синоќа	s i n ɔ c a
раја	r a j a
трисобен	t r i s ɔ b e n
ереванец	e r e v a n e t͡s
надареност	n a d a ɾ e n ɔ s t
прослави	p r ɔ s ɫ a v i
потпадне	p ɔ t p a d n e
ве	v e
идолопоклоник	i d ɔ ɫ ɔ p ɔ k ɫ ɔ n i k
тапиран	t a p i ɾ a n
сузбивање	s u z b i v a ɲ e
негаснење	n e ɡ a s n e ɲ e
поплави	p ɔ p ɫ a v i
соба	s ɔ b a
нестрадање	n e s t r a d a ɲ e
оддуван	ɔ d d u v a n
излошен	i z ɫ ɔ ʃ e n
телефони	t e l e f ɔ n i
оптегнува	ɔ p t e ɡ n u v a
кас	k a s
сонцобран	s ɔ n t͡s ɔ b r a n
нераководен	n e ɾ a k ɔ v ɔ d e n
собере	s ɔ b e ɾ e
милина	m i l i n a
неофашизам	n e ɔ f a ʃ i z a m
изнадаван	i z n a d a v a n
доручек	d ɔ ɾ u t͡ʃ e k
одвртен	ɔ d v r̩ t e n
цитоплазма	t͡s i t ɔ p ɫ a z m a
делкан	d e ɫ k a n
главатарски	ɡ ɫ a v a t a r s k i
тритомен	t r i t ɔ m e n
заемање	z a e m a ɲ e
ладникав	ɫ a d n i k a f
теснински	t e s n i n s k i
протеран	p r ɔ t e ɾ a n
пленик	p l e n i k
ционистички	t͡s i j ɔ n i s t i t͡ʃ k i
омикрон	ɔ m i k r ɔ n
мрсулави	m r̩ s u ɫ a v i
огранок	ɔ ɡ r a n ɔ k
пожарникар	p ɔ ʒ a r n i k a r
држава	d r̩ ʒ a v a
живинарски	ʒ i v i n a r s k i
несмеење	n e s m e e ɲ e
феноменологија	f e n ɔ m e n ɔ ɫ ɔ ɡ i j a
утрапен	u t r a p e n
стршлениште	s t r̩ ʃ l e n i ʃ t e
отстои	ɔ t s t ɔ i
отплетува	ɔ t p l e t u v a
оспорување	ɔ s p ɔ r u v a ɲ e
архиварство	a r x i v a r s t v ɔ
антибиотички	a n t i b i ɔ t i t͡ʃ k i
близнак	b l i z n a k
хиенски	x i e n s k i
кајсиичка	k a j s i i t͡ʃ k a
атар	a t a r
прабаба	p r a b a b a
хероин	x e ɾ ɔ i n
вжарен	v ʒ a ɾ e n
маршалка	m a r ʃ a ɫ k a
продавница	p r ɔ d a v n i t͡s a
кримтехника	k r i m t e x n i k a
одвиткан	ɔ d v i t k a n
нелекторирано	n e l e k t ɔ r i ɾ a n ɔ
скинува	s k i n u v a
неподмачкување	n e p ɔ d m a t͡ʃ k u v a ɲ e
гостилничарски	ɡ ɔ s t i ɫ n i t͡ʃ a r s k i
преоптеретеност	p r e ɔ p t e r e t e n ɔ s t
алвеоларен	a ɫ v e ɔ ɫ a ɾ e n
превртува	p r e v r̩ t u v a
штетници	ʃ t e t n i t͡s i
слободарски	s ɫ ɔ b ɔ d a r s k i
допразни	d ɔ p r a z n i
водоотпорно	v ɔ d ɔ ɔ t p ɔ r n ɔ
масовно	m a s ɔ v n ɔ
трубен	t r u b e n
микроскопи	m i k r ɔ s k ɔ p i
автомеханичари	a f t ɔ m e x a n i t͡ʃ a ɾ i
мувлосување	m u v ɫ ɔ s u v a ɲ e
соединетост	s ɔ e d i n e t ɔ s t
љ	ʎ a
кумин	k u m i n
несогласност	n e s ɔ ɡ ɫ a s n ɔ s t
либела	l i b e ɫ a
длапка	d ɫ a p k a
неследен	n e s l e d e n
собудува	s ɔ b u d u v a
џумка	d͡ʒ u m k a
разлошеност	r a z ɫ ɔ ʃ e n ɔ s t
сродство	s r ɔ t s t v ɔ
криќанец	k r i c a n e t͡s
развратен	r a z v r a t e n
потпора	p ɔ t p ɔ ɾ a
’рмбање	r̩ m b a ɲ e
заздрави	z a z d r a v i
неосуетен	n e ɔ s u e t e n
роеви	r ɔ e v i
урне	u r n e
вијадукти	v i j a d u k t i
кучуле	k u t͡ʃ u l e
парченце	p a r t͡ʃ e n t͡s e
морков	m ɔ r k ɔ f
неустрашен	n e u s t r a ʃ e n
нереизбран	n e r e i z b r a n
незадржување	n e z a d r̩ ʒ u v a ɲ e
прегазуван	p r e ɡ a z u v a n
прелетан	p r e l e t a n
прочитан	p r ɔ t͡ʃ i t a n
варвари	v a r v a ɾ i
гана	ɡ a n a
несреќавање	n e s r e c a v a ɲ e
абонент	a b ɔ n e n t
конго	k ɔ ŋ ɡ ɔ
ламја	ɫ a m j a
фундаментален	f u n d a m e n t a l e n
неделегиран	n e d e l e ɡ i ɾ a n
несреќен	n e s r e c e n
желудник	ʒ e ɫ u d n i k
беспричински	b e s p r i t͡ʃ i n s k i
стрпливо	s t r̩ p l i v ɔ
шампион	ʃ a m p i ɔ n
мустаќ	m u s t a c
фиде	f i d e
обессилува	ɔ b e s s i ɫ u v a
филипински	f i l i p i n s k i
неопашан	n e ɔ p a ʃ a n
кљанка	k ʎ a ŋ k a
болки	b ɔ ɫ k i
перфиден	p e r f i d e n
планктон	p ɫ a ŋ k t ɔ n
исонча	i s ɔ n t͡ʃ a
фокусен	f ɔ k u s e n
чоколадиште	t͡ʃ ɔ k ɔ ɫ a d i ʃ t e
предодредување	p r e d ɔ d r e d u v a ɲ e
состојби	s ɔ s t ɔ j b i
дамка	d a m k a
вообичајување	v ɔ ɔ b i t͡ʃ a j u v a ɲ e
гркинка	ɡ r̩ k i ŋ k a
разљуби	r a z ʎ u b i
класик	k ɫ a s i k
насмее	n a s m e e
кошници	k ɔ ʃ n i t͡s i
конексија	k ɔ n e k s i j a
небрежно	n e b r e ʒ n ɔ
полжавски	p ɔ ɫ ʒ a f s k i
уличен	u l i t͡ʃ e n
трикотажен	t r i k ɔ t a ʒ e n
вакцини	v a k t͡s i n i
излапа	i z ɫ a p a
напнатост	n a p n a t ɔ s t
дијабетес	d i j a b e t e s
зурла	z u r ɫ a
незастапен	n e z a s t a p e n
таинствен	t a i n s t v e n
боциче	b ɔ t͡s i t͡ʃ e
изместува	i z m e s t u v a
разбуричка	r a z b u ɾ i t͡ʃ k a
непоткупливо	n e p ɔ t k u p l i v ɔ
калеидоскоп	k a l e i d ɔ s k ɔ p
одзади	ɔ d z a d i
кауза	k a u z a
перцептивен	p e r t͡s e p t i v e n
идентификување	i d e n t i f i k u v a ɲ e
непопустливост	n e p ɔ p u s t l i v ɔ s t
намачкување	n a m a t͡ʃ k u v a ɲ e
виц	v i t͡s
џанак	d͡ʒ a n a k
единствено	e d i n s t v e n ɔ
склучен	s k ɫ u t͡ʃ e n
буричкање	b u r i t͡ʃ k a ɲ e
заледува	z a l e d u v a
црепна	t͡s r e p n a
кривопаланечки	k r i v ɔ p a ɫ a n e t͡ʃ k i
неиспасиран	n e i s p a s i ɾ a n
продаде	p r ɔ d a d e
бавнорастечки	b a v n ɔ r a s t e t͡ʃ k i
морожданец	m ɔ r ɔ ʒ d a n e t͡s
давеник	d a v e n i k
алергичност	a l e r ɡ i t͡ʃ n ɔ s t
отпорно	ɔ t p ɔ r n ɔ
проблематизира	p r ɔ b l e m a t i z i ɾ a
лексикограф	l e k s i k ɔ ɡ r a f
ректално	r e k t a ɫ n ɔ
ознака	ɔ z n a k a
романтично	r ɔ m a n t i t͡ʃ n ɔ
исчашен	i ʃ t͡ʃ a ʃ e n
илјадинка	i ʎ a d i ŋ k a
потпевнување	p ɔ t p e v n u v a ɲ e
доларче	d ɔ ɫ a r t͡ʃ e
возмутување	v ɔ z m u t u v a
дозатвори	d ɔ z a t v ɔ ɾ i
одвојување	ɔ d v ɔ j u v a ɲ e
авиониште	a v i ɔ n i ʃ t e
азијати	a z i j a t i
трепери	t r e p e ɾ i
шушкавци	ʃ u ʃ k a f t͡s i
препознае	p r e p ɔ z n a e
неразделност	n e r a z d e ɫ n ɔ s t
месно	m e s n ɔ
дупол	d u p ɔ ɫ
заквичува	z a k v i t͡ʃ u v a
расплеска	r a s p l e s k a
правилник	p r a v i ɫ n i k
пушилница	p u ʃ i ɫ n i t͡s a
кумулонимбусен	k u m u ɫ ɔ n i m b u s e n
шокира	ʃ ɔ k i ɾ a
отпуштање	ɔ t p u ʃ t a ɲ e
чести	t͡ʃ e s t i
дебрчанец	d e b r̩ t͡ʃ a n e t͡s
салон	s a ɫ ɔ n
смачкување	s m a t͡ʃ k u v a ɲ e
скокотнат	s k ɔ k ɔ t n a t
велешанче	v e l e ʃ a n t͡ʃ e
воздивнува	v ɔ z d i v n u v a
фабрика	f a b r i k a
плаштаница	p ɫ a ʃ t a n i t͡s a
павка	p a f k a
глави	ɡ ɫ a v i
димници	d i m n i t͡s i
побожно	p ɔ b ɔ ʒ n ɔ
шкаф	ʃ k a f
различен	r a z l i t͡ʃ e n
неклиматизиран	n e k l i m a t i z i ɾ a n
затвора	z a t v ɔ ɾ a
гледа	ɡ l e d a
меритократски	m e ɾ i t ɔ k r a t s k i
телиња	t e l i ɲ a
транзитен	t r a n z i t e n
институт	i n s t i t u t
бусени	b u s e n i
меми	m e m i
црни	t͡s r̩ n i
објективност	ɔ b j e k t i v n ɔ s t
будали	b u d a l i
млати	m ɫ a t i
сопственост	s ɔ p s t v e n ɔ s t
ортак	ɔ r t a k
мотори	m ɔ t ɔ ɾ i
нерепетиран	n e ɾ e p e t i ɾ a n
крошничка	k r ɔ ʃ n i t͡ʃ k a
раштркува	r a ʃ t r̩ k u v a
раслојување	r a s ɫ ɔ j u v a ɲ e
бунар	b u n a r
материјалист	m a t e ɾ i j a l i s t
истретира	i s t r e t i ɾ a
уметничиште	u m e t n i t͡ʃ i ʃ t e
расчепка	r a ʃ t͡ʃ e p k a
навидум	n a v i d u m
пипање	p i p a ɲ e
подразвесели	p ɔ d r a z v e s e l i
колатерална	k ɔ ɫ a t e r a ɫ n a
штетење	ʃ t e t e ɲ e
изебе	i z e b e
непрооден	n e p r ɔ ɔ d e n
бол	b ɔ ɫ
омажи	ɔ m a ʒ i
чувар	t͡ʃ u v a r
кифличка	k i f l i t͡ʃ k a
побратими	p ɔ b r a t i m i
кумановски	k u m a n ɔ f s k i
кларинет	k ɫ a ɾ i n e t
принцип	p r i n t͡s i p
неиздржан	n e i z d r̩ ʒ a n
наесен	n a e s e n
обезвластување	ɔ b e z v ɫ a s t u v a ɲ e
палома	p a ɫ ɔ m a
свилар	s v i ɫ a r
честитка	t͡ʃ e s t i t k a
неутешно	n e u t e ʃ n ɔ
мамец	m a m e t͡s
стадо	s t a d ɔ
штипалки	ʃ t i p a ɫ k i
пајачиште	p a j a t͡ʃ i ʃ t e
внуков	v n u k ɔ f
ќут	c u t
бенин	b e n i n
регионализам	r e ɡ i j ɔ n a l i z a m
негалење	n e ɡ a l e ɲ e
инспекторка	i n s p e k t ɔ r k a
измасиран	i z m a s i ɾ a n
заблудува	z a b ɫ u d u v a
засенчи	z a s e n t͡ʃ i
орасположи	ɔ ɾ a s p ɔ ɫ ɔ ʒ i
карта	k a r t a
куфери	k u f e ɾ i
мирнотија	m i r n ɔ t i j a
поплочи	p ɔ p ɫ ɔ t͡ʃ i
морничаво	m ɔ r n i t͡ʃ a v ɔ
земјопоседник	z e m j ɔ p ɔ s e d n i k
разнежи	r a z n e ʒ i
неверодостоен	n e v e ɾ ɔ d ɔ s t ɔ e n
проклитичен	p r ɔ k l i t i t͡ʃ e n
битност	b i t n ɔ s t
потенцијално	p ɔ t e n t͡s i j a ɫ n ɔ
сурфериште	s u r f e ɾ i ʃ t e
бамачанка	b a m a t͡ʃ a ŋ k a
обеспокои	ɔ b e s p ɔ k ɔ i
ѓаволест	ɟ a v ɔ l e s t
набеден	n a b e d e n
колан	k ɔ ɫ a n
идиотизам	i d i j ɔ t i z a m
остине	ɔ s t i n e
љубичица	ʎ u b i t͡ʃ i t͡s a
терористка	t e ɾ ɔ r i s t k a
насечен	n a s e t͡ʃ e n
уназаден	u n a z a d e n
вѕидан	v d͡z i d a n
есцајг	e s t͡s a j k
подоен	p ɔ d ɔ e n
литератури	l i t e ɾ a t u ɾ i
организми	ɔ r ɡ a n i z m i
стипендија	s t i p e n d i j a
машкоданка	m a ʃ k ɔ d a ŋ k a
закрила	z a k r i ɫ a
статистичар	s t a t i s t i t͡ʃ a r
етиопјанка	e t i ɔ p j a ŋ k a
техеранка	t e x e ɾ a ŋ k a
идолка	i d ɔ ɫ k a
вонбрачно	v ɔ m b r a t͡ʃ n ɔ
почетоци	p ɔ t͡ʃ e t ɔ t͡s i
неизгладен	n e i z ɡ ɫ a d e n
просторно	p r ɔ s t ɔ r n ɔ
аматерче	a m a t e r t͡ʃ e
издушуван	i z d u ʃ u v a n
нагрдување	n a ɡ r̩ d u v a ɲ e
хараре	x a r a ɾ e
катиљи	k a t i ʎ i
камо	k a m ɔ
немигрирање	n e m i ɡ r i ɾ a ɲ e
творец	t v ɔ ɾ e t͡s
непамтење	n e p a m t e ɲ e
оставински	ɔ s t a v i n s k i
изнаправи	i z n a p r a v i
поднесување	p ɔ d n e s u v a ɲ e
неприменување	n e p r i m e n u v a ɲ e
прататковина	p r a t a t k ɔ v i n a
неискастрен	n e i s k a s t r e n
авторитетен	a f t ɔ ɾ i t e t e n
фронтално	f r ɔ n t a ɫ n ɔ
непретставен	n e p r e t s t a v e n
избезумувачки	i z b e z u m u v a t͡ʃ k i
режимиште	r e ʒ i m i ʃ t e
катче	k a t t͡ʃ e
колови	k ɔ ɫ ɔ v i
неконструктивно	n e k ɔ n s t r u k t i v n ɔ
влагање	v ɫ a ɡ a ɲ e
изострен	i z ɔ s t r e n
несервиран	n e s e r v i ɾ a n
залаци	z a ɫ a t͡s i
курбан	k u r b a n
врста	v r̩ s t a
нелуфтирање	n e ɫ u f t i ɾ a ɲ e
лажливци	ɫ a ʒ l i f t͡s i
неред	n e ɾ e t
малтежанка	m a ɫ t e ʒ a ŋ k a
замбиски	z a m b i s k i
челист	t͡ʃ e l i s t
недохранетост	n e d ɔ x r a n e t ɔ s t
оспособува	ɔ s p ɔ s ɔ b u v a
хирургија	x i r u r ɡ i j a
замав	z a m a f
фамилииште	f a m i l i i ʃ t e
збуни	z b u n i
наруча	n a ɾ u t͡ʃ a
течнокристален	t e t͡ʃ n ɔ k r i s t a l e n
гламниче	ɡ ɫ a m n i t͡ʃ e
конкретно	k ɔ ŋ k r e t n ɔ
злосторство	z ɫ ɔ s t ɔ r s t v ɔ
онанија	ɔ n a n i j a
врвно	v r̩ v n ɔ
испупчи	i s p u p t͡ʃ i
метериз	m e t e ɾ i s
патешественик	p a t e ʃ e s t v e n i k
баклавичка	b a k ɫ a v i t͡ʃ k a
незатоплување	n e z a t ɔ p ɫ u v a ɲ e
одраз	ɔ d r a s
сочувува	s ɔ t͡ʃ u v u v a
раскашавуван	r a s k a ʃ a v u v a n
солзен	s ɔ ɫ z e n
надразнетост	n a d r a z n e t ɔ s t
лук	ɫ u k
бановина	b a n ɔ v i n a
семиологија	s e m i j ɔ ɫ ɔ ɡ i j a
молекули	m ɔ l e k u l i
буцнуван	b u t͡s n u v a n
бута	b u t a
ирена	i r e n a
смекнување	s m e k n u v a ɲ e
продекански	p r ɔ d e k a n s k i
збунувачки	z b u n u v a t͡ʃ k i
еревански	e r e v a n s k i
сожалува	s ɔ ʒ a ɫ u v a
песочници	p e s ɔ t͡ʃ n i t͡s i
сакати	s a k a t i
излаже	i z ɫ a ʒ e
отапување	ɔ t a p u v a ɲ e
киевјанец	k i e v j a n e t͡s
сеприсутен	s e p r i s u t e n
црево	t͡s r e v ɔ
расчленуван	r a ʃ t͡ʃ l e n u v a n
паганки	p a ɡ a ŋ k i
подносливо	p ɔ d n ɔ s l i v ɔ
бибер	b i b e r
самонаплата	s a m ɔ n a p ɫ a t a
немец	n e m e t͡s
феуд	f e u t
сив	s i f
актофка	a k t ɔ f k a
плико	p l i k ɔ
контрола	k ɔ n t r ɔ ɫ a
опортунистка	ɔ p ɔ r t u n i s t k a
предочуван	p r e d ɔ t͡ʃ u v a n
безмалку	b e z m a ɫ k u
џапнување	d͡ʒ a p n u v a ɲ e
пораснува	p ɔ r a s n u v a
адаптери	a d a p t e ɾ i
паркет	p a r k e t
презакопуван	p r e z a k ɔ p u v a n
сатир	s a t i r
казан	k a z a n
квартет	k v a r t e t
разлутување	r a z ɫ u t u v a ɲ e
налага	n a ɫ a ɡ a
поистоветуван	p ɔ i s t ɔ v e t u v a n
намекне	n a m e k n e
небегање	n e b e ɡ a ɲ e
перничка	p e r n i t͡ʃ k a
управуван	u p r a v u v a n
оттука	ɔ t t u k a
кити	k i t i
подзачешла	p ɔ d z a t͡ʃ e ʃ ɫ a
домери	d ɔ m e ɾ i
рапсодија	r a p s ɔ d i j a
одличие	ɔ d l i t͡ʃ i j e
ненајмување	n e n a j m u v a ɲ e
облекува	ɔ b l e k u v a
пченичен	p t͡ʃ e n i t͡ʃ e n
глупаво	ɡ ɫ u p a v ɔ
доле	d ɔ l e
незакочен	n e z a k ɔ t͡ʃ e n
гостилничар	ɡ ɔ s t i ɫ n i t͡ʃ a r
имиграција	i m i ɡ r a t͡s i j a
шалтер	ʃ a ɫ t e r
анализира	a n a l i z i ɾ a
тримесечен	t r i m e s e t͡ʃ e n
превртување	p r e v r̩ t u v a ɲ e
повреди	p ɔ v r e d i
неподатлив	n e p ɔ d a t l i f
зашеметен	z a ʃ e m e t e n
тектоника	t e k t ɔ n i k a
молкома	m ɔ ɫ k ɔ m a
деветсто	d e v e t s t ɔ
чекалница	t͡ʃ e k a ɫ n i t͡s a
ѕиркан	d͡z i r k a n
внатре	v n a t r e
разбоксиран	r a z b ɔ k s i ɾ a n
попее	p ɔ p e e
сомнителност	s ɔ m n i t e ɫ n ɔ s t
наводен	n a v ɔ d e n
забавиште	z a b a v i ʃ t e
издрибла	i z d r i b ɫ a
разгрнат	r a z ɡ r̩ n a t
балтија	b a ɫ t i j a
африкански	a f r i k a n s k i
гастритис	ɡ a s t r i t i s
неодвојување	n e ɔ d v ɔ j u v a ɲ e
бае	b a e
станче	s t a n t͡ʃ e
интригантка	i n t r i ɡ a n t k a
подвлекува	p ɔ d v l e k u v a
мумла	m u m ɫ a
страчкин	s t r a t͡ʃ k i n
рожба	r ɔ ʒ b a
буки	b u k i
изваден	i z v a d e n
нормализира	n ɔ r m a l i z i ɾ a
рамнодушен	r a m n ɔ d u ʃ e n
услов	u s ɫ ɔ f
јавачиште	j a v a t͡ʃ i ʃ t e
добротворен	d ɔ b r ɔ t v ɔ ɾ e n
доделкување	d ɔ d e ɫ k u v a ɲ e
растревожуван	r a s t r e v ɔ ʒ u v a n
прелест	p r e l e s t
масеруански	m a s e r u a n s k i
дневен	d n e v e n
расчетка	r a ʃ t͡ʃ e t k a
немонтиран	n e m ɔ n t i ɾ a n
жештина	ʒ e ʃ t i n a
изнаварен	i z n a v a ɾ e n
бар	b a r
ансамбл	a n s a m b ɫ̩
игри	i ɡ r i
фразеологија	f r a z e ɔ ɫ ɔ ɡ i j a
предјадења	p r e d j a d e ɲ a
феминацист	f e m i n a t͡s i s t
телефон	t e l e f ɔ n
вистинит	v i s t i n i t
мравја	m r a v j a
боцкалка	b ɔ t͡s k a ɫ k a
скијач	s k i j a t͡ʃ
квалификација	k v a l i f i k a t͡s i j a
демантиран	d e m a n t i ɾ a n
стапување	s t a p u v a ɲ e
догматизам	d ɔ ɡ m a t i z a m
маторици	m a t ɔ ɾ i t͡s i
пожарна	p ɔ ʒ a r n a
дилиски	d i l i s k i
уф	u f
маврициус	m a v r i t͡s i j u s
просветленост	p r ɔ s v e t l e n ɔ s t
добитничка	d ɔ b i t n i t͡ʃ k a
комичарски	k ɔ m i t͡ʃ a r s k i
јаничарче	j a n i t͡ʃ a r t͡ʃ e
постава	p ɔ s t a v a
јагленисан	j a ɡ l e n i s a n
теслиште	t e s l i ʃ t e
вомјази	v ɔ m j a z i
шеснаес	ʃ e s n a e s
недоближување	n e d ɔ b l i ʒ u v a ɲ e
умува	u m u v a
изнамрчи	i z n a m r̩ t͡ʃ i
непреводливост	n e p r e v ɔ d l i v ɔ s t
поплавуван	p ɔ p ɫ a v u v a n
преиспитува	p r e i s p i t u v a
амбуланти	a m b u ɫ a n t i
населба	n a s e ɫ b a
доуредуван	d ɔ u r e d u v a n
спонзорче	s p ɔ n z ɔ r t͡ʃ e
необразложено	n e ɔ b r a z ɫ ɔ ʒ e n ɔ
каузално	k a u z a ɫ n ɔ
насилнички	n a s i ɫ n i t͡ʃ k i
ленинистички	l e n i n i s t i t͡ʃ k i
кодоши	k ɔ d ɔ ʃ i
сомуниште	s ɔ m u n i ʃ t e
посолен	p ɔ s ɔ l e n
евра	e v r a
шанкери	ʃ a ŋ k e ɾ i
тиркизен	t i r k i z e n
допроверува	d ɔ p r ɔ v e ɾ u v a
мол	m ɔ ɫ
претрупува	p r e t r u p u v a
добричи	d ɔ b r i t͡ʃ i
кукушанец	k u k u ʃ a n e t͡s
збесне	z b e s n e
вицепремиерка	v i t͡s e p r e m i e r k a
оддржува	ɔ d d r̩ ʒ u v a
сложувалки	s ɫ ɔ ʒ u v a ɫ k i
раскопан	r a s k ɔ p a n
расфрла	r a s f r̩ ɫ a
ненадарен	n e n a d a ɾ e n
усни	u s n i
нанадвор	n a n a d v ɔ r
лупкање	ɫ u p k a ɲ e
смотанковци	s m ɔ t a ŋ k ɔ f t͡s i
мајмунка	m a j m u ŋ k a
дневник	d n e v n i k
другарски	d r u ɡ a r s k i
погрми	p ɔ ɡ r̩ m i
ќесиња	c e s i ɲ a
неличење	n e l i t͡ʃ e ɲ e
напредува	n a p r e d u v a
прилагоден	p r i ɫ a ɡ ɔ d e n
тотемизам	t ɔ t e m i z a m
информиран	i ɱ f ɔ r m i ɾ a n
целосен	t͡s e ɫ ɔ s e n
ако	a k ɔ
лексикографски	l e k s i k ɔ ɡ r a f s k i
необезбеден	n e ɔ b e z b e d e n
навечер	n a v e t͡ʃ e r
мандарински	m a n d a r i n s k i
оклопник	ɔ k ɫ ɔ p n i k
науки	n a u k i
веѓа	v e ɟ a
сателит	s a t e l i t
ризичност	r i z i t͡ʃ n ɔ s t
валкано	v a ɫ k a n ɔ
обременува	ɔ b r e m e n u v a
камионче	k a m i ɔ n t͡ʃ e
расчепкан	r a ʃ t͡ʃ e p k a n
магионичарка	m a ɡ i j ɔ n i t͡ʃ a r k a
сврзувачки	s v r̩ z u v a t͡ʃ k i
анкарец	a ŋ k a ɾ e t͡s
толчник	t ɔ ɫ t͡ʃ n i k
разнебитен	r a z n e b i t i
претрпен	p r e t r̩ p e n
костурчани	k ɔ s t u r t͡ʃ a n e t͡s
валандовчанец	v a ɫ a n d ɔ f t͡ʃ a n e t͡s
чадје	t͡ʃ a d j e
достоинство	d ɔ s t ɔ i n s t v ɔ
полјоделство	p ɔ ʎ ɔ d e ɫ s t v ɔ
долу	d ɔ ɫ u
ломејски	ɫ ɔ m e j s k i
прекуморски	p r e k u m ɔ r s k i
мрзне	m r̩ z n e
непростен	n e p r ɔ s t e n
иновативност	i n ɔ v a t i v n ɔ s t
лимонче	l i m ɔ n t͡ʃ e
означен	ɔ z n a t͡ʃ e n
геодетски	ɡ e ɔ d e t s k i
реши	r e ʃ i
експлицитно	e k s p l i t͡s i t n ɔ
кадифе	k a d i f e
заплетка	z a p l e t k a
гризови	ɡ r i z ɔ v i
јунци	j u n t͡s i
криволов	k r i v ɔ ɫ ɔ f
шегаџика	ʃ e ɡ a d͡ʒ i k a
макроекономија	m a k r ɔ e k ɔ n ɔ m i j a
незастанат	n e z a s t a n a t
свазиски	s v a z i s k i
покраински	p ɔ k r a i n s k i
танчер	t a n t͡ʃ e r
разузнавачки	r a z u z n a v a t͡ʃ k i
овековечен	ɔ v e k ɔ v e t͡ʃ e n
бројче	b r ɔ j t͡ʃ e
докачен	d ɔ k a t͡ʃ e n
кавалер	k a v a l e r
губитничка	ɡ u b i t n i t͡ʃ k a
раштркан	r a ʃ t r̩ k a n
извинува	i z v i n u v a
помодарка	p ɔ m ɔ d a r k a
челичана	t͡ʃ e l i t͡ʃ a n a
удолу	u d ɔ ɫ u
педериште	p e d e ɾ i ʃ t e
обмислен	ɔ b m i s l e n
пребира	p r e b i ɾ a
намрси	n a m r̩ s i
шилец	ʃ i l e t͡s
разбојничка	r a z b ɔ j n i t͡ʃ k a
пичкари	p i t͡ʃ k a ɾ i
определи	ɔ p r e d e l i
квартален	k v a r t a l e n
раскокан	r a s k ɔ k a n
докачи	d ɔ k a t͡ʃ i
брунејски	b r u n e j s k i
млека	m l e k a
чудотворци	t͡ʃ u d ɔ t v ɔ r t͡s i
злорадосно	z ɫ ɔ r a d ɔ s n ɔ
избоден	i z b ɔ d e n
лико	l i k ɔ
фасцинантен	f a s t͡s i n a n t e n
зачитување	z a t͡ʃ i t u v a ɲ e
поофка	p ɔ ɔ f k a
послужавник	p ɔ s ɫ u ʒ a v n i k
програмче	p r ɔ ɡ r a m t͡ʃ e
илјадница	i ʎ a d n i t͡s a
поштува	p ɔ ʃ t u v a
добродетел	d ɔ b r ɔ d e t e ɫ
интровертен	i n t r ɔ v e r t e n
образуван	ɔ b r a z u v a n
закономерен	z a k ɔ n ɔ m e ɾ e n
михаил	m i x a i ɫ
дебранци	d e b r a n t͡s i
издробен	i z d r ɔ b e n
смеа	s m e a
марина	m a r i n a
грофови	ɡ r ɔ f ɔ v i
славејски	s ɫ a v e j s k i
претсобја	p r e t s ɔ b j a
натпатници	n a t p a t n i t͡s i
вклучување	f k ɫ u t͡ʃ u v a ɲ e
тиранин	t i ɾ a n i n
производител	p r ɔ i z v ɔ d i t e ɫ
разжестување	r a ʒ ʒ e s t u v a ɲ e
недошминкан	n e d ɔ ʃ m i ŋ k a n
омекнување	ɔ m e k n u v a ɲ e
стравотен	s t r a v ɔ t e n
неусисан	n e u s i s a n
зимски	z i m s k i
фокусирање	f ɔ k u s i ɾ a ɲ e
гурабија	ɡ u r a b i j a
лемурче	l e m u r t͡ʃ e
досади	d ɔ s a d i
модернизатор	m ɔ d e r n i z a t ɔ r
несправедливост	n e s p r a v e d l i v ɔ s t
бујност	b u j n ɔ s t
раскршува	r a s k r̩ ʃ u v a
запамти	z a p a m t i
ѕвонливо	d͡z v ɔ n l i v ɔ
замазнуван	z a m a z n u v a n
доткае	d ɔ t k a e
подосвестен	p ɔ d ɔ s v e s t e n
леринчани	l e r i n t͡ʃ a n i
прекрстување	p r e k r̩ s t u v a ɲ e
проветруван	p r ɔ v e t r u v a n
чибу	t͡ʃ i b u
закоравен	z a k ɔ ɾ a v e n
дивизија	d i v i z i j a
фаланга	f a ɫ a ŋ ɡ a
српче	s r̩ p t͡ʃ e
клоца	k ɫ ɔ t͡s a
овулација	ɔ v u ɫ a t͡s i j a
подмлади	p ɔ d m ɫ a d i
неопременост	n e ɔ p r e m e n ɔ s t
ненагостен	n e n a ɡ ɔ s t e n
метафизички	m e t a f i z i t͡ʃ k i
сватен	s v a t e n
закачко	z a k a t͡ʃ k ɔ
убивање	u b i v a ɲ e
реалистичен	r e a l i s t i t͡ʃ e n
историчарка	i s t ɔ r i t͡ʃ a r k a
вртен	v r̩ t e n
задоволуван	z a d ɔ v ɔ ɫ u v a n
паузира	p a u z i ɾ a
наслутен	n a s ɫ u t e n
интригира	i n t r i ɡ i ɾ a
електризира	e l e k t r i z i ɾ a
вкусен	f k u s e n
цементира	t͡s e m e n t i ɾ a
автоматизација	a f t ɔ m a t i z a t͡s i j a
неостварен	n e ɔ s t v a ɾ e n
отровница	ɔ t r ɔ v n i t͡s a
срушување	s r u ʃ u v a ɲ e
билатерален	b i ɫ a t e r a l e n
мотивираност	m ɔ t i v i ɾ a n ɔ s t
докажлив	d ɔ k a ʒ l i f
преоптеретува	p r e ɔ p t e r e t u v a
биен	b i j e n
анка	a ŋ k a
глогинка	ɡ ɫ ɔ ɡ i ŋ k a
незаборавање	n e z a b ɔ r a v a ɲ e
тровче	t r ɔ f t͡ʃ e
осакати	ɔ s a k a t i
печива	p e t͡ʃ i v a
вообразби	v ɔ ɔ b r a z b i
неотскокнување	n e ɔ t s k ɔ k n u v a ɲ e
крекер	k r e k e r
погерманчи	p ɔ ɡ e r m a n t͡ʃ i
лазар	ɫ a z a r
зимата	z i m a t a
заклопи	z a k ɫ ɔ p i
овчаров	ɔ f t͡ʃ a ɾ ɔ f
педофилка	p e d ɔ f i ɫ k a
секташтво	s e k t a ʃ t v ɔ
идеален	i d e a l e n
мице	m i t͡s e
поднебје	p ɔ d n e b j e
каваљери	k a v a ʎ e ɾ i
завршно	z a v r̩ ʃ n ɔ
бодрост	b ɔ d r ɔ s t
неприспособливо	n e p r i s p ɔ s ɔ b l i v ɔ
вошливост	v ɔ ʃ l i v ɔ s t
желче	ʒ e ɫ t͡ʃ e
идилично	i d i l i t͡ʃ n ɔ
поткастрен	p ɔ t k a s t r e n
наврапито	n a v r a p i t ɔ
брегови	b r e ɡ ɔ v i
тротоарче	t r ɔ t ɔ a r t͡ʃ e
комарци	k ɔ m a r t͡s i
негации	n e ɡ a t͡s i i
просторија	p r ɔ s t ɔ ɾ i j a
билатерално	b i ɫ a t e r a ɫ n ɔ
бушав	b u ʃ a f
конфигуриран	k ɔ ɱ f i ɡ u r i ɾ a n
семантичар	s e m a n t i t͡ʃ a r
нагаѓа	n a ɡ a ɟ a
мариовски	m a r i j ɔ f s k i
вакуумиран	v a k u m i ɾ a n
грешници	ɡ r e ʃ n i t͡s i
поротен	p ɔ ɾ ɔ t e n
исфали	i s f a l i
препевање	p r e p e v a ɲ e
малдивијка	m a ɫ d i v i j k a
сметки	s m e t k i
пантеистички	p a n t e i s t i t͡ʃ k i
неподмирување	n e p ɔ d m i r u v a ɲ e
вајари	v a j a ɾ i
ќесиште	c e s i ʃ t e
злодела	z ɫ ɔ d e ɫ a
неварирање	n e v a r i ɾ a ɲ e
погледнување	p ɔ ɡ l e d n u v a ɲ e
шака	ʃ a k a
егоистка	e ɡ ɔ i s t k a
спрегнат	s p r e ɡ n a t
франкфурт	f r a ŋ k f u r t
смрди	s m r̩ d i
рушевина	r u ʃ e v i n a
змиест	z m i j e s t
предупреден	p r e d u p r e d e n
слее	s l e e
миловиден	m i ɫ ɔ v i d e n
боровинки	b ɔ r ɔ v i ŋ k i
изгазен	i z ɡ a z e n
тривиден	t r i v i d e n
леичка	l e i t͡ʃ k a
предрасположение	p r e d r a s p ɔ ɫ ɔ ʒ e n i j e
неспастрен	n e s p a s t r e n
непрегледан	n e p r e ɡ l e d a n
нештетен	n e ʃ t e t e n
обезименет	ɔ b e z i m e n e t
трогателно	t r ɔ ɡ a t e ɫ n ɔ
оптимистичност	ɔ p t i m i s t i t͡ʃ n ɔ s t
радување	r a d u v a ɲ e
онеспособување	ɔ n e s p ɔ s ɔ b u v a ɲ e
драматизира	d r a m a t i z i ɾ a
одбегнување	ɔ d b e ɡ n u v a ɲ e
белец	b e l e t͡s
тутка	t u t k a
срца	s r̩ t͡s a
конец	k ɔ n e t͡s
полза	p ɔ ɫ z a
малоумник	m a ɫ ɔ u m n i k
момичиња	m ɔ m i t͡ʃ i ɲ a
варварство	v a r v a r s t v ɔ
неотплатен	n e ɔ t p ɫ a t e n
писоар	p i s ɔ a r
велешки	v e l e ʃ k i
незначаен	n e z n a t͡ʃ a e n
информатички	i ɱ f ɔ r m a t i t͡ʃ k i
лактозен	ɫ a k t ɔ z e n
беџови	b e d͡ʒ ɔ v i
аргентинка	a r ɡ e n t i ŋ k a
тригодишен	t r i ɡ ɔ d i ʃ e n
сонцуле	s ɔ n t͡s u l e
претчувствуван	p r e t t͡ʃ u f s t v u v a n
предострожност	p r e d ɔ s t r ɔ ʒ n ɔ s t
ѓубреџиски	ɟ u b r e d͡ʒ i s k i
ѓонови	ɟ ɔ n ɔ v i
коментатор	k ɔ m e n t a t ɔ r
губитнички	ɡ u b i t n i t͡ʃ k i
подарување	p ɔ d a r u v a ɲ e
калуѓерство	k a ɫ u ɟ e r s t v ɔ
осаменост	ɔ s a m e n ɔ s t
окупира	ɔ k u p i ɾ a
скубне	s k u b n e
сијалица	s i j a l i t͡s a
трипати	t r i p a t i
препарирање	p r e p a r i ɾ a ɲ e
лупење	ɫ u p e ɲ e
некодифициран	n e k ɔ d i f i t͡s i ɾ a n
управители	u p r a v i t e l i
испробува	i s p r ɔ b u v a
изумуван	i z u m u v a n
калинка	k a l i ŋ k a
интонира	i n t ɔ n i ɾ a
империја	i m p e ɾ i j a
сенкар	s e ŋ k a r
досолува	d ɔ s ɔ ɫ u v a
трансформација	t r a n s f ɔ r m a t͡s i j a
итрец	i t r e t͡s
непримен	n e p r i m e n
будалеење	b u d a l e e ɲ e
подучување	p ɔ d u t͡ʃ u v a ɲ e
агресивност	a ɡ r e s i v n ɔ s t
лаен	ɫ a e n
печок	p e t͡ʃ ɔ k
кога	k ɔ ɡ a
посветување	p ɔ s v e t u v a ɲ e
индијче	i n d i j t͡ʃ e
прасловенски	p r a s ɫ ɔ v e n s k i
жезло	ʒ e z ɫ ɔ
подизрамни	p ɔ d i z r a m n i
мачорски	m a t͡ʃ ɔ r s k i
дегустаторски	d e ɡ u s t a t ɔ r s k i
купе	k u p e
деспотизам	d e s p ɔ t i z a m
вразуми	v r a z u m i
превисоко	p r e v i s ɔ k ɔ
штурче	ʃ t u r t͡ʃ e
поти	p ɔ t i
мачкање	m a t͡ʃ k a ɲ e
промашува	p r ɔ m a ʃ u v a
попишувач	p ɔ p i ʃ u v a t͡ʃ
незачувување	n e z a t͡ʃ u v u v a ɲ e
карамелизирање	k a ɾ a m e l i z i ɾ a ɲ e
неетички	n e e t i t͡ʃ k i
расипник	r a s i p n i k
отпара	ɔ t p a ɾ a
незалепен	n e z a l e p e n
исчупан	i ʃ t͡ʃ u p a n
забушува	z a b u ʃ u v a
подзнак	p ɔ d z n a k
зла	z ɫ a
спринтер	s p r i n t e r
намалуван	n a m a ɫ u v a n
избавување	i z b a v u v a ɲ e
златарници	z ɫ a t a r n i t͡s i
клукне	k ɫ u k n e
нетемпиран	n e t e m p i ɾ a n
безуморен	b e z u m ɔ ɾ e n
промеша	p r ɔ m e ʃ a
занаети	z a n a e t i
радијатор	r a d i j a t ɔ r
шкотски	ʃ k ɔ t s k i
заврши	z a v r̩ ʃ i
преформулира	p r e f ɔ r m u l i ɾ a
строго	s t r ɔ ɡ ɔ
анонимизиран	a n ɔ n i m i z i ɾ a n
прајазик	p r a j a z i k
нераскревање	n e ɾ a s k r e v a ɲ e
преторијка	p r e t ɔ ɾ i j k a
младичок	m ɫ a d i t͡ʃ ɔ k
разглоби	r a z ɡ ɫ ɔ b i
распишуван	r a s p i ʃ u v a n
ненадејно	n e n a d e j n ɔ
пакистански	p a k i s t a n s k i
хипнотизер	x i p n ɔ t i z e r
наиде	n a i d e
стокми	s t ɔ k m i
лулан	ɫ u ɫ a n
термостат	t e r m ɔ s t a t
оглупавуван	ɔ ɡ ɫ u p a v u v a n
фунта	f u n t a
земјопис	z e m j ɔ p i s
мировен	m i ɾ ɔ v e n
првенство	p r̩ v e n s t v ɔ
превид	p r e v i t
монаси	m ɔ n a s i
сензуалност	s e n z u a ɫ n ɔ s t
витези	v i t e z i
гулаш	ɡ u ɫ a ʃ
лаф	ɫ a f
шаманка	ʃ a m a ŋ k a
стокмување	s t ɔ k m u v a ɲ e
пижами	p i ʒ a m i
изживее	i ʒ ʒ i v e e
посетеност	p ɔ s e t e n ɔ s t
кама	k a m a
крофне	k r ɔ f n e
непрекинлив	n e p r e k i n l i f
помакедончува	p ɔ m a k e d ɔ n t͡ʃ u v a
должини	d ɔ ɫ ʒ i n i
велибор	v e l i b ɔ r
балон	b a ɫ ɔ n
пајки	p a j k i
сплини	s p l i n i
ротквица	r ɔ t k v i t͡s a
клункање	k ɫ u ŋ k a ɲ e
разонода	r a z ɔ n ɔ d a
неконсумирање	n e k ɔ n s u m i ɾ a ɲ e
прелудиум	p r e ɫ u d i j u m
поднамокри	p ɔ d n a m ɔ k r i
шал	ʃ a ɫ
желудочен	ʒ e ɫ u d ɔ t͡ʃ e n
доличен	d ɔ l i t͡ʃ e n
вокализира	v ɔ k a l i z i ɾ a
неиздлабен	n e i z d ɫ a b e n
хронично	x r ɔ n i t͡ʃ n ɔ
лавини	ɫ a v i n i
фалсификува	f a ɫ s i f i k u v a
разнежува	r a z n e ʒ u v a
велингтонски	v e l i ŋ k t ɔ n s k i
одвраќање	ɔ d v r a c a ɲ e
матријархат	m a t r i j a r x a t
дрвце	d r̩ f t͡s e
ископан	i s k ɔ p a n
книгишта	k n i ɡ i ʃ t a
глаголивост	ɡ ɫ a ɡ ɔ l i v ɔ s t
осовременува	ɔ s ɔ v r e m e n u v a
ошлака	ɔ ʃ ɫ a k a
морнари	m ɔ r n a ɾ i
комитетлија	k ɔ m i t e t l i j a
препуштање	p r e p u ʃ t a ɲ e
нестоење	n e s t ɔ e ɲ e
расположено	r a s p ɔ ɫ ɔ ʒ e n ɔ
тест	t e s t
мразулче	m r a z u ɫ t͡ʃ e
реформиран	r e f ɔ r m i ɾ a n
непроветрен	n e p r ɔ v e t r e n
печатиште	p e t͡ʃ a t i ʃ t e
битка	b i t k a
специфицирање	s p e t͡s i f i t͡s i ɾ a ɲ e
ддв	d a d a v a
изместување	i z m e s t u v a ɲ e
колачи	k ɔ ɫ a t͡ʃ i
меѓународно	m e ɟ u n a ɾ ɔ d n ɔ
штипалка	ʃ t i p a ɫ k a
епископски	e p i s k ɔ p s k i
испитувач	i s p i t u v a t͡ʃ
раскопчуван	r a s k ɔ p t͡ʃ u v a n
везејќи	v e z e j c i
опиран	ɔ p i ɾ a n
дур	d u r
формат	f ɔ r m a t
подизлижан	p ɔ d i z l i ʒ a n
заведен	z a v e d e n
пребоен	p r e b ɔ e n
протолкуван	p r ɔ t ɔ ɫ k u v a n
евалуација	e v a ɫ u a t͡s i j a
прпелкање	p r̩ p e ɫ k a ɲ e
апстрахиран	a p s t r a x i ɾ a n
конфети	k ɔ ɱ f e t i
анонимизира	a n ɔ n i m i z i ɾ a
заболувања	z a b ɔ ɫ u v a ɲ a
акнување	a k n u v a ɲ e
дволичност	d v ɔ l i t͡ʃ n ɔ s t
жнеење	ʒ n e e ɲ e
зрее	z r e e
исшетан	i ʃ ʃ e t a n
сауна	s a u n a
раскалуѓерува	r a s k a ɫ u ɟ e ɾ u v a
неиспупчен	n e i s p u p t͡ʃ e n
растечен	r a s t e t͡ʃ e n
порочно	p ɔ ɾ ɔ t͡ʃ n ɔ
зетски	z e t s k i
електричарка	e l e k t r i t͡ʃ a r k a
ослонуван	ɔ s ɫ ɔ n u v a n
мотан	m ɔ t a n
архивист	a r x i v i s t
лем	l e m
прекројуван	p r e k r ɔ j u v a n
вработува	v r a b ɔ t u v a
вмеша	v m e ʃ a
нелегализирање	n e l e ɡ a l i z i ɾ a ɲ e
бут	b u t
анимиран	a n i m i ɾ a n
доклика	d ɔ k l i k a
потир	p ɔ t i r
отпишува	ɔ t p i ʃ u v a
бледило	b l e d i ɫ ɔ
бесшеќерен	b e ʃ ʃ e c e ɾ e n
гасеничар	ɡ a s e n i t͡ʃ a r
неконтролиран	n e k ɔ n t r ɔ l i ɾ a n
пегла	p e ɡ ɫ a
блузон	b ɫ u z ɔ n
суштественост	s u ʃ t e s t v e n ɔ s t
наврапит	n a v r a p i t
раскашавува	r a s k a ʃ a v u v a
книжен	k n i ʒ e n
побиен	p ɔ b i j e n
пасинок	p a s i n ɔ k
расфрлен	r a s f r̩ l e n
издлабуван	i z d ɫ a b u v a n
слепо	s l e p ɔ
телефонира	t e l e f ɔ n i ɾ a
пополнува	p ɔ p ɔ ɫ n u v a
италијанец	i t a l i j a n e t͡s
погано	p ɔ ɡ a n ɔ
небраска	n e b r a s k a
обвие	ɔ b v i j e
креда	k r e d a
нераздвоен	n e r a z d v ɔ e n
своеглавост	s v ɔ e ɡ ɫ a v ɔ s t
фиран	f i ɾ a n
неќарење	n e c a ɾ e ɲ e
носорози	n ɔ s ɔ ɾ ɔ z i
хаванец	x a v a n e t͡s
клавичембало	k ɫ a v i t͡ʃ e m b a ɫ ɔ
нумерира	n u m e r i ɾ a
п	p a
домешува	d ɔ m e ʃ u v a
долгосежно	d ɔ ɫ ɡ ɔ s e ʒ n ɔ
умира	u m i ɾ a
разврски	r a z v r̩ s k i
ненегирање	n e n e ɡ i ɾ a ɲ e
отфрла	ɔ t f r̩ ɫ a
полуготов	p ɔ ɫ u ɡ ɔ t ɔ f
несамостојност	n e s a m ɔ s t ɔ j n ɔ s t
развеселен	r a z v e s e l e n
оксидиран	ɔ k s i d i ɾ a n
урнатина	u r n a t i n a
бадмингтон	b a d m i ŋ k t ɔ n
отпишување	ɔ t p i ʃ u v a ɲ e
кумановка	k u m a n ɔ f k a
варен	v a ɾ e n
здружено	z d r u ʒ e n ɔ
неиспилен	n e i s p i l e n
неиндексирање	n e i n d e k s i ɾ a ɲ e
бесчувствителност	b e ʃ t͡ʃ u f s t v i t e ɫ n ɔ s t
нане	n a n e
отсекогаш	ɔ t s e k ɔ ɡ a ʃ
воздигнат	v ɔ z d i ɡ n a t
имј	i m a j a
достигне	d ɔ s t i ɡ n e
ашхабатка	a ʃ x a b a t k a
зрачење	z r a t͡ʃ e ɲ e
манамка	m a n a m k a
аранжира	a ɾ a n ʒ i ɾ a
манипулантка	m a n i p u ɫ a n t k a
ресен	r e s e n
антифашист	a n t i f a ʃ i s t
плик	p l i k
актиниум	a k t i n i j u m
хартивче	x a r t i f t͡ʃ e
непотполен	n e p ɔ t p ɔ l e n
лингвист	l i ŋ ɡ v i s t
морски	m ɔ r s k i
гневови	ɡ n e v ɔ v i
најгвирц	n a j ɡ v i r t͡s
раширен	r a ʃ i ɾ e n
личење	l i t͡ʃ e ɲ e
воскосува	v ɔ s k ɔ s u v a
мешанци	m e ʃ a n t͡s i
добрина	d ɔ b r i n a
забушаван	z a b u ʃ a v a
партизанче	p a r t i z a n t͡ʃ e
судови	s u d ɔ v i
писател	p i s a t e ɫ
дијадема	d i j a d e m a
словенски	s ɫ ɔ v e n s k i
неспецифициран	n e s p e t͡s i f i t͡s i ɾ a n
ластиче	ɫ a s t i t͡ʃ e
онанист	ɔ n a n i s t
бодри	b ɔ d r i
натнува	n a t n u v a
триста	t r i s t a
главоболка	ɡ ɫ a v ɔ b ɔ ɫ k a
индустријализира	i n d u s t r i j a l i z i ɾ a
принцези	p r i n t͡s e z a
запиран	z a p i ɾ a n
мајски	m a j s k i
аорта	a ɔ r t a
наследно	n a s l e d n ɔ
пацифист	p a t͡s i f i s t
неозначен	n e ɔ z n a t͡ʃ e n
оклагија	ɔ k ɫ a ɡ i j a
астрономски	a s t r ɔ n ɔ m s k i
заглавен	z a ɡ ɫ a v e n
валандовски	v a ɫ a n d ɔ f s k i
гра	ɡ r a
саксофонист	s a k s ɔ f ɔ n i s t
брчење	b r̩ t͡ʃ e ɲ e
враќе	v r a c e
грбно	ɡ r̩ b n ɔ
криптира	k r i p t i ɾ a
солитер	s ɔ l i t e r
интересирање	i n t e ɾ e s i ɾ a ɲ e
нагрден	n a ɡ r̩ d e n
тенисериште	t e n i s e ɾ i ʃ t e
дострижување	d ɔ s t r i ʒ u v a ɲ e
нето	n e t ɔ
преполнет	p r e p ɔ ɫ n e t
искалкулира	i s k a ɫ k u l i ɾ a
ѕидајќи	d͡z i d a j c i
гуши	ɡ u ʃ i
релативизиран	r e ɫ a t i v i z i ɾ a n
преглуп	p r e ɡ ɫ u p
гросистички	ɡ r ɔ s i s t i t͡ʃ k i
синтетизирање	s i n t e t i z i ɾ a ɲ e
опишува	ɔ p i ʃ u v a
оџаци	ɔ d͡ʒ a t͡s i
искорне	i s k ɔ r n e
висина	v i s i n a
преиспита	p r e i s p i t a
пропушта	p r ɔ p u ʃ t a
шарки	ʃ a r k i
спечалуван	s p e t͡ʃ a ɫ u v a n
пипа	p i p a
детергент	d e t e r ɡ e n t
џогери	d͡ʒ ɔ ɡ e ɾ i
масер	m a s e r
атински	a t i n s k i
предрасположуван	p r e d r a s p ɔ ɫ ɔ ʒ u v a n
нишање	n i ʃ a ɲ e
предобро	p r e d ɔ b r ɔ
малибу	m a l i b u
чамец	t͡ʃ a m e t͡s
поготви	p ɔ ɡ ɔ t v i
трга	t r̩ ɡ a
чевлиште	t͡ʃ e v l i ʃ t e
намуртеност	n a m u r t e n ɔ s t
французин	f r a n t͡s u z i n
саатчиски	s a t t͡ʃ i s k i
наврнат	n a v r̩ n a t
разори	r a z ɔ ɾ i
отплетка	ɔ t p l e t k a
развојно	r a z v ɔ j n ɔ
манипуланти	m a n i p u ɫ a n t i
вртипоп	v r̩ t i p ɔ p
прекинување	p r e k i n u v a ɲ e
крштеница	k r̩ ʃ t e n i t͡s a
напакостува	n a p a k ɔ s t u v a
хокеист	x ɔ k e i s t
песниче	p e s n i t͡ʃ e
затворан	z a t v ɔ ɾ a n
пророштво	p r ɔ ɾ ɔ ʃ t v ɔ
изнесуван	i z n e s u v a n
корозивно	k ɔ ɾ ɔ z i v n ɔ
калкирање	k a ɫ k i ɾ a ɲ e
препакување	p r e p a k u v a ɲ e
клава	k ɫ a v a
покачува	p ɔ k a t͡ʃ u v a
современ	s ɔ v r e m e n
хигрометар	x i ɡ r ɔ m e t a r
лиљак	l i ʎ a k
прилагодливо	p r i ɫ a ɡ ɔ d l i v ɔ
пеликански	p e l i k a n s k i
намрштува	n a m r̩ ʃ t u v a
доистребен	d ɔ i s t r e b e n
пауза	p a u z a
бладајќи	b ɫ a d a j c i
баталува	b a t a ɫ u v a
обол	ɔ b ɔ ɫ
пруги	p r u ɡ i
наковална	n a k ɔ v a ɫ n a
поколение	p ɔ k ɔ l e n i j e
деноноќие	d e n ɔ n ɔ c i j e
тирана	t i r a n a
непреправен	n e p r e p r a v e n
отежнувачки	ɔ t e ʒ n u v a t͡ʃ k i
чембала	t͡ʃ e m b a ɫ a
инкубација	i ŋ k u b a t͡s i j a
осрамотуван	ɔ s r a m ɔ t u v a n
распостеле	r a s p ɔ s t e l e
позеленува	p ɔ z e l e n u v a
заматување	z a m a t u v a ɲ e
наместува	n a m e s t u v a
сонча	s ɔ n t͡ʃ a
македонско	m a k e d ɔ n s k ɔ
постење	p ɔ s t e ɲ e
раселување	r a s e ɫ u v a ɲ e
мудроштина	m u d r ɔ ʃ t i n a
зобне	z ɔ b n e
отсликан	ɔ t s l i k a n
репариран	r e p a r i ɾ a n
рудари	r u d a ɾ i
рецензира	r e t͡s e n z i ɾ a
усмрдува	u s m r̩ d u v a
изграден	i z ɡ r a d e n
пури	p u ɾ i
монархија	m ɔ n a r x i j a
манометар	m a n ɔ m e t a r
потекнување	p ɔ t e k n u v a ɲ e
богатство	b ɔ ɡ a t s t v ɔ
трошач	t r ɔ ʃ a t͡ʃ
раздвои	r a z d v ɔ i
облие	ɔ b l i j e
незакотвување	n e z a k ɔ t v u v a ɲ e
подбуцне	p ɔ d b u t͡s n e
подробност	p ɔ d r ɔ b n ɔ s t
пајажина	p a j a ʒ i n a
жесток	ʒ e s t ɔ k
линчување	l i n t͡ʃ u v a ɲ e
морнар	m ɔ r n a r
павкање	p a f k a ɲ e
недохранет	n e d ɔ x r a n e t
изгонување	i z ɡ ɔ n u v a ɲ e
расрди	r a s r̩ d i
прошара	p r ɔ ʃ a ɾ a
потиштување	p ɔ t i ʃ t u v a ɲ e
ненадоместлив	n e n a d ɔ m e s t l i f
бленење	b l e n e ɲ e
свилари	s v i ɫ a ɾ i
автостоперка	a f t ɔ s t ɔ p e r k a
амарилис	a m a r i l i s
родилен	r ɔ d i l e n
снижи	s n i ʒ i
дисахарид	d i s a x a r i t
нерасхефтан	n e r a s x e f t a n
вденуван	v d e n u v a n
тестер	t e s t e r
распојаса	r a s p ɔ j a s a
мена	m e n a
испогази	i s p ɔ ɡ a z i
наведнат	n a v e d n a t
рипнување	r i p n u v a ɲ e
седум	s e d u m
емигрантка	e m i ɡ r a n t k a
скандинавски	s k a n d i n a f s k i
господ	ɡ ɔ s p ɔ t
давен	d a v e n
патарини	p a t a ɾ i n i
повеќејазичен	p ɔ v e c e j a z i t͡ʃ e n
атаман	a t a m a n
инцест	i n t͡s e s t
платно	p ɫ a t n ɔ
водоскок	v ɔ d ɔ s k ɔ k
стрви	s t r̩ v i
хиерархиски	x i j e r a r x i s k i
размазуван	r a z m a z u v a n
пребричуван	p r e b r i t͡ʃ u v a n
еуфемизам	e u f e m i z a m
суета	s u e t a
радовишанец	r a d ɔ v i ʃ a n e t͡s
покриви	p ɔ k r i v i
глобализиран	ɡ ɫ ɔ b a l i z i ɾ a n
бојкоти	b ɔ j k ɔ t i
налетува	n a l e t u v a
инцестуозно	i n t͡s e s t u ɔ z n ɔ
мнт	m a n a t a
коралски	k ɔ ɾ a ɫ s k i
тутуниште	t u t u n i ʃ t e
сешто	s e ʃ t ɔ
нептун	n e p t u n
могадишанки	m ɔ ɡ a d i ʃ a ŋ k i
пневматика	p n e v m a t i k a
реагира	r e a ɡ i ɾ a
мае	m a e
тајвански	t a j v a n s k i
дамнешен	d a m n e ʃ e n
психолингвистички	p s i x ɔ l i ŋ ɡ v i s t i t͡ʃ k i
престига	p r e s t i ɡ a
бара	b a ɾ a
исламистички	i s ɫ a m i s t i t͡ʃ k i
крикне	k r i k n e
заштедува	z a ʃ t e d u v a
антипатичен	a n t i p a t i t͡ʃ e n
као	k a ɔ
грозотија	ɡ r ɔ z ɔ t i j a
молер	m ɔ l e r
штиман	ʃ t i m a n
годење	ɡ ɔ d e ɲ e
затропа	z a t r ɔ p a
вдомуван	v d ɔ m u v a n
филмаџии	f i ɫ m a d͡ʒ i i
сенчење	s e n t͡ʃ e ɲ e
екипиче	e k i p i t͡ʃ e
редактира	r e d a k t i ɾ a
наведнување	n a v e d n u v a ɲ e
стомниште	s t ɔ m n i ʃ t e
потсмешлив	p ɔ t s m e ʃ l i f
хрват	x r̩ v a t
топорење	t ɔ p ɔ ɾ e ɲ e
доспремање	d ɔ s p r e m a ɲ e
бригаден	b r i ɡ a d e n
доплаќа	d ɔ p ɫ a c a
мангупиште	m a ŋ ɡ u p i ʃ t e
парцијален	p a r t͡s i j a l e n
незаврзување	n e z a v r̩ z u v a ɲ e
пициште	p i t͡s i ʃ t e
пригода	p r i ɡ ɔ d a
делче	d e ɫ t͡ʃ e
командување	k ɔ m a n d u v a ɲ e
засукување	z a s u k u v a ɲ e
испотутка	i s p ɔ t u t k a
забучи	z a b u t͡ʃ i
забрзува	z a b r̩ z u v a
композиции	k ɔ m p ɔ z i t͡s i i
перен	p e ɾ e n
млак	m ɫ a k
приметување	p r i m e t u v a ɲ e
нескротен	n e s k r ɔ t e n
премелува	p r e m e ɫ u v a
нетрпеливо	n e t r̩ p e l i v ɔ
одбегнат	ɔ d b e ɡ n a t
џорџтаунци	d͡ʒ ɔ r t͡ʃ t a u n t͡s i
топонимија	t ɔ p ɔ n i m i j a
посипува	p ɔ s i p u v a
сантодомингоански	s a n t ɔ d ɔ m i ŋ ɡ ɔ a n s k i
расадува	r a s a d u v a
класика	k ɫ a s i k a
комесаријат	k ɔ m e s a ɾ i j a t
револуционизира	r e v ɔ ɫ u t͡s i j ɔ n i z i ɾ a
убацува	u b a t͡s u v a
неизбањат	n e i z b a ɲ a t
епентеза	e p e n t e z a
преморува	p r e m ɔ ɾ u v a
праматари	p r a m a t a ɾ i
њујорчанец	ɲ u j ɔ r t͡ʃ a n e t͡s
накаже	n a k a ʒ e
експресионист	e k s p r e s i j ɔ n i s t
триумфално	t r i j u ɱ f a ɫ n ɔ
јуфка	j u f k a
побутнуван	p ɔ b u t n u v a n
ќупови	c u p ɔ v i
неженење	n e ʒ e n e ɲ e
резистентно	r e z i s t e n t n ɔ
искамшикува	i s k a m ʃ i k u v a
творен	t v ɔ ɾ e n
воочлив	v ɔ ɔ t͡ʃ l i f
идиоти	i d i ɔ t i
ледина	l e d i n a
суетност	s u e t n ɔ s t
обелување	ɔ b e ɫ u v a ɲ e
косо	k ɔ s ɔ
ранчер	r a n t͡ʃ e r
дуален	d u a l e n
љупи	ʎ u p i
североисточен	s e v e ɾ ɔ i s t ɔ t͡ʃ e n
свидетелство	s v i d e t e ɫ s t v ɔ
кичевчанец	k i t͡ʃ e f t͡ʃ a n e t͡s
бунтувајќи	b u n t u v a j c i
златица	z ɫ a t i t͡s a
бонтон	b ɔ n t ɔ n
тупотење	t u p ɔ t e ɲ e
триаголно	t r i a ɡ ɔ ɫ n ɔ
никозијка	n i k ɔ z i j k a
поѕвони	p ɔ d͡z v ɔ n i
киселински	k i s e l i n s k i
скротуван	s k r ɔ t u v a n
маѓепсница	m a ɟ e p s n i t͡s a
елеганција	e l e ɡ a n t͡s i j a
преса	p r e s a
видливост	v i d l i v ɔ s t
пренесувач	p r e n e s u v a t͡ʃ
царистка	t͡s a r i s t k a
испокара	i s p ɔ k a ɾ a
бе	b e
библиофил	b i b l i j ɔ f i ɫ
зломислено	z ɫ ɔ m i s l e n ɔ
вдлабне	v d ɫ a b n e
уснен	u s n e n
наточува	n a t ɔ t͡ʃ u v a
кисели	k i s e l i
градбено	ɡ r a d b e n ɔ
пријателство	p r i j a t e ɫ s t v ɔ
поткрепи	p ɔ t k r e p i
зашамара	z a ʃ a m a ɾ a
портлуисанка	p ɔ r t ɫ u i s a ŋ k a
двоспратен	d v ɔ s p r a t e n
зграпчен	z ɡ r a p t͡ʃ e n
преколнува	p r e k ɔ ɫ n u v a
џогинг	d͡ʒ ɔ ɡ i ŋ k
виори	v i j ɔ ɾ i
дораби	d ɔ ɾ a b i
шасија	ʃ a s i j a
хартиен	x a r t i j e n
сом	s ɔ m
наменет	n a m e n e t
алабастер	a ɫ a b a s t e r
нагмечуван	n a ɡ m e t͡ʃ u v a n
немрднување	n e m r̩ d n u v a ɲ e
партал	p a r t a ɫ
гулаб	ɡ u ɫ a p
отрови	ɔ t r ɔ v i
префарбан	p r e f a r b a n
третоодделенче	t r e t ɔ ɔ d d e l e n t͡ʃ e
сочувство	s ɔ t͡ʃ u f s t v ɔ
засолнување	z a s ɔ ɫ n u v a ɲ e
билкарки	b i ɫ k a r k i
говетце	ɡ ɔ v e t t͡s e
забарикадира	z a b a ɾ i k a d i ɾ a
соја	s ɔ j a
пушач	p u ʃ a t͡ʃ
фреска	f r e s k a
изумира	i z u m i ɾ a
седумдести	s e d u m d e s t i
пилана	p i ɫ a n a
техерански	t e x e ɾ a n s k i
кметува	k m e t u v a
предгорја	p r e d ɡ ɔ r j a
неодбивање	n e ɔ d b i v a ɲ e
оригиналност	ɔ ɾ i ɡ i n a ɫ n ɔ s t
фала	f a ɫ a
недеактивиран	n e d e a k t i v i ɾ a n
малави	m a ɫ a v i
повампирен	p ɔ v a m p i ɾ e n
срциња	s r̩ t͡s i ɲ a
доноси	d ɔ n ɔ s i
залижан	z a l i ʒ a n
класифициран	k ɫ a s i f i t͡s i ɾ a n
дпм	d a p a m a
подмети	p ɔ d m e t i
квинтесенција	k v i n t e s e n t͡s i j a
прогноза	p r ɔ ɡ n ɔ z a
расади	r a s a d i
авантуристка	a v a n t u r i s t k a
буревесници	b u ɾ e v e s n i t͡s i
арамбаша	a r a m b a ʃ a
аха	a x a
савана	s a v a n a
хормонално	x ɔ r m ɔ n a ɫ n ɔ
ремонтира	r e m ɔ n t i ɾ a
топаз	t ɔ p a s
неистоварање	n e i s t ɔ v a ɾ a ɲ e
првоодделенски	p r̩ v ɔ ɔ d d e l e n s k i
неинтервенирање	n e i n t e r v e n i ɾ a ɲ e
врколачки	v r̩ k ɔ ɫ a t͡ʃ k i
инвалид	i ɱ v a l i t
отсечоци	ɔ t s e t͡ʃ ɔ t͡s i
приврзаници	p r i v r̩ z a n i t͡s i
змејски	z m e j s k i
препораки	p r e p ɔ ɾ a k i
константно	k ɔ n s t a n t n ɔ
понишан	p ɔ n i ʃ a n
влијателно	v l i j a t e ɫ n ɔ
протеруван	p r ɔ t e ɾ u v a n
намигнување	n a m i ɡ n u v a ɲ e
сатирично	s a t i ɾ i t͡ʃ n ɔ
бунарски	b u n a r s k i
апсолутен	a p s ɔ ɫ u t e n
вонсезонски	v ɔ n s e z ɔ n s k i
огин	ɔ ɡ i n
букира	b u k i ɾ a
резервација	r e z e r v a t͡s i j a
домарски	d ɔ m a r s k i
бакардисувајќи	b a k a r d i s u v a j c i
заљубено	z a ʎ u b e n ɔ
пантомимичар	p a n t ɔ m i m i t͡ʃ a r
прегрнат	p r e ɡ r̩ n a t
преклопува	p r e k ɫ ɔ p u v a
стекнува	s t e k n u v a
злочин	z ɫ ɔ t͡ʃ i n
меѓуножја	m e ɟ u n ɔ ʒ j a
елениште	e l e n i ʃ t e
височок	v i s ɔ t͡ʃ ɔ k
исцртување	i s t͡s r̩ t u v a ɲ e
пронаоѓање	p r ɔ n a ɔ ɟ a ɲ e
наградуван	n a ɡ r a d u v a n
притворува	p r i t v ɔ ɾ u v a
завидливо	z a v i d l i v ɔ
капитализиран	k a p i t a l i z i ɾ a n
неотварање	n e ɔ t v a ɾ a ɲ e
стоногалка	s t ɔ n ɔ ɡ a ɫ k a
кофеин	k ɔ f e i n
гоштева	ɡ ɔ ʃ t e v a
вентилатори	v e n t i ɫ a t ɔ ɾ i
импониран	i m p ɔ n i ɾ a n
мугра	m u ɡ r a
манипулиран	m a n i p u l i ɾ a n
долготрајно	d ɔ ɫ ɡ ɔ t r a j n ɔ
оформуван	ɔ f ɔ r m u v a n
неморален	n e m ɔ ɾ a l e n
ѓаволче	ɟ a v ɔ ɫ t͡ʃ e
штрекнува	ʃ t r e k n u v a
тресе	t r e s e
достојно	d ɔ s t ɔ j n ɔ
ојаловен	ɔ j a ɫ ɔ v e n
осакатува	ɔ s a k a t u v a
трупци	t r u p t͡s i
шиљо	ʃ i ʎ ɔ
прекоси	p r e k ɔ s i
касне	k a s n e
бесцелен	b e s t͡s e l e n
легенда	l e ɡ e n d a
плагијатор	p ɫ a ɡ i j a t ɔ r
узакони	u z a k ɔ n i
цртежи	t͡s r̩ t e ʒ i
ноќно	n ɔ c n ɔ
ц	t͡s a
истумба	i s t u m b a
оптимален	ɔ p t i m a l e n
исчеша	i ʃ t͡ʃ e ʃ a
скаперници	s k a p e r n i t͡s i
месење	m e s e ɲ e
вниманија	v n i m a n i j a
колективност	k ɔ l e k t i v n ɔ s t
пленство	p l e n s t v ɔ
рекиште	r e k i ʃ t e
шминкан	ʃ m i ŋ k a n
харков	x a r k ɔ f
стандардно	s t a n d a r d n ɔ
приватизиран	p r i v a t i z i ɾ a n
инвентар	i ɱ v e n t a r
венецуелка	v e n e t͡s u e ɫ k a
краишта	k r a i ʃ t a
земјотресение	z e m j ɔ t r e s e n i j e
довиткува	d ɔ v i t k u v a
тамошен	t a m ɔ ʃ e n
духовнички	d u x ɔ v n i t͡ʃ k i
многулик	m n ɔ ɡ u l i k
семен	s e m e n
филозофија	f i ɫ ɔ z ɔ f i j a
ликвидирање	l i k v i d i ɾ a ɲ e
стокхолмци	s t ɔ k x ɔ ɫ m t͡s i
изнуди	i z n u d i
одбирање	ɔ d b i ɾ a ɲ e
стефан	s t e f a n
давател	d a v a t e ɫ
гени	ɡ e n i
слепоочница	s l e p ɔ ɔ t͡ʃ n i t͡s a
лансиран	ɫ a n s i ɾ a n
вајмарски	v a j m a r s k i
копнежливо	k ɔ p n e ʒ l i v ɔ
дотресен	d ɔ t r e s e n
синдром	s i n d r ɔ m
испохефта	i s p ɔ x e f t a
сакраментален	s a k r a m e n t a l e n
сатиричари	s a t i r i t͡ʃ a ɾ i
заофка	z a ɔ f k a
карета	k a r e t a
пластифициран	p ɫ a s t i f i t͡s i ɾ a n
прооден	p r ɔ ɔ d e n
зевс	z e f s
информативност	i ɱ f ɔ r m a t i v n ɔ s t
резимирање	r e z i m i ɾ a ɲ e
недоспремен	n e d ɔ s p r e m e n
пливање	p l i v a ɲ e
зорт	z ɔ r t
богданци	b ɔ ɡ d a n t͡s i
флизер	f l i z e r
шишиња	ʃ i ʃ i ɲ a
исправуван	i s p r a v u v a n
засрамен	z a s r a m e n
подгорчување	p ɔ d ɡ ɔ r t͡ʃ u v a ɲ e
прешива	p r e ʃ i v a
траурен	t r a u ɾ e n
обесцени	ɔ b e s t͡s e n i
претекнуван	p r e t e k n u v a n
варијанта	v a ɾ i j a n t a
навалуван	n a v a ɫ u v a n
сања	s a ɲ a
фунти	f u n t i
неаболиран	n e a b ɔ l i ɾ a n
фаза	f a z a
дооблечен	d ɔ ɔ b l e t͡ʃ e n
изземе	i z z e m e
корка	k ɔ r k a
бебуленце	b e b u l e n t͡s e
сликнува	s l i k n u v a
презентација	p r e z e n t a t͡s i j a
обвинителен	ɔ b v i n i t e l e n
ревматологија	r e v m a t ɔ ɫ ɔ ɡ i j a
училишен	u t͡ʃ i l i ʃ e n
збунетост	z b u n e t ɔ s t
сноб	s n ɔ p
вртоглав	v r̩ t ɔ ɡ ɫ a f
автобуска	a f t ɔ b u s k a
квиз	k v i s
придружуван	p r i d r u ʒ u v a n
лекувачки	l e k u v a t͡ʃ k i
превземе	p r e v z e m e
обиколи	ɔ b i k ɔ l i
полумесец	p ɔ ɫ u m e s e t͡s
тастер	t a s t e r
салце	s a ɫ t͡s e
четриесе	t͡ʃ e t r i j e s e
пудра	p u d r a
пожарни	p ɔ ʒ a r n i
монокл	m ɔ n ɔ k ɫ̩
злотворен	z ɫ ɔ t v ɔ ɾ e n
кингстон	k i ŋ k s t ɔ n
алчно	a ɫ t͡ʃ n ɔ
стока	s t ɔ k a
одмрзне	ɔ d m r̩ z n e
разлошен	r a z ɫ ɔ ʃ e n
србинка	s r̩ b i ŋ k a
докторантка	d ɔ k t ɔ r a n t k a
смока	s m ɔ k a
киселини	k i s e l i n i
маѓарско	m a ɟ a r s k ɔ
дочува	d ɔ t͡ʃ u v a
вклучителност	f k ɫ u t͡ʃ i t e ɫ n ɔ s t
грбче	ɡ r̩ p t͡ʃ e
предучилиштен	p r e d u t͡ʃ i l i ʃ t e n
гасометар	ɡ a s ɔ m e t a r
сузбиен	s u z b i j e n
муцки	m u t͡s k i
папирологија	p a p i ɾ ɔ ɫ ɔ ɡ i j a
небендисување	n e b e n d i s u v a ɲ e
колкумина	k ɔ ɫ k u m i n a
примарно	p r i m a r n ɔ
порази	p ɔ ɾ a z i
портири	p ɔ r t i ɾ i
усвитува	u s v i t u v a
дунав	d u n a f
искажан	i s k a ʒ a n
јамб	j a m p
бејрут	b e j r u t
унапреден	u n a p r e d e n
пропорционален	p r ɔ p ɔ r t͡s i j ɔ n a l e n
дипломски	d i p ɫ ɔ m s k i
избрука	i z b r u k a
воведно	v ɔ v e d n ɔ
антифашистички	a n t i f a ʃ i s t i t͡ʃ k i
пинокио	p i n ɔ k i j ɔ
незаокружен	n e z a ɔ k r u ʒ e n
идиличен	i d i l i t͡ʃ e n
китен	k i t e n
доминикански	d ɔ m i n i k a n s k i
земјотрес	z e m j ɔ t r e s
архитект	a r x i t e k t
непредложување	n e p r e d ɫ ɔ ʒ u v a ɲ e
вкусувајќи	f k u s u v a j c i
размрежува	r a z m r e ʒ u v a
летаргија	l e t a r ɡ i j a
крило	k r i ɫ ɔ
прецвета	p r e t͡s v e t a
портирски	p ɔ r t i r s k i
ожеднува	ɔ ʒ e d n u v a
штипјанки	ʃ t i p j a ŋ k i
арогантен	a ɾ ɔ ɡ a n t e n
распознавање	r a s p ɔ z n a v a ɲ e
легитимно	l e ɡ i t i m n ɔ
козметичарка	k ɔ z m e t i t͡ʃ a r k a
флуиден	f ɫ u i d e n
испремести	i s p r e m e s t i
титриран	t i t r i ɾ a n
полов	p ɔ ɫ ɔ f
екстремно	e k s t r e m n ɔ
двоглав	d v ɔ ɡ ɫ a f
преградување	p r e ɡ r a d u v a ɲ e
аранжиран	a ɾ a n ʒ i ɾ a n
пороби	p ɔ ɾ ɔ b i
спасител	s p a s i t e ɫ
специјалец	s p e t͡s i j a l e t͡s
манифест	m a n i f e s t
дознаен	d ɔ z n a e n
рафиниран	r a f i n i ɾ a n
заглавување	z a ɡ ɫ a v u v a ɲ e
влече	v l e t͡ʃ e
ризикуван	r i z i k u v a n
недостижно	n e d ɔ s t i ʒ n ɔ
бифокален	b i f ɔ k a l e n
менѓуша	m e ɲ ɟ u ʃ a
клеца	k l e t͡s a
четврточен	t͡ʃ e t v r̩ t ɔ t͡ʃ e n
неудобен	n e u d ɔ b e n
папан	p a p a n
пердув	p e r d u f
дотекува	d ɔ t e k u v a
нефилтрирање	n e f i ɫ t r i ɾ a ɲ e
номинирање	n ɔ m i n i ɾ a ɲ e
љубејќи	ʎ u b e j c i
мовлив	m ɔ v l i f
прежален	p r e ʒ a l e n
неисхранет	n e i s x r a n e t
женкари	ʒ e ŋ k a ɾ i
маскатски	m a s k a t s k i
семенски	s e m e n s k i
шуми	ʃ u m i
поцрнува	p ɔ t͡s r̩ n u v a
андорка	a n d ɔ r k a
масиште	m a s i ʃ t e
акушерство	a k u ʃ e r s t v ɔ
пожелност	p ɔ ʒ e ɫ n ɔ s t
крадешкум	k r a d e ʃ k u m
ласици	ɫ a s i t͡s i
борч	b ɔ r t͡ʃ
неактуализирање	n e a k t u a l i z i ɾ a ɲ e
меритократија	m e ɾ i t ɔ k r a t i j a
безусловно	b e z u s ɫ ɔ v n ɔ
засмевање	z a s m e v a ɲ e
дереџе	d e ɾ e d͡ʒ e
шеријат	ʃ e ɾ i j a t
нефенирање	n e f e n i ɾ a ɲ e
трезно	t r e z n ɔ
херметички	x e r m e t i t͡ʃ k i
гори	ɡ ɔ ɾ i
преграден	p r e ɡ r a d e n
трауматичен	t r a u m a t i t͡ʃ e n
националноослободителен	n a t͡s i j ɔ n a ɫ n ɔ ɔ s ɫ ɔ b ɔ d i t e l e n
наслика	n a s l i k a
непредизвикување	n e p r e d i z v i k u v a ɲ e
напумпан	n a p u m p a n
сеул	s e u ɫ
стражарка	s t r a ʒ a r k a
безвредно	b e z v r e d n ɔ
шнајдер	ʃ n a j d e r
исцелува	i s t͡s e ɫ u v a
основ	ɔ s n ɔ f
мариово	m a r i j ɔ v ɔ
чворче	t͡ʃ v ɔ r t͡ʃ e
накострешува	n a k ɔ s t r e ʃ u v a
догнивање	d ɔ ɡ n i v a ɲ e
накитување	n a k i t u v a ɲ e
раженче	r a ʒ e n t͡ʃ e
прикаска	p r i k a s k a
потполковници	p ɔ t p ɔ ɫ k ɔ v n i t͡s i
хашки	x a ʃ k i
њујорк	ɲ u j ɔ r k
геодезија	ɡ e ɔ d e z i j a
атлас	a t ɫ a s
плеснат	p l e s n a t
извлекуван	i z v l e k u v a
ограничувања	ɔ ɡ r a n i t͡ʃ u v a ɲ a
пренесува	p r e n e s u v a
парафира	p a ɾ a f i ɾ a
ликвидира	l i k v i d i ɾ a
заврзува	z a v r̩ z u v a
телекомуникациски	t e l e k ɔ m u n i k a t͡s i s k i
омачување	ɔ m a t͡ʃ u v a ɲ e
чудовишност	t͡ʃ u d ɔ v i ʃ n ɔ s t
соединување	s ɔ e d i n u v a ɲ e
слушне	s ɫ u ʃ n e
човекоубиство	t͡ʃ ɔ v e k ɔ u b i s t v ɔ
слатко	s ɫ a t k ɔ
налупан	n a ɫ u p a n
боцичка	b ɔ t͡s i t͡ʃ k a
скијање	s k i j a ɲ e
нагрби	n a ɡ r̩ b i
два	d v a
кориснички	k ɔ r i s n i t͡ʃ k i
канцероген	k a n t͡s e ɾ ɔ ɡ e n
противприродно	p r ɔ t i f p r i ɾ ɔ d n ɔ
нецитиран	n e t͡s i t i ɾ a n
доближуван	d ɔ b l i ʒ u v a n
ланчан	ɫ a n t͡ʃ a n
ендокринологија	e n d ɔ k r i n ɔ ɫ ɔ ɡ i j a
којзнае	k ɔ j z n a e
ќејф	c e j f
јажар	j a ʒ a r
стрв	s t r̩ f
шверца	ʃ v e r t͡s a
слива	s l i v a
полуосветлен	p ɔ ɫ u ɔ s v e t l e n
акварел	a k v a r e ɫ
предуслов	p r e d u s ɫ ɔ f
јаворишта	j a v ɔ ɾ i ʃ t a
чуе	t͡ʃ u e
засегне	z a s e ɡ n e
минималистка	m i n i m a l i s t k a
бурмански	b u r m a n s k i
видин	v i d i n
подложен	p ɔ d ɫ ɔ ʒ e n
дорешен	d ɔ ɾ e ʃ e n
разбранува	r a z b r a n u v a
брчкајќи	b r̩ t͡ʃ k a j c i
мажите	m a ʒ i t e
етикетичка	e t i k e t i t͡ʃ k a
литосфера	l i t ɔ s f e ɾ a
стопуван	s t ɔ p u v a n
воспоставување	v ɔ s p ɔ s t a v u v a ɲ e
мелнички	m e ɫ n i t͡ʃ k i
сали	s a l i
палачинка	p a ɫ a t͡ʃ i ŋ k a
вати	v a t i
северџански	s e v e r d͡ʒ a n s k i
фркне	f r̩ k n e
зголемен	z ɡ ɔ l e m e n
оморика	ɔ m ɔ ɾ i k a
менувачница	m e n u v a t͡ʃ n i t͡s a
погмечи	p ɔ ɡ m e t͡ʃ i
хибискус	x i b i s k u s
еј	e j
оружја	ɔ ɾ u ʒ j a
багра	b a ɡ r a
томографија	t ɔ m ɔ ɡ r a f i j a
неовенат	n e ɔ v e n a t
латиноамерикански	ɫ a t i n ɔ a m e r i k a n s k i
ливади	l i v a d i
корегирање	k ɔ ɾ e ɡ i ɾ a ɲ e
цирокумулус	t͡s i ɾ ɔ k u m u ɫ u s
секад	s e k a t
лекари	l e k a ɾ i
вруќина	v r u c i n a
пјонгјанжанка	p j ɔ ŋ ɡ j a n ʒ a ŋ k a
мноштво	m n ɔ ʃ t v ɔ
коптски	k ɔ p t s k i
појадување	p ɔ j a d u v a ɲ e
селекционен	s e l e k t͡s i ɔ n e n
еклер	e k l e r
опуси	ɔ p u s i
подотрезнет	p ɔ d ɔ t r e z n e t
инкубатори	i ŋ k u b a t ɔ ɾ i
неоткован	n e ɔ t k ɔ v a n
разголување	r a z ɡ ɔ ɫ u v a ɲ e
субверзивен	s u b v e r z i v e n
бескарактерен	b e s k a r a k t e ɾ e n
неготвење	n e ɡ ɔ t v e ɲ e
јаглика	j a ɡ l i k a
бунтовници	b u n t ɔ v n i t͡s i
преродбеничка	p r e ɾ ɔ d b e n i t͡ʃ k a
негушанки	n e ɡ u ʃ a ŋ k i
немаскирање	n e m a s k i ɾ a ɲ e
катиљ	k a t i ʎ
незаборавно	n e z a b ɔ ɾ a v n ɔ
неизброен	n e i z b r ɔ e n
координационен	k ɔ ɔ r d i n a t͡s i ɔ n e n
фоки	f ɔ k i
миксер	m i k s e r
поручек	p ɔ ɾ u t͡ʃ e k
дропли	d r ɔ p l i
затрудни	z a t r u d n i
струготина	s t r u ɡ ɔ t i n a
џогер	d͡ʒ ɔ ɡ e r
славно	s ɫ a v n ɔ
меѓуверски	m e ɟ u v e r s k i
густо	ɡ u s t ɔ
дополна	d ɔ p ɔ ɫ n a
жанр	ʒ a n r̩
сигурен	s i ɡ u ɾ e n
конечен	k ɔ n e t͡ʃ e n
нестиснат	n e s t i s n a t
зараснува	z a r a s n u v a
режира	r e ʒ i ɾ a
оцрни	ɔ t͡s r̩ n i
плех	p l e x
гледан	ɡ l e d a n
светка	s v e t k a
преместуван	p r e m e s t u v a n
исполни	i s p ɔ ɫ n i
ракуниште	r a k u n i ʃ t e
изнакопан	i z n a k ɔ p a n
сврзе	s v r̩ z e
дружење	d r u ʒ e ɲ e
наблажување	n a b ɫ a ʒ u v a ɲ e
плешка	p l e ʃ k a
жалбено	ʒ a ɫ b e n ɔ
насилник	n a s i ɫ n i k
лабав	ɫ a b a f
девери	d e v e ɾ i
ацко	a t͡s k ɔ
крева	k r e v a
испитува	i s p i t u v a
успива	u s p i v a
попречно	p ɔ p r e t͡ʃ n ɔ
корумпиран	k ɔ ɾ u m p i ɾ a n
посмртница	p ɔ s m r̩ t n i t͡s a
наговара	n a ɡ ɔ v a ɾ a
жениве	ʒ e n i v e
туженик	t u ʒ e n i k
бормашина	b ɔ r m a ʃ i n a
мажов	m a ʒ ɔ f
заѕидува	z a d͡z i d u v a
интерактивност	i n t e r a k t i v n ɔ s t
обожавателски	ɔ b ɔ ʒ a v a t e ɫ s k i
мнозински	m n ɔ z i n s k i
богољубиво	b ɔ ɡ ɔ ʎ u b i v ɔ
инжињер	i n ʒ i ɲ e r
ха	x a
висококатници	v i s ɔ k ɔ k a t n i t͡s i
активација	a k t i v a t͡s i j a
осетлив	ɔ s e t l i f
кујна	k u j n a
топографија	t ɔ p ɔ ɡ r a f i j a
батали	b a t a l i
паника	p a n i k a
чекорење	t͡ʃ e k ɔ ɾ e ɲ e
сошие	s ɔ ʃ i j e
судење	s u d e ɲ e
аниматор	a n i m a t ɔ r
прифаќање	p r i f a c a ɲ e
човечно	t͡ʃ ɔ v e t͡ʃ n ɔ
пијанка	p i j a ŋ k a
неисфризиран	n e i s f r i z i ɾ a n
распламтен	r a s p ɫ a m t e n
месапски	m e s a p s k i
заклатување	z a k ɫ a t u v a ɲ e
назначуван	n a z n a t͡ʃ u v a n
епопеја	e p ɔ p e j a
етикети	e t i k e t i
ветрулиња	v e t r u l i ɲ a
непостење	n e p ɔ s t e ɲ e
насмевнат	n a s m e v n a t
разжалостен	r a ʒ ʒ a ɫ ɔ s t e n
пицерија	p i t͡s e ɾ i j a
лажовен	ɫ a ʒ ɔ v e n
нередовен	n e r e d ɔ v e n
гревовно	ɡ r e v ɔ v n ɔ
отпаѓање	ɔ t p a ɟ a ɲ e
самоуштво	s a m ɔ u ʃ t v ɔ
негенериран	n e ɡ e n e r i ɾ a n
изгубен	i z ɡ u b e n
раскостуван	r a s k ɔ s t u v a n
однесуван	ɔ d n e s u v a n
причува	p r i t͡ʃ u v a
затрпа	z a t r̩ p a
индонезиец	i n d ɔ n e z i j e t͡s
леопард	l e ɔ p a r t
нафрлен	n a f r̩ l e n
бакнува	b a k n u v a
вентијага	v e n t i j a ɡ a
угостителство	u ɡ ɔ s t i t e ɫ s t v ɔ
суванка	s u v a ŋ k a
непотенцирање	n e p ɔ t e n t͡s i ɾ a ɲ e
нуакшотјанка	n u a k ʃ ɔ t j a ŋ k a
војвотски	v ɔ j v ɔ t s k i
подмладува	p ɔ d m ɫ a d u v a
љубителски	ʎ u b i t e ɫ s k i
дамаски	d a m a s k i
прошверца	p r ɔ ʃ v e r t͡s a
намоткан	n a m ɔ t k a n
трнливост	t r̩ n l i v ɔ s t
засолнет	z a s ɔ ɫ n e t
постепен	p ɔ s t e p e n
кошта	k ɔ ʃ t a
мустаќлија	m u s t a c l i j a
ибриче	i b r i t͡ʃ e
човечност	t͡ʃ ɔ v e t͡ʃ n ɔ s t
неполнење	n e p ɔ ɫ n e ɲ e
аранжирајќи	a ɾ a n ʒ i r a j c i
вливајќи	v l i v a j c i
немаркирање	n e m a r k i ɾ a ɲ e
бански	b a n s k i
продлабочен	p r ɔ d ɫ a b ɔ t͡ʃ e n
топови	t ɔ p ɔ v i
бунгалов	b u ŋ ɡ a ɫ ɔ f
цвилење	t͡s v i l e ɲ e
ладничок	ɫ a d n i t͡ʃ ɔ k
необоснованост	n e ɔ b ɔ s n ɔ v a n ɔ s t
ајвари	a j v a ɾ i
куќичка	k u c i t͡ʃ k a
сирена	s i r e n a
гусарство	ɡ u s a r s t v ɔ
кореспонденција	k ɔ ɾ e s p ɔ n d e n t͡s i j a
соучесништво	s ɔ u t͡ʃ e s n i ʃ t v ɔ
киселкаст	k i s e ɫ k a s t
ене	e n e
простичок	p r ɔ s t i t͡ʃ ɔ k
менаџерски	m e n a d͡ʒ e r s k i
бубалица	b u b a l i t͡s a
трговија	t r̩ ɡ ɔ v i j a
зјапне	z j a p n e
корупција	k ɔ r u p t͡s i j a
монети	m ɔ n e t i
двоумење	d v ɔ u m e ɲ e
немирисање	n e m i r i s a ɲ e
препраќање	p r e p r a c a ɲ e
наквасување	n a k v a s u v a ɲ e
беспримерност	b e s p r i m e r n ɔ s t
масакрирање	m a s a k r i ɾ a ɲ e
обусловуван	ɔ b u s ɫ ɔ v u v a n
газа	ɡ a z a
закупец	z a k u p e t͡s
претресува	p r e t r e s u v a
мирудија	m i r u d i j a
испијанет	i s p i j a n e t
натумпани	n a t u m p a n i
комуницира	k ɔ m u n i t͡s i ɾ a
пуристички	p u r i s t i t͡ʃ k i
убав	u b a f
масен	m a s e n
соопштение	s ɔ ɔ p ʃ t e n i j e
опрасување	ɔ p r a s u v a ɲ e
мајки	m a j k i
производителка	p r ɔ i z v ɔ d i t e ɫ k a
океан	ɔ k e a n
неготинец	n e ɡ ɔ t i n e t͡s
соблече	s ɔ b l e t͡ʃ e
пигмент	p i ɡ m e n t
небудење	n e b u d e ɲ e
хиндуист	x i n d u i s t
заговорница	z a ɡ ɔ v ɔ r n i t͡s a
исполнуван	i s p ɔ ɫ n u v a n
тироиден	t i ɾ ɔ i d e n
уставно	u s t a v n ɔ
табеларен	t a b e ɫ a ɾ e n
растуран	r a s t u ɾ a n
предвесница	p r e d v e s n i t͡s a
сатанизира	s a t a n i z i ɾ a
блесок	b l e s ɔ k
грандиозен	ɡ r a n d i ɔ z e n
чекалници	t͡ʃ e k a ɫ n i t͡s i
кениски	k e n i s k i
кораб	k ɔ ɾ a p
маршал	m a r ʃ a ɫ
бернец	b e r n e t͡s
спермицид	s p e r m i t͡s i t
повртен	p ɔ v r̩ t e n
угостување	u ɡ ɔ s t u v a ɲ e
ангажман	a ŋ ɡ a ʒ m a n
жупанија	ʒ u p a n i j a
укор	u k ɔ r
фактурира	f a k t u r i ɾ a
авокада	a v ɔ k a d a
противници	p r ɔ t i v n i t͡s i
невосприемање	n e v ɔ s p r i e m a ɲ e
несебично	n e s e b i t͡ʃ n ɔ
кал	k a ɫ
клиентелизам	k l i j e n t e l i z a m
вектор	v e k t ɔ r
мисионерка	m i s i j ɔ n e r k a
сестриче	s e s t r i t͡ʃ e
сожителка	s ɔ ʒ i t e ɫ k a
бинго	b i ŋ ɡ ɔ
кокос	k ɔ k ɔ s
хагиографија	x a ɡ i j ɔ ɡ r a f i j a
сендвичиште	s e n d v i t͡ʃ i ʃ t e
позира	p ɔ z i ɾ a
несоблечен	n e s ɔ b l e t͡ʃ e n
санмаринец	s a n m a r i n e t͡s
несовесност	n e s ɔ v e s n ɔ s t
разменет	r a z m e n e t
претпочитање	p r e t p ɔ t͡ʃ i t a ɲ e
досушува	d ɔ s u ʃ u v a
осуши	ɔ s u ʃ i
богота	b ɔ ɡ ɔ t a
хонијарски	x ɔ n i j a r s k i
алоцира	a ɫ ɔ t͡s i ɾ a
помислување	p ɔ m i s ɫ u v a ɲ e
врвеж	v r̩ v e ʃ
мртвопроверител	m r̩ t v ɔ p r ɔ v e ɾ i t e ɫ
недовршен	n e d ɔ v r̩ ʃ e n
смлачен	s m ɫ a t͡ʃ e n
порочност	p ɔ ɾ ɔ t͡ʃ n ɔ s t
диган	d i ɡ a n
истакнуван	i s t a k n u v a n
симона	s i m ɔ n a
черепен	t͡ʃ e ɾ e p e n
амалгамиран	a m a ɫ ɡ a m i ɾ a n
хедонизам	x e d ɔ n i z a m
доктор	d ɔ k t ɔ r
брборка	b r̩ b ɔ r k a
марјана	m a r j a n a
цепен	t͡s e p e n
простачиште	p r ɔ s t a t͡ʃ i ʃ t e
модернист	m ɔ d e r n i s t
шинат	ʃ i n a t
забен	z a b e n
собеседничка	s ɔ b e s e d n i t͡ʃ k a
забрадување	z a b r a d u v a ɲ e
јува	j u v a
кариран	k a r i ɾ a n
расече	r a s e t͡ʃ e
згужван	z ɡ u ʒ v a n
копенхашки	k ɔ p e ŋ x a ʃ k i
елен	e l e n
прекречен	p r e k r e t͡ʃ e n
разурнувачки	r a z u r n u v a t͡ʃ k i
ненадоместливост	n e n a d ɔ m e s t l i v ɔ s t
македонка	m a k e d ɔ ŋ k a
соучесница	s ɔ u t͡ʃ e s n i t͡s a
лош	ɫ ɔ ʃ
јазолче	j a z ɔ ɫ t͡ʃ e
черупа	t͡ʃ e r u p a
ветерница	v e t e r n i t͡s a
наводенување	n a v ɔ d e n u v a ɲ e
обесуван	ɔ b e s u v a n
адмирали	a d m i r a l i
лајк	ɫ a j k
зум	z u m
душкало	d u ʃ k a ɫ ɔ
протекционистка	p r ɔ t e k t͡s i j ɔ n i s t k a
нередуциран	n e ɾ e d u t͡s i ɾ a n
преживан	p r e ʒ i v a n
пивнува	p i v n u v a
додоманец	d ɔ d ɔ m a n e t͡s
пролетер	p r ɔ l e t e r
јазолен	j a z ɔ l e n
лусачанец	ɫ u s a t͡ʃ a n e t͡s
мизерен	m i z e ɾ e n
релаксирање	r e ɫ a k s i ɾ a ɲ e
пропржен	p r ɔ p r̩ ʒ e n
чуки	t͡ʃ u k i
багажници	b a ɡ a ʒ n i t͡s i
букурештанка	b u k u r e ʃ t a ŋ k a
чорапиште	t͡ʃ ɔ r a p i ʃ t e
пиратство	p i ɾ a t s t v ɔ
срами	s r a m i
надваси	n a d v a s i
демонтира	d e m ɔ n t i ɾ a
судбоносен	s u d b ɔ n ɔ s e n
тракторист	t r a k t ɔ r i s t
кувајќанка	k u v a j c a ŋ k a
огон	ɔ ɡ ɔ n
наебува	n a e b u v a
видрин	v i d r i n
постоперативен	p ɔ s t ɔ p e ɾ a t i v e n
скројување	s k r ɔ j u v a ɲ e
пржелика	p r̩ ʒ e l i k a
овенување	ɔ v e n u v a ɲ e
прекласифицира	p r e k ɫ a s i f i t͡s i ɾ a
сезнаечки	s e z n a e t͡ʃ k i
незабранет	n e z a b r a n e t
шверцува	ʃ v e r t͡s u v a
сонародник	s ɔ n a ɾ ɔ d n i k
доистребуван	d ɔ i s t r e b u v a n
пресостави	p r e s ɔ s t a v i
топи	t ɔ p i
аври	a v r i
часовниче	t͡ʃ a s ɔ v n i t͡ʃ e
кркнува	k r̩ k n u v a
потиснување	p ɔ t i s n u v a ɲ e
непокорност	n e p ɔ k ɔ r n ɔ s t
импонирање	i m p ɔ n i ɾ a ɲ e
локализира	ɫ ɔ k a l i z i ɾ a
смали	s m a l i
неоткривање	n e ɔ t k r i v a ɲ e
далечност	d a l e t͡ʃ n ɔ s t
навремен	n a v r e m e n
наведне	n a v e d n e
богомил	b ɔ ɡ ɔ m i ɫ
фонетика	f ɔ n e t i k a
малаја	m a ɫ a j a
колосален	k ɔ ɫ ɔ s a l e n
олабавен	ɔ ɫ a b a v e n
професориште	p r ɔ f e s ɔ ɾ i ʃ t e
однародува	ɔ d n a r ɔ d u v a
тубичка	t u b i t͡ʃ k a
доспреми	d ɔ s p r e m i
фрустрира	f r u s t r i ɾ a
отпадне	ɔ t p a d n e
полноглавци	p ɔ ɫ n ɔ ɡ ɫ a f t͡s i
дијалошки	d i j a ɫ ɔ ʃ k i
апелирање	a p e l i ɾ a ɲ e
столарница	s t ɔ ɫ a r n i t͡s a
азили	a z i l i
апартманче	a p a r t m a n t͡ʃ e
нејавнат	n e j a v n a t
декоративен	d e k ɔ ɾ a t i v e n
дуалистка	d u a l i s t k a
напудрен	n a p u d r e n
манијачен	m a n i j a t͡ʃ e n
потсоблече	p ɔ t s ɔ b l e t͡ʃ e
незаверен	n e z a v e ɾ e n
источкан	i s t ɔ t͡ʃ k a n
непошумен	n e p ɔ ʃ u m e n
сметачки	s m e t a t͡ʃ k i
радикализам	r a d i k a l i z a m
соблазни	s ɔ b ɫ a z n i
матурирање	m a t u r i ɾ a ɲ e
рашмркан	r a ʃ m r̩ k a n
лепеза	l e p e z a
геронтолошки	ɡ e ɾ ɔ n t ɔ ɫ ɔ ʃ k i
одбутнува	ɔ d b u t n u v a
муслиман	m u s l i m a n
муабетче	m u a b e t t͡ʃ e
неменлив	n e m e n l i f
канаѓанка	k a n a ɟ a ŋ k a
пристаништа	p r i s t a n i ʃ t a
јавувајќи	j a v u v a j c i
