رائےدہندگان	ɽ a: ɪ d ə ɦ ə n d ɡ a: n
ارادہ	ʔ ɪ ɽ a: d ə
جدیدترین	d͡ʒ a d iː d t a r iː n
دکن	d ʊ k n
رامو	ɽ a: m ʊ
موٹر	m oː ʈ ɽ
دیویندر	d eː ʋ iː n d ɽ
واریرس	ʋ aː ɽ iː ɽ s
اٹارنی	a: ʈ a: r n iː
بہت	b ə ɦ ʊ t
اتوار	ɪ t ʋ a: ɽ
مٹانا	m ɪ ʈ a: n a:
منہ	m ʊ ɦ
تھم	t ɦ ə m
بااثر	b a: ʔ s ɛ ɽ
سازش	s a: z ɪ ʃ
شماری	ʃ ʊ m a: ɽ iː
چھال	t͡ʃʰ a: l
خسارہ	x ɪ s a: ɽ a: ɦ
انعام	ɪ n a aː m
مشروب	m a ʃ r uː b
خطا	x ə t a:
ارب	ə ɽ ə b
قومیت	q ɔː m ɪ j j ə t
غیرمستحکم	ɣ ɪ r m ʊ s t ɦ a k a m
نرمان	n ɪ ɽ m a: n
ابھشیک	ə bʰ ɪ ʂ eː k
رجوران	r ə d͡ʒ ʊ r a: n
ڈیسک	ɖ iː s k
سلاح	s ɪ l a:
رنگولی	ɽ ə ŋ ɡ oː l iː
سلجوق	s ə l d͡ʒ uː q
جوا	d͡ʒ ʊ a:
ذ	z
آکاش	a: k a: ʃ
جشن	d͡ʒ ə ʃ ə n
ہیکہ	ɦ eː k ɦ
ہمسفر	ɦ ə m s ə f ə ɽ
تہجی	t ə ɦ ə d͡ʒʰ iː
حقارت	ɦ ʊ q a: ɽ ə t
جنم	d͡ʒ ə n m
بادل	b a: d ə l
دھرنہ	dʰ ʊ r n a
مسئلہ	m ə s l a:
پہ	p eː
خاموش	x a: m oː ʃ
اسٹائسٹکس	ɪ s ʈ a: ɪ s ʈ k s
یکجا	j ə k d͡ʒ aː
ایشیا	a: ɪ ʃ iː a:
بالے	b a: l eː
کھانا	kʰ a: n a:
فلورنگ	f l ɔː r n ɪ ŋ
گرنا	ɡ ɪ ɽ n a:
فلاحی	f l a: ɦ iː
پریدا	p ə r iː d a:
تمھیں	t ʊ m e:
مکواوگر	m a k ʋ a: ʋ ɡ ə ɽ
سکو	s k uː
گانا	ɡ a: n a:
دعوہ	d ʊ ʔ a:
سفر	s ə f ə ɽ
رویئہ	ɽ ə ʋ ə i a:
گود	ɡ uː d
لوتھ	l oː tʰ
استفسار	a s t a f s aː r
واجبی	ʋ aː d͡ʒ b iː
میزان	m iː z a: n
نافذ	n a: f ɪ z
پار	p a: ɽ
اودبلاؤ	uː d b ɪ l a: oː
مودی	m uː d iː
باشندہ	b a: ʃ ɪ n d a:
راجو	ɽ a: d͡ʒ oː
گرجا	ɡ ɪ ɽ d͡ʒ a:
القرآن	a l q ʊ r aː n
بھروسہ	bʰ ə ɽ oː s a:
جامعہ	d͡ʒ a: m ɪ ʔ a:
کسی	k ə s iː
ٹریژری	ʈ r iː ʒ ɛ r iː
ٹانگ	ʈ a: ŋ ɡ
تحدید	t ə ɦ d iː d
خاصا	x a: s a:
رمضان	ɽ ə m z a: n
محمد	m ʊ ɦ ə m m ə d
پالیسی	p a: l iː s iː
کارگزاری	k a: r ɡ ʊ z a: r iː
آلنگن	a: l ɪ ŋ ɡ ə n
سمیع	s ə m iː a
سنگھ	s ɪ ŋ ɡʰ
اردو	ʊ ɽ d uː
یت	ɪ j ə t
ندیو	n ə d ɪ j oː
ریمارک	r eɪ m a: r k
پرکاش	p ɽ ə k a: ʃ
سیاست	s ɪ j a: s ə t
رکشا	ɽ ə k ʂ a:
باقاعدہ	b a: q a: ɪ d a:
گروداس	ɡ ə r uː d a: s
چال	t͡ʃ a: l
جاہی	d͡ʒ a: ɦ iː
صفرواں	s ɪ f ə ɽ ʋ a:
برادرنسبتی	b ɽ a: d ə r n ɪ s b ə t iː
رسالہ	ɽ ɪ s a: l a:
رب	ɽ ə b
بشرط	b ə ʃ ɽ ʈ
ملازم	m ʊ l a: z ə m
اختیارکردہ	ə x t iː j aː ɽ k ə ɽ d ə ɦ
مرد	m ə ɽ d
کھاگ	kʰ a: ɡ
غنڈہ	ɣ ʊ n ɖ a:
دیواکر	d iː ʋ a: k ə ɽ
شرائط	ʃ ʊ r a: ɪ ʈ
ویژن	ʋ iː ʒ ə n
ربوہ	ɽ ə b ʋ a: ɦ
سداسیوپیٹ	s ʊ d a: s j oː p iː ʈ
ریکٹر	ɽ eː k t ɽ
ماک	m a: k
داردر	d a: ɽ ɪ d ɽ
پہلا	p ə ɦ l a:
بنوکلب	b ə n oː k l a b
شائنی	ʃ a: ɪ n iː
راجا	ɽ a: d͡ʒ a:
ارغوانی	ə ɽ ɣ ʋ a: n iː
درس	d ə r s
کتراپی	k ʊ t ɽ a: p iː
بیدر	b iː d r
ڈھيٹھ	ɖʰ iː ʈʰ
سترویں	s t ɽ oː ʋ eː n
بھونگیر	bʰ ʊ ŋ ɡ iː r
شریک	ʃ a r iː k
ابوغریب	a: b ʊ ɣ ɽ iː b
ڈیفنس	ɖ iː f n ɪ s
رسٹورنٹس	ɽ ə s ʈ ɔː ɽ ə n ʈ s
خنجر	x ə n d͡ʒ ə ɽ
آبسٹیٹرکس	a: b s ʈ iː ʈ ɪ ɽ k s
انت	ə n t
ترپاٹھی	t ə ɽ p a: tʰ iː
دستبردار	d ʊ s t b ɛ r d a: r
جگر	d͡ʒ ə ɡ ə r
جانی	d͡ʒ a: n iː
آزمودہ	a: z m uː d ə
پیلاگو	p iː l aː ɡ oː
روٹس	r ɔː ʈ s
چوڑائی	t͡ʃ ɔː ɽ a: iː
پولیت	p oː l iː t
شروع	ʃ ʊ ɽ uː a
ڈگیس	ɖ ɪ ɡ iː s
ورزش	ʋ ə ɽ z ɪ ʃ
پینل	p eː n l
فٹچ	f t͡ʃ
پارٹنرشپ	p a: r t n ɛ r ʃ ɪ p
پیغام	p eː ɡ a: m
پستہ	p ɪ s t a:
فتنہ	f ə t n ə
مسافر	m ʊ s a: f ɪ ɽ
خوراک	x ʊ ɽ a: k
گودھرا	ɡ oː dʰ ɽ aː
سختی	s a x t iː
چابھی	t͡ʃ a: bʰ iː
قلندر	q ə l ə n d ə ɽ
کوہیر	k oː ɦ iː ɽ
آبادی	a: b a: d iː
اکرام	a: k r a: m
اودا	uː d a:
عابد	ʔ a: b ɪ d
پریم	p ɽ eː m
جمیعتہ	d͡ʒ ʊ m iː a a: t a:
غیرضروری	ɣ eː ɽ z ə ɽ uː ɽ iː
ڈر	ɖ ə ɽ
پڑھ	p ɽʰ
ایرانی	iː ɽ a: n iː
چاہت	t͡ʃ a: ɦ ə t
ایشیائی	a: iː ʃ iː a: iː
مانچسٹر	m a: t͡ʃ ə s ʈ ə ɽ
پرابین	p ə ɽ aː b iː n
انگلانگ	ɪ ŋ ɡ l a: ŋ ɡ
بہار	b ə ɦ a: ɽ
کارنامہ	k aː r n aː m ə
نثار	n ɪ s a: r
بہشت	b ɪ ɦ ɪ ʃ t
نتجہ	n ə t d͡ʒ ə ɦ
لاشعوری	l a: ʃ eː ʋ oː ɽ iː
ڈمرو	ɖ ə m ɽ uː
ملکہ	m ə l ɪ k a:
شہد	ʃ ə ɦ d
کمیشن	k a m iː ʃ a n
سہمانا	s ə ɦ m a: n a:
وسلم	ʋ ʊ s l ʊ m
عکس	a k s
مند	m ʊ n d
ندی	n ə d iː
مہیندرا	m ə ɦ iː n d r a:
ققنس	q ə q n ʊ s
افتتاح	ə f t t a: ɦ
بنجر	b ʊ n d͡ʒ ɛ r
مینار	m iː n aː r
النکرت	ə l ə ŋ k ɽ ɪ t
پنا	p ə n n a:
روپوش	r uː p oː ʃ
کڑپہ	k a r p a
شاہی	ʃ a: ɦ iː
شائق	ʃ a: ɪ q
فرانس	f ɽ a: n s
سوادو	s ʋ a: d uː
تکنیکی	t a k n iː k iː
تڑت	t ə ɽ ɪ t
ایرانڈیا	a iː r aː n d iː aː
فعالیت	f a a: l iː t
تدبیر	t ə d b iː ɽ
نتائج	n ɪ t aː ɪ d͡ʒ
ٹیکسی	ʈ iː k s iː
مباحثہ	m ʊ b aː ɦ a tʰ a
مناسبت	m ə n aː s b ə t
خودکش	x ʊ d k ʊ ʃ
پجاری	p ʊ d͡ʒ a: r iː
روپیا	ɽ uː p iː a:
خصوص	x ʊ s uː s
افق	a: f ə q
عمر	a m r
عجائب	ə d͡ʒ a: ɪ b
تیسری	t eː s r iː
پشاور	p e ʃ a: ʋ ə ɽ
اردن	a: r d ə n
جٹا	d͡ʒ ə ʈ a:
ژالہ	ʒ a: l ə
لمپٹ	l ə m p ə ʈ
موسم	m ɔː s ə m
پیشاب	p eː ʃ a: b
میاتھمیٹکس	m j a: tʰ m iː ʈ ɪ k s
تھیلا	tʰ iː l a:
بینچ	b iː n t͡ʃ
وظیفدار	ʋ ʊ z iː f d a: ɽ
سموسہ	s ə m oː s a:
دلیری	d ə l iː ɽ iː
لیبرمن	l iː b ə r m ə n
ٹرینس	ʈ ɽ eː n s
پرتبھا	p ə r t ʊ bʰ a:
بدلوانا	b ə d ə l ʋ a: n a:
معمولی	m ʊ ʔ m ʊ l iː
تاپنا	t a: p n a:
زخم	z ə x m
ایماندار	iː m a: n d a: ɽ
سلامی	s ə l aː m iː
پجرنا	p ə d͡ʒ ɽ n a:
یورانیم	j ʊ ɽ aː n iː m
وانچو	ʋ a: n t͡ʃ oː
پورکر	p u: r k ə r
گجنی	ɡ ʊ d͡ʒ n iː
ہاں	ɦ a:
بستی	b ə s t iː
مہلوک	m ə ɦ l oː k
پرفل	p ə ɽ f l
عبری	ɪ b ɽ iː
کاٹ	k a: ʈ
انٹرنیشنل	ɪ n ʈ ə r n iː ʃ ə n ə l
پرنسپل	p ə ɽ n s p ə l
لیگ	l iː ɡ
قابض	q a: b ɪ z
بادشاہت	b a: d ʃ a: ɦ ə t
مئی	m eː ɪ
حالانکہ	ɦ a: l a: k iː
آسان	a: s a: n
فورا	f ɔː ɽ ə n
آسمانی	a: s m a: n iː
دیکشت	d iː k ʃ t
کشتی	k ə ʃ t iː
لاکھ	l a: kʰ
نور	n ʊ r
ایتھنز	iː tʰ ə n z
طوطی	ʈ ɔː ʈ iː
بھارت	bʰ a: ɽ ə t
ڈسمبر	ɖ ə s m b ə ɽ
لڑکی	l ə ɽ k iː
ہوٹل	ɦ oː ʈ ə l
کنگارو	k ə ŋ ɡ a: ɽ uː
کھانی	kʰ a: n iː
جڑ	d͡ʒ ə ɽ
آگ	aː ɡ
حجام	ɦ ə d͡ʒ d͡ʒ a: m
پرندہ	p ə ɽ ɪ n d a:
اطباء	ɪ t ɪ b a: a:
بوتھا	b oː tʰ a:
مالیت	m a: l iː t
کوبائلوبہ	k ʋ ʊ b a: iː l ʋ ʊ b a:
گز	ɡ ʊ z
جوس	d͡ʒ oʊ s
تال	t a: l
وسنت	ʋ ʊ s n a t
نمائند	n ʊ m aː ɪ n d
میزبان	m eː z b a: n
فیڈنگ	f iː d ɪ ŋ ɡ
ڈاکٹر	ɖ a: k ʈ ə ɽ
بھراتا	bʰ ɽ a: t a:
مخبر	m ʊ x b ɪ ɽ
مسلح	m ʊ s l ɛ ɦ
عنب	ɪ n eː b
کشیدہ	k a ʃ iː d a:
کروانا	k ə ɽ ʋ a: n a:
نصیب	n ə s iː b
باربروسہ	b a: r b ə r oː s ə
گے	ɡ eː
مسجد	m ə s d͡ʒ ɪ d
شجرکاری	ʃ ʊ d͡ʒ r k a: r iː
کلکٹر	k ʊ l k ʈ ɛ ɽ
کھیلنا	kʰ eː l n a:
کالجس	k a: l d͡ʒ ə s
کھجور	kʰ ə d͡ʒ uː ɽ
سری	s ɽ iː
اوباما	ɔː b a: m a:
کیول	k eː ʋ ə l
جھوٹ	d͡ʒ ʱ uː ʈ
گزشتہ	ɡ ʊ z ʃ t ɦ
ناظرہ	n a: z ɪ ɽ ə
چوبے	t͡ʃ oː b eː
ادھنا	ə dʰ ʊ n a:
دینا	d eː n a:
آکسیجن	a: k s iː d͡ʒ ə n
اشتراکیت	ɪ ʃ t e ɽ a: k ɪ j ə t
غم	ɣ ə m
جیش	d͡ʒ æː ʃ
سیما	s iː m a:
پرجا	p ɛ ɽ d͡ʒ a:
شراب	ʃ ə ɽ a: b
رنگاریڈی	ɽ ə ŋ ɡ a: ɽ iː d iː
ش	ʃ
عوامی	a ʋ aː m iː
سلیکٹر	s ʊ l iː k ʈ ɛ ɽ
کرکٹرس	k ɪ r k ɪ t ɽ ʊ s
بادامی	b a: d a: m iː
انڈیوگونزیلویس	a n ɖ iː ʋ a ɡ a n z iː l a ʋ iː s
دعائے	d̪ʊ a: ɪ eː
لیکچرر	l iː k t͡ʃ ə ɽ ɽ
سونا	s uː n a:
فارسی	f a: ɽ s iː
اولا	oː l a:
برسر	b ə r s ə r
نبردآزما	n ə b ɽ d a: z m a:
کمپیوٹر	k a m p j uː ʈ ə ɽ
حافظ	ɦ a: f ɪ z
فیریرو	f eɪ r iː r oʊ
رد	ɽ ə d d
چاٹ	t͡ʃ a: ʈ
مصارف	m ʊ s a: ɽ ɪ f
لرزاں	l ə ɽ z a:
کورٹ	k ɔː r ʈ
تحقیقی	t ə ɦ ə q iː q iː
سؤر	s uː ə ɽ
نصاریٰ	n ə s a: ɽ a:
ڈوگر	ɖ oː ɡ ɛː ɽ
ریاستہا	ɽ ɪ j a: s ə t ɦ a:
میٹرس	m eː t ə r s
سنگین	s ʊ ŋ ɡ iː n
پرسوں	p ə ɽ s o:
ہندوستان	ɦ ɪ n d ʊ s t a: n
دلی	d ɪ l iː
تھکا	tʰ ə k a:
گلال	ɡ ʊ l a: l
گرجنا	ɡ ə ɽ ə d͡ʒ n a:
کیمیا	k iː m ɪ j a:
قلعہ	q ɪ l a:
آرڈر	a: ɽ ʈ ɽ
اسوسی	ɪ s ʊ s iː
یونیورسٹی	j uː n iː ʋ a r s ʈ iː
بنجارا	b ə n d͡ʒ a: ɽ a:
دفنانا	d ə f n a: n a:
اختتام۔پزیر	a: x t t a: m p ə z iː ɽ
تیاگ	t j a: ɡ
گرمکھی	ɡ ʊ ɽ m ʊ kʰ iː
گین	ɡ eː n
میٹابولائز	m eː ʈ a: b oː l aː ɪ z
الجھن	ʔ ə l d͡ʒ ʱ ʊ n
عام	a: m
کمبلے	k ə m b l eː
کاشف	k a: ʃ f
تنازعہ	t ə n a: z a ɦ
آزادی	a: z a: d iː
کونکنی	k uː n k n iː
سنور	s ɪ n ʋ ɔː ɽ
سرمئی	s ʊ ɽ m ə iː , s ə ɽ m ə iː
کارڈ	k a: ɽ d
سپلی	s ə p l iː
رائے	ɽ a: j
عطر	ʔ ɪ t ɽ
سنگاپور	s ɪ ŋ ɡ a: p uː ɽ
بند	b ə n d
شام	ʃ a: m
فلک	f ə l ə k
بشکل	b ʊ ʃ k ə l
دباؤ	d ə b a: oː
چھاڑ	t͡ʃʰ a: ɽ
ڈسٹرکٹ	ɖ ɪ s ʈ r ɪ k ʈ
ارجنٹائن	ə ɽ d͡ʒ ə n ʈ a: iː n
نتیجتا	n ə t iː d͡ʒ ə t ə n
گردی	ɡ ʊ r d iː
ایل	a: ɪ l
بورن	b ɔː ɽ n
دھول	dʰ uː l
سڑک	s ə ɽ ə k
ایمان	iː m a: n
آسرا	a: s ɽ a:
چوٹ	t͡ʃ oː ʈ
وصولی	ʋ ʊ s uː l iː
ہے	ɦ ɛː
طوفان	t uː f a: n
سونگھ	s uː ŋ ɦ
نالے	n a: l eː
گھرانا	ɡʰ ə ɽ a: n a:
جیوتی	d͡ʒ j oː t iː
کھیل	kʰ eː l
ماریشیس	m a: r iː ʃ iː s
مستحکم	m ʊ s t a ɦ k a m
جاسوس	d͡ʒ a: s uː s
جرأت	d͡ʒ ʊ ɽ ɽ ə t
اکانٹس	ə k a: n ʈ s
جرثومہ	d͡ʒ ʊ ɽ s uː m a:
دھیریہ	dʰ ɛː ɽ j
بابرہ	b a: b ɽ a:
تازہ	t a: z a:
پڑھنا	p ə ɽʰ n a:
اخبار	ə x b a: ɽ
مباین	m ʊ b a: j n
ڈابسن	ɖ a: b s ə n
بچپن	b ə t͡ʃ p ə n
انجام	ə n d͡ʒ a: m
نظرانداز	n ʊ z ɽ a: n d a: z
مقبوض	m ə q b uː z
کرشمہ	k ə ɽ ɪ ʃ m a:
مراکیش	m ɽ a: k ɛː ʃ
راکھ	ɽ a: kʰ
تاناشاہی	t a: n a: ʃ a: ɦ iː
سائمن	s a: ɪ m ʊ n
احتمال	eː ɦ t eː m a: l
ئن	ʔ ɪ n
جائپھل	d͡ʒ a: ɪ pʰ ə l
قبض	q ə b ə z
غیر	ɣ ɛː ɽ
مے	m ɛː
اناج	a: n a: d͡ʒ
خون	x uː n
اپنيتر	ʊ p n eː t ɽ
ہماہمی	ɦ ə m a: ɦ ə m iː
پوٹےشیم	p oʊ ʈ eɪ ʃ iː m
مجھ	m ʊ d͡ʒʰ
فریقی	f ə r iː q iː
انحراف	ɪ n ɦ ɪ r a: f
بہن	bʰ ɛː n
نسل	n ə s l
پستان	p ɪ s t a: n
علامہ	a ə l aː m ə
الاسد	ə l a: s d
انگور	ə n ɡ uː ɽ
آیئنا	a: iː ə n ə
بہاؤالدین	b ə ɦ a: ʔ ʊ d d iː n
حکمرانی	ɦ ʊ k ʊ m ɽ a: n iː
تگنا	t ɪ ɡ n a:
بوریت	b oː ɽ ɪ j ə t
متواتر	m ʊ t ʋ a: t ɽ
جیبھ	d͡ʒ iː bʰ
ذات	z a: t
چاہیئے	t͡ʃ a: ɦ iː ɛ
ادی	ə d j
بلین	b ɛː l iː n
زنانی	z ʊ n a: n iː
کنٹیشور	k a n ʈ iː ʃ ɔː r
طلبہ	ʈ ə l b ə ɦ
دیکھنا	d eː kʰ n a:
اندر	ɪ n d ə ɽ
نيت	n iː t
سبقت	s ʊ b q ʊ t
جھوٹی	d͡ʒ ʱ uː ʈ iː
لاہور	l ə ɦ oː ɽ
کارخانہ	k a: r x a: n ə
منصور	m ə n s ʊ ɽ
تار	t a: ɽ
سنجیدہ	s ʊ n d͡ʒ iː d a
اسرائیل	ɪ s ɽ a: iː l
اچاریہ	ə t͡ʃ a: ɽ iː ə
پرول	p ə ɽ ʋ ə l
مزدور	m ʊ z d ʊ r
پڑ	p ɽ
ابٹن	ʊ b ʈ ə n
سلجھ	s ʊ l d͡ʒ ɦ
پورہ	p uː r a:
آفت	a: f ə t
پھول	pʰ uː l
کوچس	k oː t͡ʃ ə s
لوبیا	l oː b ɪ j a:
پردیب	p ə ɽ d iː b
جمہوریت	d͡ʒ ə m ɦ uː ɽ ɪ j ə t
قدر	q a d r
لنگ	l ɪ ŋ ɡ
پریسیڈنٹ	p ɽ eː s iː ɖ ə n ʈ
دیانتداری	d iː aː n ə t d aː r iː
ینگ	j ɪ ŋ
پیٹ	p eː ʈ
کاویہ	k a: ʋ j ə
ساڑی	s a: ɽ iː
لاپرواہی	l a: p ɽ ʋ a: ɦ iː
تئیں	t ɛː ɪ n
متجاوز	m ʊ t d͡ʒ a: ʋ ə z
لسانیات	l ɪ s a: n ɪ j a: t
حامدالاحمر	ɦ a: m ɪ d ʔ a: l a: ɦ m ɛː ɽ
حملہ	ɦ ə m l a:
میٹنگ	m iː ʈ ɪ ŋ ɡ
سہولت	s ʊ ɦ ʊ l t
احسان	ə ɦ ə s a: n
شیطان	ʃ eː t a: n
فولک	f oː l k
مایاوتی	m aː j aː ʋ ə t iː
ظہیرآباد	z ə ɦ iː ɽ aː b aː d
پلانڈو	p ə l a: n ɖ uː
یوگانڈا	j ʊ ɡ a: n ʈ a:
غرناطہ	ɣ ə ɽ n a: t a: ɦ
بھگوان	bʰ ə ɡ ʋ a: n
حصول	ɦ ʊ s uː l
شرینگر	ʃ ɽ iː n ə ɡ ə ɽ
دوگنا	d oː ɡ ʊ n a:
فٹنس	f ɪ t n ə s
چراغاں	t͡ʃ ɽ a: ɣ a:
دانیال	d a: n iː a: l
زبیر	z ʊ b eː ɽ
فرار	f a r aː r
تولہ	t u: l a:
نام	n a: m
امرود	ə m ɽ uː d
ترجیح	t ə ɽ d͡ʒ iː ɦ
الزہرہ	a l z ə ɦ r ə
پاکستانی	p a: k ɪ s t a: n iː
انتظار	ɪ n t ɪ z a: ɽ
توقع	t ʋ oː q a
کاڑھا	k a: ɽʰ a:
دھاندل	dʰ a: n d ə l
موجودہ	m oː d͡ʒ uː d a:
تولیے	t ɔː l ɪ j eː
تحصیل	t ɦ ʊ s iː l
ابلاغ	ə b l a: ɣ
پیاس	p j a: s
تئن	t ɛː n
شعر	ʃ eː ɽ
محفوظ	m ʊ ɦ f oː z
پلانٹ	p l a: n ʈ
بجائے	b ʊ d͡ʒ aː ɪ ə
آٹو	a: ʈ oʊ
غور	ɣ ʊ ɽ
گڑیا	ɡ ʊ ɽ ɪ j a:
چودنا	t͡ʃ oː d n a:
انہ	a: n a:
دوران	d ʊ ɽ a: n
نخرا	n ə x ɽ a:
کامتھ	k a: m tʰ
دخل	d ə x ə l
بیزار	b eɪ z a: r
طورپر	t ʊ ɽ p ʊ ɽ
تكميل	t ə k m iː l
ذلیل	z ə l iː l
وہ	ʋ oː
آدھنک	a: dʰ ʊ n ɪ k
عقبہ	a ɪ q b a:
کوی۶	k oː ɪ a 6
ضرور	z ə ɽ uː ɽ
بھاجن	bʰ a: d͡ʒ ə n
خلل	x ʊ l l
خلق	x ə l q
بلی	b ə l iː
خصوصا	x ʊ s uː s ə n
ب	b
چھونا	t͡ʃʰ uː n a:
کھجلی	kʰ ʊ d͡ʒ l iː
تاشقند	t a: ʃ q ə n d
ہاتھی	ɦ a: tʰ iː
اصول	ʊ s uː l
انہدامی	ʔ ʊ n ɦ d a: m iː
اترنا	ʊ t ə ɽ n a:
کمپٹرولر	k a m p j uː t ə ɽ oʊ l ə ɽ
استنبول	ɪ s t ə m b oː l
کشادہ	k ə ʃ aː d ə
دھونا	dʰ uː n a:
ویراٹ	ʋ ɪ r a: t
سوالیہ	s uː aː l iː ə
کمائی	k ə m a: iː
باولی	b aː oː l iː
ویاکرن	ʋ j a: k ə ɽ ə n
چائے	t͡ʃ aɪ ə
ہائی۔ٹیکس	ɦ aɪ t ɛ k s
ارسطو	ə ɽ ə s t uː
حسین	ɦ ʊ s eɪ n
پھسل	pʰ a s l
عجوبہ	ə d͡ʒ uː b a:
جیت	d͡ʒ iː t
بغیر	b ɪ ɣ ɛː r
یہود	j ə ɦ uː d
خواتین	x ə ʋ a: t iː n
آمیز	a: m iː z
مسوری	m ʊ s ʋ ʊ r iː
پنکھڑی	p ə ŋ kʰ ʊ ɽ iː
کیابس	k j a: b s
سہل	s ə ɦ l
بہکا	b ə ɦ k a:
ویریا	ʋ iː r iː a:
کٹرپسند	k ʈ ə ɽ p s ʊ n d
چلانا	t͡ʃ ɪ l l a: n a:
اوسطا	ɔː s t ə n
ڈکار	ɖ ə k a: ɽ
صلیب	s ə l iː b
اقتصادی	ɪ q t ɪ s a: d iː
اسٹال	ɪ s ʈ aː l
ٹرافک	ʈ r a: f ɪ k
چار	t͡ʃ a: ɽ
جن	d͡ʒ ɪ n n
بھوت	bʰ uː t
چنگال	t͡ʃ ə ŋ ɡ a: l
آئندہ	a: ɪ n d ə
ایسی	aɪ s iː
طاقت	ʈ a: q ə t
شیر	ʃ iː ɽ
شے۶	ʃ eː t͡ʃʰ ʰ
اودھاؤ	ɔː dʰ a: ʊ
اخراجات	a: x r a: d͡ʒ a: t
اودھی	ə ʋ ə dʰ iː
آخرت	a: x ɪ ɽ ə t
چتا	t͡ʃ ʊ t a:
راجیش	ɽ a: d͡ʒ iː ʃ
پٹرولیم	p a t ɽ oː l iː m
عیسائی	a iː s a: ʔ iː
بدر	b ə d ə ɽ
سج	s ə d͡ʒ
پھاڑ	pʰ a: ɽ
عوام	ə ʋ a: m
بیک	b eː k
مخاطب	m ʊ x a: t ɪ b
وصال	ʋ ɪ s a: l
چاقو	t͡ʃ a: q uː
پردہ	p a r d a:
لکیج	l ə k iː d͡ʒ
حمیدالدین	ɦ ʊ m iː d a l d iː n
بجٹ	b ə d͡ʒ ʈ
انفوٹی	ɪ n f oʊ ʈ iː
ممنوعہ	m ə m n oː a ə ɦ
گگن	ɡ ə ɡ ə n
چوتھا	t͡ʃ ɔː tʰ a:
بےحیائی	b eː ɦ j a: iː
قیمہ	q iː m a:
لہنگا	l ɛː ɦ ɛː ŋ ɡ a:
پولیو	p oː l iː oː
نند	n ə n d
ڈیوڈ	ɖ iː oʊ ɖ
گنیش	ɡ ə n eː ʃ
پیٹرسن	p eː ʈ ə ɽ s ə n
پارلیمنٹ	p aː ɽ l iː m ə n ʈ
پان	p a: n
آلسی	a: l s iː
سرگرم	s ə ɽ ɡ ə ɽ m
خوشی	x ʊ ʃ iː
جلسہ	d͡ʒ ə l s a ɦ
پپاسا	p ɪ p a: s a:
آندھرائی	a: n dʰ ə r a: iː
کوتا	k ə ʋ ɪ t a:
اللہ	ə l l a: ɦ
ہمنوائی	ɦ ə m ‿ n ə ʋ a: iː
منسٹرس	m ə n s t ə r s
ڈگر	ɖ ə ɡ ə ɽ
انوکھا	ə n oː kʰ a:
بحیثیت	b ɦ ɪ s iː t
ارجت	ə ɽ d͡ʒ ɪ t
چلچتر	t͡ʃ ə l t͡ʃ ɪ t ɽ ə
چولھا	t͡ʃ uː l ɦ a:
بالخصوص	b a: l x a s ʊ s
کو	k oː
مفتاحی	m uː f t aː ɦ iː
میں	m e:
چرخہ	t͡ʃ ə ɽ x a:
اشارہ	ɪ ʃ a: ɽ a:
جنوری	d͡ʒ a n uː r iː
الطاف	a l t a: f
د	d
بتایاکہ	b ɪ t a: j a: k ɛː
حیات	ɦ ə j a: t
دل	d ɪ l
خواہ	x a: ɦ
کیڑا	k iː ɽ a:
اداشدہ	ʔ ə d a: ʃ ʊ d ə
نر	n ə ɽ
نہ	n a:
النظر	ʔ ʊ l n ʊ z ɽ
طبقات	ʈ a: b q a: t
بیلاروس	b eː l a: ɽ uː s
بنزین	b ə n z iː n
کاج	k a: d͡ʒ
مسقط	m ə s q ə t
گائے	ɡ a: eː
بہیمانہ	b ə ɦ iː m aː n ə
ونڈے	ʋ ʊ n ʈ eː
ریشی	r eː ʃ iː
یقینا	j ə q iː n ə n
باہوبلی	b a: ɦ ʊ b ə l iː
گیڈ	ɡ eː ɖ
چھت	t͡ʃʰ ə t
چوتھائی	t͡ʃ ɔː tʰ a: iː
وغیرہ	ʋ ə ɣ ɛː r ə
مدیرا	m ə d iː ɽ a:
فرمائش	f ə ɽ m a: ɪ ʃ
کوئ	k ʊ ɪ
بلکہ	b ə l k iː
باہری	b a: ɦ ɪ r iː
لہرانا	l ɛ ɦ ɽ a: n a:
عنقریب	a ɪ n q ə r iː b
چیارٹیبل	t͡ʃ iː a: ɽ ʈ iː b ʊ l
کهان	kʰ a: n
انٹرملان	ɪ n ʈ ə ɽ m ə l a: n
تلبیہ	t ə l b iː ə
مذہب	m ə z ɦ ə b
ٹکراؤ	ʈ ɪ k ɽ a: ʊ
سمکھ	s ə m m ʊ kʰ
ادھورا	ə dʰ uː ɽ a:
متوفی	m ʊ t ʋ ɔː f iː
چای	t͡ʃ a: j
پرچہ	p ə ɽ t͡ʃ ə
کتی	k ə t iː
ہنوز	ɦ ə n oː z
سنجہا	s ʊ n d͡ʒ ɦ a:
ایکسپریس	aɪ k s p ɽ iː s
ناخوش	n a: x ʊ ʃ
پلاٹس	p l a: ʈ s
روانہ	ɽ ə ʋ a: n a:
یوسی	j oʊ s iː
میراں	m iː r aː n
بیمار	b eː m a: ɽ
مورتی	m uː ɽ t iː
جانور	d͡ʒ a: n ʋ ə ɽ
ٹیچر	ʈ iː t͡ʃ ɪ ɽ
ٹھوس	ʈʰ oː s
باون	b a: ʊ n
جامن	d͡ʒ a: m ə n , d͡ʒ a: m ʊ n
اڈمیرل	ə d m iː r l
طبلہ	t ə b l ə
میتھن	m ɛː tʰ ʊ n
ساتھ	s a: tʰ
سیاستدان	s ɪ j a: s ə t d a: n
صرفہ	s ʊ ɽ f a:
تعاونی	t a a: ʋ n iː
کاروائی	k a: ɽ oː a: iː
تندور	t ə n d uː ɽ
قرآن	q ʊ ɽ ʔ a: n
ہوڑا	ɦ ʊ r a:
داخلہ	d a: x ɪ l ə
عبرانی	ɪ b ɽ a: n iː
آرٹیکل	a: r ʈ iː k ə l
سوا	s ʋ aː
اصلاح	ɪ s l a: ɦ
کوشاں	k ʊ ʃ a: n
سزا	s ə z a:
مکھ	m ʊ kʰ
شیواجی	ʃ iː ʋ a: d͡ʒ iː
نعرہ	n a: ɽ a: ɦ
قطب	q ʊ t b
کچھ	k ʊ t͡ʃʰ
عجب	a d͡ʒ a b
ادبیات	ə d b ɪ j a: t
انفراسٹرکچر	ɪ n f r a: s t ɽ ʊ k t͡ʃ ʊ ɽ
شمولیت	ʃ ʊ m oʊ l iː t
کینچلی	k e: t͡ʃ ʊ l iː
شوقین	ʃ ʊ q iː n
سراب	s ə ɽ a: b
کوششں	k oː ʃ ɪ ʃ a n
بلاکس	b l a: k s
بطخ	b ə t ə x
گمانا	ɡ ʊ m a: n a:
پٹی	p ʈ iː
جنیشور	d͡ʒ ə n iː ʃ ʊ ɽ
چڑیا	t͡ʃ ɪ ɽ ɪ j a:
بیاگ	b j aː ɡ
دمشق	d ə m ɪ ʃ q
لئے	l ɛː
لیاپس	l iː a: p s
تمہیں	t ʊ m ɦ e:
تب	t ə b
بالکل	b ɪ l k ʊ l
فالسہ	f a: l s a:
کرنا	k ə ɽ n a:
سیلسیس	s iː l s iː s
ایشین	eː ʃ iː n
زندگی	z ɪ n d ə ɡ iː
ولایت	ʋ ɪ l a: j ə t
ٹرانزیشنل	ʈ r a: n z iː ʃ a n l
ناخدا	n a: x ʊ d a:
بکھراو	b ɪ kʰ ɽ a: ʋ
کپاسی	k ə p a: s iː
فوجداری	f ʊ d͡ʒ d a: ɽ iː
ایلینا	ʔ eː l iː n a:
سوتیلا	s ɔː t eː l a:
روزگار	r oː z ɡ a: r
نومنتخب	n oː m ə n t ɪ x ə b
پاکستان	p a: k ɪ s t a: n
عبید	a ʊ b eː d
طینت	ʈ ɪ n t
گھرا	ɡʰ ɛː ɽ a:
دیپکا	d iː p ɪ k a:
غیردستوری	ɣ ɛː r d ʊ s t ʊ ɽ iː
اسکولس	ə s k uː l s
بیٹھ	b eː ʈʰ
اکٹھا	ə k ʈʰ a:
چیتاپور	t͡ʃ iː t aː p ɔː r
آواز	a: ʋ a: z
کاپٹر	k a: p ʈ ɽ
نقلی	n ə q l iː
چپل	t͡ʃ ə p ə l
راشٹرپتی	r a: ʃ t r p a t iː
بادبان	b a: d b a: n
شعار	ʃ a a: ɽ
کشیدگی	k ə ʃ iː d ɡ iː
سرحد	s ə ɽ ɦ ə d
پوت	p uː t
ہندو	ɦ ɪ n d uː
ہندوستانی	ɦ ɪ n d ʊ s t a: n iː
ٹیکساس	ʈ iː k s a: s
وار	ʋ a: ɽ
سائنس	s a: ɪ n s
بتدریج	b ə t d ɽ iː d͡ʒ
شاپر	ʃ a: p ə ɽ
دورلیکھ	d uː ɽ l eː kʰ
تلخ	t ə l ə x
کوتلماں	k oː t ʊ l m a: n
تھوکنا	tʰ uː k n a:
اندھیرا	ə n dʰ iː ɽ aː
برعکس	b ɽ a a k s
شارجہ	ʃ a: ɽ d͡ʒ a: ɦ
امن	ə m ə n
ماتحت	m aː tʰ a t
تصادم	t ə s a: d ə m
پرتگیا	p ɽ ə t ɪ ɡ j a:
اثاثہ	ɪ s a: s a:
برتر	b ɪ ɽ t ɽ
مول	m oː l
ہونا	ɦ oː n a:
آمدنی	a: m d ə n iː
گفتگو	ɡ ʊ f t ɡ oʊ
عالمی	a a: l ə m iː
یکساں	j ə k s a: n
ناکامی	n a: k a: m iː
یوسف	j uː s ə f
سبب	s ə b b
کالا	k a: l a:
خاصی	x a: s iː
پاپیا	p a: p iː a:
لدھیانہ	l ʊ dʰ ɪ j a: n a:
صحافت	s ɪ ɦ a: f ə t
ریچھ	ɽ iː t͡ʃʰ
کیئر	k iː ɛ ɽ
عمری	a ʊ m r iː
پروار	p ə ɽ ɪ ʋ a: ɽ
منی	m ə n iː
عہدہ	a ɛː d a:
بیوی	b iː ʋ iː
معلوم	m aː l uː m
کلاونت	k ə l a: ʋ ə n t
گندھاری	ɡ ʊ n d ɦ a: ɽ iː
اتفاق	ɪ t t ɪ f a: q
محل	m ɛ ɦ ɛ l
سوز	s ʊ z
وا	ʋ a:
ملک	m ʊ l k
چاۓ	t͡ʃ a: eː
سیوریج	s iː ʋ ə ɽ ɪ d͡ʒ
بے۔چین	b eː t͡ʃ eː n
مختصر	m ʊ x t ə s ɪ ɽ
کیمرہ	k ɛː m ɽ a:
آبشار	a: b ʃ a: ɽ
سیکریٹریٹ	s iː k r iː ʈ ə r iː ʈ
کالنگ	k a: l ə ŋ ɡ
خدمت	x ɪ d m ə t
ساڑھے	s aː r a
رگھوناتھ	r ʊ ɡʰ oʊ n a: tʰ
شناخت	ʃ ɪ n a: x t
چنتا	t͡ʃ ɪ n t a:
دوپہر	d uː p ɛː ɽ
سینکڑا	s ɛː ŋ k ɽ a:
ڈنکی	ɖ ə ŋ k iː
ادھار	ʊ dʰ a: ɽ
غلبہ	ɡʰ ʊ l b a:
رفتہ	r a f t ə
ثروت	s ə ɽ ʋ ə t
سفارتخانہ	s ɪ f a: ɽ ə t x a: n a:
جھانجھ	d͡ʒʰ a: d͡ʒʰ
گنبذ	ɡ ʊ m b ə z
پسماندگی	p ə s m a: n d ɡ iː
مقدار	m ɪ q d a: ɽ
جمعرات	d͡ʒ ʊ m eː ɽ a: t
کودنڈا	k ʊ d n ʊ n d a:
اندرا	ɪ n d r a:
فرمانا	f ə ɽ m a: n a:
منسٹرا	m ə n s ʈ ɽ a:
آشکارا	a: ʃ k a: ɽ a:
اشتمالیت	ɪ ʃ t e m a: l ɪ j ə t
عبدالعزیز	a ʊ b d ʊ l a ʊ z iː z
آفسیر	a: f s iː ɽ
کہاکہ	k ə ɦ a: k ə
ٹائیلس	ʈ a: ɪ l s
انھیں	ʊ n e:
گاڑی	ɡ a: ɽ iː
ایونٹ	a: j uː n ʈ
البتہ	a l b ə t a:
پرنی	p ə ɽ n iː
یونٹس	j ʊ n ɪ t s
ندیوں	n ə d ɪ j o:
بہنا	b ɛ ɦ n a:
بھنڈاری	bʰ ʊ n ʈʰ a: r iː
استری	ɪ s t ɽ iː
چور	t͡ʃ oː ɽ
آنکھ	a: kʰ
پھیلاؤ	pʰ eː l aː oː
سینا	s iː n a:
پٹل	p ə ʈ ə l
مصیبت	m ʊ s iː b ə t
صد	s ʊ d
یا	j a:
چوٹکی	t͡ʃʰ ʊ ʈ k iː
الماس	ə l m a: s
سشما	s ʊ ʃ m a:
بہاراں	b ə ɦ a: ɽ a:
رازداری	ɽ a: z d a: ɽ iː
لمبا	l ə m b a:
دھماکہ	dʰ ə m a: k a: ɦ
چین	t͡ʃ iː n
چوبیس	t͡ʃ oː b iː s
کارنی	k aː r n iː
پاستا	p a: s t a:
قدوائی	q ʊ d ʋ aː ɪ
سنہ	s ɪ ŋ ɦ
لیفٹیننٹ	l iː f ʈ iː n ə n ʈ
جامع	d͡ʒ aː m ɛː
ترجمہ	t ə ɽ d͡ʒ ʊ m a:
اولیا	a: ʋ l iː a:
اوہ	uː ɦ
ساتویں	s a: t ʋ eː n
ڈیویژنل	ɖ iː ʋ iː ʒ n l
تندرست	t ə n d ʊ ɽ ʊ s t
آگار	a: ɡ a: ɽ
ایکشن	ɛː k ʃ ə n
امیت	a m iː t
مہنگائی	m ə ɦ ə ŋ ɡ a: iː
دستاویزی	d ə s t a: ʋ iː z iː
صفائی	s ɪ f a: iː
سیکھنا	s iː kʰ n a:
دال	d a: l
غنائیت	ɣ ʊ n n a: iː j ə t
کندرا	k ə n d ə ɽ a:
گیہوں	ɡ eː ɦ u:
انجنئیر	ɪ n d͡ʒ ɪ n i: ɽ
فارمس	f a: r m s
تم	t ʊ m
خریدنا	x ə ɽ iː d n a:
الشیخ	ʔ ʊ l ʃ eː x
چارجس	t͡ʃ a: r d͡ʒ ɪ s
ٹرانسپورٹ	ʈ r a: n s p ɔː r ʈ
ساتواں	s a: t ʋ a:
لہذا	l ɪ ɦ a: z a:
مذکور	m ʊ z k ʊ r
بحر	b ə ɦ ɽ
گلبرگہ	ɡ ʊ l b ə ɽ ɡ ə
ایمباسیٹرس	ɪ m b a: s iː ʈ ʊ ɽ s
کیڈٹس	k eː ɖ ɪ t s
مولوی	m uː l oʊ ʋ iː
سید	s eː d
برکت	b ə ɽ k ə t
الم	ə l ə m
ہتھیار	ɦ ə tʰ ɪ j a: ɽ
ایذارسانیوں	a: ɪ z a: ɽ s a: n iː ʊ n
کاپوریشن	k a: p oː ɽ iː ʃ ə n
فنڈ	f ʊ n ʈ
چاندی	t͡ʃ a: d iː
بکس	b ə k s
مڈبھیڑ	m ʊ d bʰ iː ɽ
کروڈ	k ə r oː ɖ
چیرپرسن	t͡ʃ eː ɽ p ə ɽ s ə n
پڑوسی	p a: r oː s iː
شرکرا	ʃ ə ɽ k ə ɽ a:
چھٹپٹانا	t͡ʃʰ ə ʈ p ə ʈ a: n a:
بریہ	b ə ɽ j ə
امداد	ɪ m d a: d
اصغر	ɪ s ɣ ə ɽ
انتخاب	ɪ n t ɪ x a: b
نورین	n ʊ ɽ iː n
تمہارا	t ʊ m ɦ a: ɽ a:
تعزیتی	t ə a z iː t iː
بنجارہ	b ə n d͡ʒ a: ɽ a:
سرزنش	s ə ɽ z n ɪ ʃ
فیصد	f iː s ə d
حریت	ɦ ʊ r iː t
ستیا	s ʊ t iː a:
صالح	s a: l ɪ ɦ
باشاہ	b a: ʃ a: ɦ
آرزو	a: ɽ z uː
منتظم	m ʊ n t ə z ɪ m
سکنا	s ə k n a:
شین	ʃ iː n
بکم	b ʊ k m
اروکھ	aː r oː kʰ
اچت	ʊ t͡ʃ ɪ t
جمہوریہ	d͡ʒ ʊ m ɦ uː ɽ ɪ j a:
جاؤں	d͡ʒ a: ʊ
تندرستی	t ə n d ʊ ɽ ʊ s t iː
ولائتی	ʋ ɪ l a: j ə t iː
ساحلی	s a: ɦ l iː
آبی	a: b iː
کارکردگی	k a: ɽ k ə ɽ d ə ɡ iː
بہتر	b ə ɦ ə t t ə ɽ
بازو	b a: z uː
مذکر	m ʊ z ə k k ə ɽ
تہائی	t ɪ ɦ a: iː
نہایت	n ɪ ɦ a: j ə t
مت	m ə t
تروپتی	t r oʊ p t iː
مسٹرسنہا	m ɪ s ʈ ə r s n ə ɦ a:
نکسلائٹ	n ɪ k s l a: iː t
پرسار	p ə ɽ s a: ɽ
ڈگ	ɖ ə ɡ
جور	d͡ʒ ʋ ə ɽ
حرج	ɦ ʊ r d͡ʒ
کلومیٹر	k ɪ l oʊ m iː t ə ɽ
محنت	m ɪ ɦ n ə t
آئیرن	a: ɪ ɽ ə n
آدھا	a: dʰ a:
غرض	ɣ ʊ r d z
دانت	d ə n t
زیرقیادت	z i: r q iː a: d t
کیمیکل	k iː m iː k ə l
ھما	ɦ m a:
دارالقضات	d a: ɽ ʊ l q ʊ z a: t
دلربا	d ɪ l ɽ ʊ b a:
دجلہ	d ə d͡ʒ l a:
سائینس	s a: ɪ n s
ماہ	m aː ɦ
بھکت	bʰ ə k t
نظر	n ə z ə ɽ
متحدہ	m ʊ t ɦ ɛ d a:
تین	t iː n
ہانک	ɦ a: k
لٹیرا	l ʊ ʈ iː ɽ a:
داغ	d a: ɣ
گھیرنے	ɡʰ iː r n eɪ
مدینہ	m ə d iː n a:
پیام	p j a: m
سست	s ʊ s t
مکہ	m ə k ə
دشواری	d ʊ ʃ ʋ a: ɽ iː
نصرانی	n ə s ɽ a: n iː
ویٹرنری	ʋ eː ʈ ə r n ə r iː
بنفشی	b ə n ə f ʃ iː
ٹلفورڈ	ʈ ɪ l f oː ɽ ɖ
مروانا	m ə ɽ ʋ a: n a:
مقفل	m ʊ q f ʊ l
كر	k ə r
غیرانسانی	ɣ ɛː r ɪ n s a: n iː
رواداری	ɽ ʋ a: d a: ɽ iː
آزمانا	a: z m a: n a:
اول	ə ʋ ʋ ə l
بعدازاں	b aː d a: z a: n
پرجوش	p ʊ r d͡ʒ oː ʃ
سندھو	s ɪ n dʰ uː
بیورو	b j ʊ ɽ oː
وشنو	ʋ ɪ ʃ n uː
اتھان	ʊ t tʰ a: n
سپرد	s ʊ p ə r d
فادر	f a: d ə ɽ
رہنمائے	ɽ ə ɦ n ə m aː ɪ
ارتکاب	ɪ ɽ t k a: b
قوم	q ɔː m
سامل	s a: m ə l
واکیہ	ʋ a: k j
گمبھی	ɡ ə m bʰ iː
پنکھا	p ə ŋ kʰ a:
نزول	n ə z uː l
عنابی	ʊ n n a: b iː , ə n a: b iː
گیارنٹی	ɡ j a: r n ʈ iː
بادشاہ	b a: d ʃ a: ɦ
کھوکس	kʰ oː k s
انگریزی	ə ŋ ɡ ɽ eː z iː
معصوم	m a ʊ s uː m
بھوتنی	bʰ uː t ɪ n iː
دھمال	dʰ ə m m a: l
نکال	n ɪ k a: l
شرط	ʃ ə ɽ t
سمجھدار	s ə m ə d͡ʒʰ d a: ɽ
ایہود	ɪ j a: ɦ ʊ d
دانش	d a: n ɪ ʃ
کنٹرولرس	k ə n ʈ r oː l ə r s
بارہا	b a: ɽ ɦ a:
نصرت	n ʊ s ɽ ə t
آئے	a: ɪ ɛː
مدائن	m ʊ d a: ɪ n
نیلا	n iː l a:
اناہزارے	ɪ n a: ɦ z a: ɽ eː
صحیح	s ə ɦ iː
ویرنمنٹ	ʋ iː ɽ n ə m ə n t
توحیدیت	t ɔː ɦ iː d ɪ j ə t
رپورٹرس	ɽ ə p ɔː r ʈ ə r s
کمل	k ə m ə l
نکاح	n ɪ k a: ɦ
راس	ɽ aː s
آمریت	a: m ɪ ɽ ɪ j ə t
تن	t ə n
نجیب	n ə d͡ʒ iː b
اگزامنیشن	a ɡ z a: m n ɪ ʃ ə n
وامن	ʋ a: m ə n
اسٹیڈیم	ə s t iː d iː m
نہس	n ɛ ɦ s
گھڑیال	ɡʰ ə ɽ ɪ j a: l
فالحال	f ɪ l ɦ a: l
کھٹائی	kʰ ə ʈ a: iː
متاثرہ	m ʊ t a: s ɪ ɽ a:
خریدی	x ə r iː d iː
بکاؤ	b ɪ k a: uː
کفایتی	k ə f aː j t iː
جسور	d͡ʒ ə s uː ɽ
میاں	m ɪ j a:
مفتی	m ʊ f t iː
بھکتی	bʰ ə k t iː
راما	ɽ a: m a:
رہنا	ɽ ə ɦ n a:
چٹس	t͡ʃ ə ʈ s
برچھیت	b ə ɽ t͡ʃʰ ɛː t
کھاتا	kʰ a: t a:
خلفا	x ʊ l ə f a:
ایووکیڈو	ɛ j uː k iː d oʊ
دیوناگری	d eː ʋ n a: ɡ ɽ iː
چہارم	t͡ʃ ə ɦ a: ɽ ʊ m
جواہر	d͡ʒ ʋ a: ɦ ə r
پہنچنا	p ə ɦ ʊ t͡ʃ n a:
جدول	d͡ʒ ʊ d ʊ l
اسٹیون	ɪ s t iː ʋ ə n
نمائندہ	n ʊ m a: ɪ n d ə ɦ
رکھا	ɽ ʊ kʰ a:
پاؤں	p a: u:
ناگ	n a: ɡ
قباحت	q ə b a: ɦ ə t
موعود	m oː a uː d
شکتی	ʃ ə k t iː
شائد	ʃ a: ɪ d
تنازع	t ə n a: z oː ʔ
مہاجرت	m ʊ ɦ a: d͡ʒ ə ɽ ə t
ران	r a: n
دینی	d iː n iː
بےحد	b eː ɦ ə d
انڈسٹریل	ɪ n ɖ ʊ s t r iː l
لاٹھی	l a: ʈʰ iː
بلغاریہ	b ʊ l ɣ a: ɽ ɪ j a:
تاجکستان	t a: d͡ʒ ɪ k ɪ s t a: n
ٹسکالوسکا	ʈ s k a: l ʊ s k a:
چھڑا	t͡ʃʰ ɽ aː
شاداب	ʃ a: d a: b
نارا	n a: ɽ a:
دو	d oː
یوگیتا	j oː ɡ iː t a:
كا	k a:
وجود	ʋ ə d͡ʒ uː d
تلقین	t ə l q iː n
اتحاد	ɪ t ɪ ɦ a: d
ریشم	ɽ eː ʃ ə m
سکتہ	s ə k t ə
خدا	x ʊ d a:
ریکارڈز	ɽ eɪ k a: ɽ ɖ z
کاروبار	k a: ɽ oː b a: ɽ
تجدید	t ə d͡ʒ d iː d
نکتہ	n ʊ k t a:
چناب	t͡ʃ ə n a: b
اومیش	oː m iː ʃ
دوستی	d oʊ s t iː
کاپی	k a: p iː
دھوسر	dʰ uː s ə r
پرمیشور	p ɽ ə m iː ʃ ɔː ɽ
کروڑپتی	k ɽ oː ɽ p a t iː
آئیڈیا	a: ɪ d iː a:
دھوج	dʰ ʋ ə d͡ʒ
ملزمین	m ʊ l z ɪ m iː n
اندیکھا	ə n d eː kʰ a:
لینا	l eː n a:
مجیب	m ʊ d͡ʒ iː b
تماریڈی	t ə m a: ɽ iː ɖ iː
حبش	ɦ ə b ə ʃ
اگان	ə ɡ a: n
سینیٹر	s iː n eː ʈ ə ɽ
سوار	s ʋ a: ɽ
نقطہ	n ʊ q t a:
المرزائی	a l m ɛ r z aɪ iː
ساتھی	s a: tʰ iː
سرونام	s ə ɽ ʋ n a: m
مذاکرہ	m ʊ z a: k ə r a:
شبہات	ʃ ə b ɦ a: t
قلم	q ə l ə m
کولکاتا	k oː l k a: t a:
چکنا	t͡ʃ ʊ k n a:
شاعری	ʃ a: j ɽ iː
نوٹس	n oː ʈ s
سستی	s ʊ s t iː
حبشی	ɦ ʊ b ʃ iː
نظیف	n ə z iː f
شیو	ʃ iː ʋ
موقع	m ɔː q a:
مصروف	m ʊ s ɽ ʊ f
طاق	t a: q
نامی	n a: m iː
العرفائ	ə l a ɽ f a: ɪ
الیکٹرولائٹ	ə l j eː k ʈ r oː l aː ɪ ʈ
زراعت	z ə r a: a ə t
سنجیدگی	s ʊ n d͡ʒ iː d ɡ iː
روزہ	ɽ oː z a:
توہین	t ɔː ɦ iː n
توصیف	t ʋ o s iː f
مطابق	m ʊ t a: b ɪ q
ڈومور	ɖ ʋ oː m ɔː ɽ
شیوشنکر	ʃ iː ʋ ʃ ə n k ə ɽ
لگانا	l ə ɡ a: n a:
انفورسمنٹ	ɪ n f ɔː r s m ə n ʈ
نمکین	n ə m k iː n
مذاق	m ə z a: q
رکت	ɽ ə k t
گلاس	ɡ l a: s
جگاڑ	d͡ʒ ʊ ɡ a: ɽ
درود	d ʊ ɽ uː d
فائدہ	f a: ɪ d ə
نقاب	n ɪ q a: b
کائنات	k a: ɪ n a: t
جوت	d͡ʒ oː t
غمازی	ɣ ɪ m a: z iː
شریر	ʃ ə ɽ iː ɽ
اداسی	ʊ d a: s iː
ساری	s a: r iː
جانچنا	d͡ʒ a: n t͡ʃ n a:
استقبال	ɪ s t ɪ q b a: l
فکسنگ	f ə k s ɪ ŋ
اجمیر	a: d͡ʒ m iː r
پھلنا	pʰ ə l n a:
تمام۔تر	t ʊ m a: m t ɽ
سوچنا	s oː t͡ʃ n a:
دگنا	d ʊ ɡ n a:
مشرق	m ɪ ʃ ɽ ɪ q
سوپر	s uː p ɪ ɽ
ڈیولپمنٹ	ɖ iː oʊ l p m ə n ʈ
سیریز	s iː ɽ iː z
کبج	k ʊ b d͡ʒ
سرسید	s ə ɽ s iː d
للاٹ	l ə l a: ʈ
فالسئی	f a: l s ə iː
ایف	eː f
اجناس	ə d͡ʒ n a: s
بغير	b ə ɣ ɛː ɽ
ازاں	a: z a: n
انتخابی	ɪ n t ɪ x a: b iː
لفٹ	l ɪ f t
تمھارا	t ʊ m a: ɽ a:
قیدی	q iː d iː
سائبرٹاورس	s a: ɪ b ə ɽ ʈ a: ʋ ə ɽ s
سناتن	s ə n a: t ə n
کمیونٹی	k a m j uː n ɪ ʈ iː
زیر۔قیادت	z iː ɽ q iː a: d ə t
دہی	d eː ɦ iː
سردیاں	s ə ɽ d ɪ j a:
اوپینین	oː p iː n iː n
رنگت	ɽ ə ŋ ɡ ə t
پھوڑا	pʰ oː ɽ a:
تیمور	t ɛː m uː ɽ
رابطہ	ɽ a: b t a:
جھنڈ	d͡ʒ ʱ ʊ n ɖ
مالگاڑی	m a: l ɡ a: ɽ iː
ٹیلی	ʈ iː l iː
ہکا	ɦ ɪ k k a:
عنقاد	a ɪ n q a: d
خلافت	x ɪ l a: f ə t
انڈین	ɪ n ʈ iː n
گنجان	ɡ ʊ n d͡ʒ a: n
فانی	f a: n iː
ایشن	eɪ ʃ ʊ n
ڈال	ɖ a: l
چندربند	t͡ʃ ə n d ə ɽ ə b ɪ n d ʊ
غصہ	ɣ ʊ s a:
پیکیج	p eː k iː d͡ʒ
پنگھٹ	p ə ŋ ɡʰ ə ʈ
کون	k ɔː n
سائبان	s a: iː b a: n
راؤنڈر	ɽ a: ʊ n ɖ ə ɽ
شکایات	ʃ iː k aː j aː t
اسٹارس	ə s ʈ a: ɽ s
مینہ	m e: ɦ
اطلس	ə t l ə s
چھہ	t͡ʃʰ eː
معاشرہ	m ʊ ʔ a: ʃ ɪ ɽ a:
پریت	p ə ɽ iː t
دیش	d eː ʃ
سیرسہ	s eː ɽ s ə
دھل	d ɦ ɛː l
متھرا	m ə tʰ ʊ ɽ a:
سامنے	s a: m n eɪ
کھرجو	kʰ ə ɽ d͡ʒ uː
جوہری	d͡ʒ ɔː ɦ ɽ iː
قسمت	q ɪ s m ə t
کچرہلز	k ʊ t͡ʃ r ə ɦ l z
کشٹاریڈی	k ʊ ʃ t a: ɽ iː d iː
کیلا	k eː l a:
خواہشمند	x ʋ a: ɦ ɪ ʃ m ɛː n d
ناتھولا	n a: tʰ oː l a:
قواعد	q ə ʋ a: ɪ d
ذلت	z ɪ l ə t
نمونہ	n ə m uː n a:
علم	ɪ l m
شوٹنگ	ʃ oː ʈ ɪ ŋ
کوشش	k oː ʃ ɪ ʃ
ایٹمی	ɛː ʈ m iː
خودمحتار	x ʊ d m ʊ ɦ t aː ɽ
انظر	ɪ n z ɽ
گرکیرت	ɡ ɽ k iː ɽ t
لکشمی	l ə k ʃ m iː
لکشمیا	l ə k ʃ m iː aː
ایمبرسمنٹ	ɛ m b ɽ ɛ s m ɛ n ʈ
فرزند	f ə r z ə n d
ورنگل	ʋ ɔː r n ɡ a l
گمبھیر	ɡ ə m bʰ iː ɽ
لیٹنا	l eː ʈ n a:
نماز	n ə m a: z
مسٹالا	m ʊ s ʈ a: l a:
پھیر	pʰ eː ɽ
ضمانت	z ə m a: n ə t
سینکڑوں	s eː n k ə ɽ oː n
بےپناہ	b eː p n aː ɦ
گیا	ɡ ə j a:
حلال	ɦ ə l a: l
نمبیار	n ə m b j aː r
بگاڈیا	b ʊ ɡ a: ɖ iː a:
کتاب	k ɪ t a: b
آستین	a: s t iː n
پھل	pʰ ə l
چکنائی	t͡ʃ ʊ k n aɪ iː
نوواں	n ə u ʋ a:
ہرانا	ɦ ə ɽ a: n a:
ببھکشا	b ʊ bʰ ʊ k ʂ a:
کٹی	k ə ʈ iː
انوپ	a: n uː p
خواب	x a: b
سائنسداں	s a: ɪ n s d a: n
گھاو	ɡʰ a: ʋ
خواجہ	x a: d͡ʒ a:
چکنگنیا	t͡ʃ ɪ k ə n ɡ ʊ n ɪ j a:
ضلاع	z ʊ l a: a
علاج	ʔ ɪ l a: d͡ʒ
ذمہ۔دارانہ	z ə m ɦ ɖ a: ɽ a: n a:
انکڈل	ɪ n k ə ɖ l
علوم	ʔ ʊ l uː m
جڑواں	d͡ʒ ʊ ɽ ʋ a:
الگ	ə l ə ɡ
دلچسپ	d ɪ l t͡ʃ ə s p
رنڈی	ɽ ə n ɖ iː
زینت	z eɪ n ə t
دوچار	d ʊ t͡ʃ a: ɽ
رفتار	ɽ ə f t a: ɽ
گہہ	ɡ ə ɦ ɦ
گوناگوں	ɡ oː n a: ɡ oː n
انتقال	ɪ n t iː q a: l
اقامت	ɪ q a: m ə t
گیند	ɡ eː n d
مقبوضہ	m ə q b uː z ə
ممبئی	m ʊ m b ə iː
روپے	ɽ uː p eː
شانی	ʃ a: n iː
باضابطہ	b a: z a: b ɪ t ɦ a:
پانچواں	p a: t͡ʃ ʋ a:
لوری	l oː ɽ iː
دھارا	dʰ a: ɽ a:
بمبہ	b ə m b
ٹھیس	ʈʰ iː s
کشما	k ʂ ə m a:
ڈھانک	ɖʰ a: n k
لازمی	l a: z m iː
انار	ə n a: ɽ
توں	t ʊ n
عشرت	a ɪ ʃ r ə t
اسکواڈ	a: s k uː a: d
جدید	d͡ʒ ə d iː d
گرفتارشدہ	ɡ ɛ r f t a: r ʃ ʊ d a:
صدی	s ə d iː
آئٹمس	a: ɪ ʈ m s
برن	b ə ɽ n
دودھ	d uː dʰ
اداہرن	ʊ d a: ɦ ɽ ə n
فیاض	f j a: z
مترا	m ʊ t r a:
در	d a: ɽ
کنٹک	k ə n ʈ ɪ k
پربهات	p ɽ ə bʰ a: t
بهنجك	bʰ ə n d͡ʒ ə k
لازم	l a: z ə m
مےئر	m eː ɪ ɽ
خاطیوں	x a: t iː j oː n
ازدواج	ɪ z d ɪ ʋ a: d͡ʒ
پرمکھ	p ɽ ə m ʊ kʰ
نندی	n ə n d iː
رشادی	r ə ʃ a: d iː
چاول	t͡ʃ a: ʋ ə l
موجھی	m oʊ d͡ʒʰ iː
مینا	m eː n a:
کارا	k a: ɽ a:
جادھوپور	d͡ʒ a: dʰ oː p ʊ ɽ
واقعاتی	ʋ a: q eː a: t iː
پیچھا	p iː t͡ʃʰ a:
اضافہ	ɪ z a: f ə
خداوندی	x ʊ d a: ʋ ə n d iː
راضی	ɽ a: z iː
قربت	q ʊ r b ə t
خالد	x a: l ɪ d
ابن	ə b n
پرہیزگاری	p ə r ɦ eː z ɡ a: r iː
اسٹیم	ɪ s ʈ iː m
سوانگ	s ʋ a: ŋ ɡ
خط	x a t
سنت	s a n t
ناپاک	n a: p a: k
فرضی	f ə ɽ z iː
پتلون	p ə t l uː n
ویش	ʋ eɪ ʃ
برکها	b ə ɽ kʰ a:
سلیور	s ʊ l j ɔː ɽ
بلا	b ʊ l l a:
ہائی	ɦ aɪ
پریمئر	p r eɪ m ɪə r
شیوسینا	ʃ iː ʋ s iː n a:
رائےدہی	ɽ aː ɪ ə d ɦ iː
گجویل	ɡ ə d͡ʒ ʋ ə iː l
اورمعیاری	ɔː ɽ m a ɪ j a: ɽ iː
نبھانے	n ʊ bʰ a: n eː
فرنانڈو	f a r n a: n ɖ a uː
دبئی	d ʊ b ə iː
پرشنسا	p ɽ ə ʃ ə n s a:
انشاء	ɪ n ʃ a: ʔ
صحافتی	s ʊ ɦ a: f t iː
پیکلس	p eɪ k l s
موہن	m oː ɦ n
نوموہیون	n ʊ m ʊ ɦ iː ʊ n
نیم	n ɪ j ə m
چوتر	t͡ʃ uː t ə ɽ
ماہرین	m a: ɦ ɪ ɽ iː n
عاشق	a aː ʃ ɪ q
کار	k a: ɽ
افغانستان	ə f ɣ a: n ɪ s t a: n
پراڈکٹس	p ɽ a: ʈ k ʈ s
تمنا	t ə m ə n n a:
چکرورتی	t͡ʃ ə k r ʊ r t iː
درسگاہ	d ə r s ɡ a: ɦ
بزرگ	b ʊ z ʊ ɽ ɡ
بت	b ʊ t
کوکب	k ɔː k ə b
فریدآباد	f ə r iː d a: b a: d
ابیان	a: b j a: n
کوڈا	k ʊ d a:
مرحومہ	m ə ɽ ɦ uː m ə
غزہ	ɣ ə z ə
آکھیٹ	a: kʰ eː ʈ
اذیت	ə z iː t
سلنڈر	s ə l ə n ɖ ə ɽ
جاننا	d͡ʒ a: n n a:
ششن	ʃ ɪ ʃ n
نصبین	n ə s b iː n
انہوں	ʔ ʊ n ɦ ʊ n
متوجہ	m ʊ t ə ʋ ə d͡ʒ d͡ʒ ʊ ɦ
وشوکت	ʋ ə ʃ ʋ oː k ə t
مقصدبراری	m ʊ k s ə d b ə r a: r iː
بددعا	b ə d d ʊ a:
نبض	n ə b z
خادم	x a: d ɪ m
ہند	ɦ ɪ n d
دن	d ɪ n
مہمان	m ɪ ɦ m a: n
گزارش	ɡ ʊ z a: ɽ ɪ ʃ
ٹسکرس	ʈ s k ə ɽ s
کچن	k ʊ t͡ʃ n
استثنی	ɪ s t ɪ s n a: iː
سمترا	s ə m t r a:
ارے	ə ɽ eː
بیگز	b eː ɡ z
جامنی	d͡ʒ a: m n iː
اہلیہ	a: ɦ l iː a:
علمیات	ɪ l m ɪ j a: t
نظامت	n ɪ z a: m ə t
اسکینڈلس	ə s k iː n d ə l s
منان	m ʊ n a: n
دھاندلی	dʰ a: n d l iː
فالکن	f a: l k ə n
پرستش	p ə ɽ ə s t ɪ ʃ
زیادتی	z ɪ j a: d t iː
تقلید	t ə q l iː d
اسلام	ɪ s l a: m
واقفیت	ʋ aː q f iː t
برسلز	b ɽ ə s ə l z
کیسی	k eɪ s iː
الھند	ʔ ə l ɦ ɪ n d
کپتان	k ə p t a: n
رضوی	ɽ ɪ z ʋ iː
ہومگارڈ	ɦ oː m ɡ aː r ɖ
یسعیاہ	j ə s a: ʔ j a: ɦ
مواقع	m ə ʋ a: q eː
آکرمن	a: k ɽ ə m ə n
فلو	f l oː
پور	p uː ɽ
کونسل	k oː n s ə l
مانند	m aː n ɪ n d
دہندہ	d ə ɦ n d ə
چشتی	t͡ʃ ɪ ʃ t iː
اجگر	ə d͡ʒ ɡ ə ɽ
ڈرونس	ɖ ɽ oː n s
طیرانگاہ	ʈ iː ɽ a: n ɡ a: ɦ
چنگل	t͡ʃ ʊ ŋ ɡ ʊ l
شیشے	ʃ iː ʃ eː
سخت	s ʊ x t
عرض	ə ɽ z
مہنگی	m ə ɦ n ɡ iː
اپلبدھ	ʊ p l ə b dʰ
سپریمو	s ʊ p ɽ iː m oː
باقاعدگی	b a: q a: ʔ ɪ d ɡ iː
دور	d uː ɽ
بادام	b a: d a: m
صفحہ	s ə f ɦ a:
نیا	n ə j a:
پٹے	p a t eɪ
فیکلٹی	f iː k l ʈ iː
پارٹنر	p aː ɽ ʈ n ə ɽ
کیوی	k iː ʋ iː
بحسن	b ɦ ʊ s n
تاڑی	t a: ɽ iː
بانچنا	b a: t͡ʃ n a:
ریختہ	ɽ eː x t a:
شیپ	ʃ eː p
عادل	a a: d ə l
سل	s ə l
رامائن	ɽ a: m a: j ə n
افراد۔سازی	a: f ɽ a: d . s a: z iː
جوگی	d͡ʒ oː ɡ iː
مانکیا	m a: n k iː a:
گرانا	ɡ ɪ ɽ a: n a:
آس	a: s
مکین	m ʊ k iː n
المقدس	ʔ ə l m ʊ q d ə s
ابھیلاشا	ə bʰ iː l a: ʃ a:
گرانٹس	ɡ r a: n t s
محسن	m ʊ ɦ s ə n
مؤذن	m ʊ ə z z ɪ n
بھید	bʰ eː d
ڈیولس	ɖ iː oː l s
رحمت	ɽ ɪ ɦ m a t
قینچی	q ɛ: t͡ʃ iː
ناصرت	n a: s ə ɽ ə t
ٹائلٹ	ʈ a: ɪ l ʈ
اجتماع	ɪ d͡ʒ t ɪ m aː a
چڑھنا	t͡ʃ ə ɽʰ n a:
گھنٹہ	ɡʰ ʊ n ʈ a:
جنرل	d͡ʒ ə n ɽ ə l
متقاضی	m ʊ t q aː z iː
امکانی	ə m k a: n iː
منظوری	m ə n z ʊ r iː
چدمبرم	t͡ʃ ʊ d m b ʊ ɽ m
زائد	z a: ɪ d
ٹھکانا	tʰ ɪ k a: n a:
سالومان	s a: l oː m a: n
خلیفہ	x ə l iː f a: ɦ
اسٹون	ɪ s t oʊ n
تنگ	t ə ŋ ɡ
عمرہ	a ʊ m ɽ a:
اڑیوا	ə ɽ eː ʋ a:
بھاری	bʰ a: r iː
دوپے	d oː p eː
کالسانگرا	k a: l s a: ŋ ɡ r a:
جھنڈا	d͡ʒʰ ə n ɖ a:
حویلی	ɦ ə ʋ eː l iː
طبیعت	t ə b iː j ə t
بورڈس	b ɔː ɽ d s
گانجا	ɡ a: n d͡ʒ a:
ادعا	a: d ʊ a:
معیشت	m ə ʔ iː ʃ ə t
پشتو	p ə ʃ t oː
دھو	dʰ uː
العبیدی	ʔ ɛː l a ɛː b iː d iː
ایموٹو	ɛː m oʊ ʈ oʊ
نشریات	n ə ʃ ɽ ɪ j a: t
مکھن	m ə kʰ ə n
کپوت	k ə p oː t
وینکٹیش	ʋ eː n k ʈ iː ʃ
مارکٹس	m a: r k ɪ t s
جہازی	d͡ʒ ə ɦ a: z iː
مینٹن	m eː n ʈ n
حجر	ɦ ə d͡ʒ ɽ
تولیہ	t ɔː l ɪ j ə
چوراستہ	t͡ʃ ʊ ɽ a: s t ə
سنوار	s ʊ n ʋ a: r
مرتبہ	m ə ɽ t ə b a:
غیرسرکاری	ɣ ɪ r s ʊ r k a: r iː
نگرانی	n ɪ ɡ ɽ a: n iː
از	ə z
طور	t ɔː ɽ
فورٹ	f ɔː ɽ ʈ
گرما	ɡ ɽ m aː
کانفرنس	k a: n f ɽ ə n s
ذائقہ	z a: j q a:
اجالا	ʊ d͡ʒ a: l a:
مورت	m uː ɽ ə t
مکانپور	m ə k a: n p ɔː ɽ
خسرہ	x ə s ɽ a:
الفاظ	a l f a: z
نکسیر	n ə k s iː ɽ
دریا	d ə ɽ iː a:
قاسمی	q aː s m iː
وہاں	ʋ ə ɦ a:
بھالو	bʰ a: l uː
چومنا	t͡ʃ uː m n a:
عیسیٰ	iː s a:
ٹیوٹ	ʈ iː uː ʈ
تناظر	t ə n a: z ə r
ہار	ɦ a: ɽ
ورما	ʋ ɔː ɽ m a:
بنچ	b ə n t͡ʃ
اورنمائش	ɔː r n ə m a: ɪ ʃ
جوڑا	d͡ʒ oʊ ɽ a:
گلانی	ɡ l a: n iː
احباب	ə ɦ b a: b
پورا	p uː ɽ a:
گہرا	ɡ ə ɦ ɽ a:
انارکلی	ə n a: ɽ k ə l iː
خطیر	x ə t iː r
تیرا	t eː ɽ a:
جرمنی	d͡ʒ ə ɽ m ə n iː
دام	d a: m
جارجن	d͡ʒ a: r d͡ʒ ə n
بےبس	b eɪ b ə s
بدھسٹ	b ʊ dʰ s ʈ
کشدھا	k ʂ ʊ dʰ a:
ثناخوان	s n a: x ʋ a: n
بجلی	b ɪ d͡ʒ l iː
سارا	s a: ɽ a:
سات	s a: t
پاور	p a: ʋ ə ɽ
ریپھ	ɽ eː pʰ
کم	k a m
ہنسا	ɦ ɪ n s a:
واحد	ʋ a: ɦ ɪ d
بڑھوتری	b a ɽ ʊ t ɽ iː
پہاڑ	p ə ɦ a: ɽ
کھنک	kʰ ə n ə k
سويمور	s ʋ ə j ə m ʋ ə ɽ
انجنیئرنگ	ɪ n d͡ʒ ə n iː ə ɽ n ɡ
سپاہی	s ɪ p a: ɦ iː
دلچسپی	d ɪ l t͡ʃ ʊ s p iː
روس	ɽ uː s
ثقافت	s ə q a: f ə t
گاتر	ɡ a: t ɽ
قیمتی	q iː m ə t iː
جبری	d͡ʒ ʊ b r iː
چوکا	t͡ʃ oʊ k ə
پٹریو	p ʈ r iː oː
ریکارڈکردہ	r eː k a: r ʈ k ʊ r d ə ɦ
چھوٹا	t͡ʃʰ oː ʈ a:
خارجہ	x a: ɽ ɪ d͡ʒ a:
ڈوجی	ɖ oː d͡ʒ iː
وارسا	ʋ a: ɽ s a:
سننا	s ʊ n n a:
تسلیم	t ə s l iː m
مہربند	m ə ɦ ɽ b ə n d
فلسطین	f ɪ l ɪ s t iː n
متوازن	m ʊ t ʋ aː z ə n
خسرو	x ʊ s ɽ oː
کاری	k a: ɽ iː
مہر	m ʊ ɦ ə ɽ
مٹنا	m ɪ ʈ n a:
تحریک	t ə ɦ ɽ iː k
مالٹا	m ə l ʈ a:
کرانیکل	k ə r a: n iː k ə l
برتن	b ə ɽ t ə n
سرشت	s ə ɽ ɪ ʃ t
گنگولی	ɡ ʊ ŋ ɡ ɔː l iː
گھریلو	ɡʰ ə ɽ eː l uː
کتره	k ʊ t ɽ
نغمہ	n ə ɣ m ə
اوز	oː z
سوشیل	s oː ʃ iː l
افسانہ	ə f s a: n ə
سیشنس	s eː ʃ n s
مجرمانہ	m ʊ d͡ʒ ɽ ɪ m a: n a:
فاروق	f a: ɽ ʊ q
کارن	k a: ɽ ə n
خانہ	x a: n a:
رفت	ɽ ə f t
نذرانہ	n ɪ z r a: n a:
گڈا	ɡ ʊ ɖ ɖ a:
محدود	m ə ɦ d uː d
سوان	s ʋ a: n
اتحادی	ɪ t t ɪ ɦ a: d iː
طبقہ	ʈ ə b q ə
اسم	ɪ s m
جبرئیل	d͡ʒ ɪ b r aɪ l
چنانچہ	t͡ʃ ʊ n a: n t͡ʃ a:
ہمیں	ɦ ə m e:
اطلاقی	ɪ t l a: q iː
ین	iː n
حیران	ɦ ɛː ɽ a: n
ستاری	s t a: ɽ iː
جوہر	d͡ʒ ɔː ɦ ə ɽ
ننھا	n ə n a:
مکتوب	m ʊ k t oʊ b
انتہا	a n t a a:
جلنا	d͡ʒ ə l n a:
صلاح	s ʊ l a: ɦ
عشق	ɪ ʃ q
چوگنا	t͡ʃ ɔː ɡ ʊ n a:
گرہن	ɡ ɽ ə ɦ ə n
حفاظت	ɦ ɪ f a: z ə t
سوٹ	s uː ʈ
شری	ʃ ɽ iː
لندن	l ə n d ə n
حسنی	ɦ ə s n iː
آذربائیجان	a: z ə ɽ b a: ɪ d͡ʒ a: n
توجہی	t ʋ oː d͡ʒ ɦ iː
اسٹیونس	ə s ʈ iː ʋ oː n s
کینسر	k æ n s ə ɽ
امام	ɪ m a: m
اخلاق	ə x l a: q
حکومت	ɦ ʊ k uː m ə t
لحاظ	l ɪ ɦ a: z
اگربتی	ə ɡ ə ɽ b ə t t iː
شوارع	ʃ oː aː r a
بلاآواز	b a l a: a: ʋ a: z
انشورنس	ɪ n ʃ ʊ r ə n s
چوتڑ	t͡ʃ uː t ə ɽ
ناممکن	n a: m ʊ m k ə n
ڈارا	ɖ a: ɽ a:
سگنل	s ɪ ɡ n ə l
بھوگ	bʰ ʊ ɡ
ککش	k ə k ʃ
راو	r aː ʋ
گندا	ɡ ʊ n d a:
جائلس	d͡ʒ a: ɪ l s
ناراض	n a: ɽ a: z
ابتر	ə b t ə ɽ
ننگا	n ə ŋ ɡ a:
چھڑکاؤ	t͡ʃʰ ɪ ɽ k a: oː
رامیا	ɽ a: m iː a:
فہد	f ə ɦ d
نوٹ	n oʊ t
جھگڑا	d͡ʒʰ ə ɡ ɽ a:
جوں	d͡ʒ u:
جٹ	d͡ʒ a ʈ
مرنا	m ə ɽ n a:
تعمیری	t a ə m iː r iː
کیا	k ɪ j a:
اهہ	ɪ ɦ
کمپنی	k ə m p n iː
ادعاء	ʔ ə d a aː
خبر	x ə b ə ɽ
سلجوقی	s ə l d͡ʒ uː q iː
تماشہ	t ʊ m a: ʃ a:
نکالنا	n ɪ k a: l n a:
چیلنجس	t͡ʃ eː l ə n d͡ʒ s
ہفتہ	ɦ ə f t a: ɦ
لڑکا	l ə ɽ k a:
ہتیارا	ɦ ə t j a: ɽ a:
اضطراری	ɪ z t ɪ ɽ a: ɽ iː
اصیل	ə s iː l
بدھیا	b ə dʰ ɪ j a:
چنی	t͡ʃ ʊ n iː
الوداع	ə l ʋ ɪ d a:
چھوٹ	t͡ʃʰ uː ʈ
اوسو	ɔː s o
ذمہ۔دار	z ə m ɦ ə d aː ɽ
عینی	a eː n iː
لکژری	l ʊ k z ʊ r iː
برس	b ɛː ɽ s
زندہ	z ɪ n d a:
تعاقب	t a a: q ʊ b
جیل	d͡ʒ eː l
نصاب	n ɪ s a: b
مالدیپ	m a: l d iː p
ثانوی	s a: n ʋ iː
دوسرا	d uː s ɽ a:
سفارت	s ɪ f a: ɽ ə t
پسندیدہ	p ʊ s n d iː d ə
مولین	m oː l iː n
شادی	ʃ a: d iː
مدھم	m ə dʰ ə m
مقدر	m ʊ q d a: ɽ
پیج	p ɛː d͡ʒ
خوش	x ʊ ʃ
نائٹ	n aɪ t
مردانہ	m ə ɽ d a: n a:
اوقاف	ɔː q a: f
خاتمہ	x a: t ɪ m ə
تعمیراتی	t a ə m iː r a: t iː
تخلیہ	t ə x l iː ə
یوم	j oː m
باعزت	b a: a ɪ z z ə t
ادھو	a dʰ oʊ
واقف	ʋ a: q ɪ f
ڈوری	ɖ oː ɽ iː
یزدانی	j ɛ z d a: n iː
القاعدہ	ʔ ə l q a: a ɪ d a:
دھوم	dʰ uː m
ضبط	z a b t
چکت	t͡ʃ ə k ɪ t
بودھن	b oː dʰ ə n
سرمہ	s ʊ ɽ m a:
تیز	t eː z
چھان	t͡ʃʰ a: n
پہلوان	p ə ɦ l ʋ ə n
دوستانہ	d oː s t a: n a:
مہیب	m ʊ ɦ iː b
کیمیائی	k iː m ɪ j a: iː
مہندی	m ɪ ɦ ə d iː
بھاشا	bʰ a: ʂ a:
گاڑ	ɡ a: ɽ
سبزی	s ə b z iː
رنز	r ə n z
سوہال	s uː ɦ aː l
منشیات	m ʊ n ə ʃ ɪ j a: t
گارنر	ɡ a: r n ə r
نارنجی	n a: ɽ ə n d͡ʒ iː
پردیش	p ɽ ə d iː ʃ
کمان	k ə m a: n
نذرآتش	n ɛː z ɽ a: t ɪ ʃ
کنجی	k ʊ n d͡ʒ iː
اسپانچ	ɪ s p a: n t͡ʃ
انش	ə n ʃ
موہنی	m oː ɦ n iː
لداخ	l ə d a: x
عناصر	a ɪ n a: s ə r
جی	d͡ʒ iː
پیرس	p ɛː ɽ ɪ s
مچھرکش	m ʊ t͡ʃʰ ɽ k ɪ ʃ
تقریباً	t ə q ɽ iː b ə n
گمنام	ɡ ʊ m n a: m
فیڈرر	f eː d ɛː ɽ ɽ
بدعنوانی	b ə d a n ʋ a: n iː
ایران	iː ɽ a: n
شعب	ʃ a a b
سلام	s ə l a: m
بارش	b a: ɽ ɪ ʃ
بونا	b ɔː n a:
ترٹی	t ɽ ʊ ʈ iː
انتہاپسند	ɪ n t e ɦ a: p ə s ə n d
انسیت	ɪ n s iː t
خاکسار	x a: k s a: ɽ
ارتعاش	ɪ ɽ t eː a: ʃ
شہر	ʃ ɛ ɦ ɛ ɽ
باٹ	b a: ʈ
اظہر	ʔ ɪ z ʱ ə r
مقتول	m ʊ q t uː l
سفید	s ə f eː d
نبی	n ə b iː
ویزا	ʋ iː z a:
رخ	r ʊ x
منگوانا	m ə n ɡ ʋ a: n a:
رسول	ɽ ə s uː l
مظاہرہ	m ʊ z a: ɦ ɪ ɽ a:
بکرا	b ə k ɽ a:
چابی	t͡ʃ a: b iː
نظم	n ə z ə m
کہنا	k ə ɦ n a:
شہلا	ʃ ə ɦ l a:
النکار	ə l ə ŋ k a: ɽ
خودمختاری	x ʊ d m ʊ x t a: ɽ iː
بکری	b ə k ɽ iː
سرم	s ə r m
راہداری	ɽ a: ɦ d a: ɽ iː
نستعلیق	n ə s t a: l iː q
اجتماعی	a: d͡ʒ t ɪ m a: a iː
یونان	j uː n a: n
نکل	n ɪ k ə l
سرفروش	s ə ɽ f ə ɽ oː ʃ
توچا	t ʋ ə t͡ʃ a:
بروخے	b ɽ uː x eː
نا	n a:
نباتیات	n ə b a: t ɪ j a: t
جمعہ	d͡ʒ ʊ m ʔ a:
جرگہ	d͡ʒ ɪ ɽ ɡ a:
فصل	f a s l
معبود	m a: ʔ b uː d
حج	ɦ ə d͡ʒ d͡ʒ
دندنا	d ə n d ə n a:
جونیر	d͡ʒ ʊ n iː ɽ
بابری	b a: b ɽ iː
سسرال	s a s r a: l
ادا	ə d a:
بےجا	b eː d͡ʒ a:
جینت	d͡ʒ iː n t
سے	s eː
کمرے	k ə m ɽ eː
کب	k a b
روپ	ɽ uː p
تیرنا	t ɛː ɽ n a:
آمیزش	a: m eː z ɪ ʃ
آندھی	a: n dʰ iː
کومٹ	k oː m ʈ
خاکستری	x a: k ɪ s t ə ɽ iː
آیوکت	a: j oː k t
ناٹ	n a: ʈ
بیٹسمےن	b eː ʈ s m ɛ n
للن	l ʊ l ə n
ٹورسٹ	ʈ ɔː ɽ s ʈ
کسمپرسی	k ə s m ʊ p r ə s iː
خراج	x ə r a: d͡ʒ
مہاراشٹر	m ə ɦ a: ɽ a: ʃ ʈ ə ɽ
روزن	ɽ ɔː z ə n
بلز	b ə l z
حقیقت	ɦ ə q iː q ə t
چہرہ	t͡ʃ ɪ ɦ ɽ a:
بھرن	bʰ ə ɽ ə n
پہن	p ɛː n
اندلس	ʊ n d ʊ l ʊ s
خاصے	x a: s e
گارڈیولا	ɡ aː ɽ ɖ iː oː l aː
میگھ	m eː ɡʰ
پانچ	p a: t͡ʃ
دامودر	d a: m uː d a r
بٹورنا	b ə ʈ oː ɽ n a:
اغوا	ɪ ɣ ʋ a:
تحفظ	t ə ɦ f ə z
دوش	d oː ʃ
بال	b a: l
کمی	k ə m iː
کیپرس	k eɪ p ɛ r s
کوٹھی	k oː ʈʰ iː
نیاک	n iː a: k
نیننس	n eː n ɪ n s
تحریر	t ʊ ɦ r iː r
لہجہ	l ə ɦ d͡ʒ ə
باک	b a: k
شہادت	ʃ ə ɦ a: d ə t
بہادر	b ə ɦ a: d ə ɽ
گردوارہ	ɡ ʊ ɽ d ʋ a: ɽ a:
مفاہمانہ	m ʊ f a: ɦ m a: n a:
انقلاب	ɪ n q ɪ l a: b
جپنا	d͡ʒ ə p n a:
بھارتیہ	bʰ a: r t iː ə
جراثیم	d͡ʒ ə ɽ a: s iː m
مقدسہ	m ʊ q ə d d ə s a:
ڈنکرک	ɖ ə n k ə ɽ k
مہارانی	m ə ɦ a: ɽ a: n iː
جل	d͡ʒ ə l
فیروزی	f eː ɽ oː z iː
ہوس	ɦ ə ʋ ə s
انگوٹھا	ə ŋ ɡ uː ʈʰ a:
مارگ	m a: ɽ ɡ
غیرمحفوظ	ɣ ɛː ɽ m ɦ ʊ f ʊ z
سوامی	s ʊ a: m iː
قیام	q iː a: m
دھواں	dʰ uː a:
غفلت	ɣ ə f l ə t
لائینز	l aɪ n z
انگلینڈ	ɪ ŋ ɡ l ɛː n ɖ
محمدو	m ʊ ɦ ə m ə d ʋ oʊ
جزیرہ	d͡ʒ a z iː r a
نوبت	n ɔː b ə t
خیرسگالی	x eː r s ɡ a: l iː
انگلستان	ɪ ŋ ɡ l ɪ s t a: n
بوتے	b ʊ t eː
راستہ	ɽ a: s t ə
مرکندہ	m ʊ ɽ k ə n d ə
جائزہ	d͡ʒ a: ɪ z a:
مولا	m ɔː l a:
وچن	ʋ ə t͡ʃ ə n
متذکرہ	m ʊ t z ɪ k ɽ a:
یوہان	j uː ɦ aː n
اور	ɔː ɽ
مفاہمت	m ʊ f a: ɦ ɪ m ə t
ذمہداری	z ə m ɦ d a: ɽ iː
سرکار	s ə ɽ k a: ɽ
معالجہ	m a a a: l ɪ d͡ʒ a:
بشیر	b ə ʃ iː ɽ
مایوس۔کن	m aː j oː s k ʊ n
ہڑتالی	ɦ ə ɽ t a: l iː
بوائز	b oʊ z
ہیڈکوارٹر	ɦ iː ʈ k ʋ a: ɽ ʈ ə ɽ
وینیو	ʋ eɪ n iː uː
مذکرہ	m ʊ z k ɪ ɽ a:
آنجہانی	a: n d͡ʒ ə ɦ aː n iː
گندمی	ɡ ə n d ʊ m iː
مچھلی	m ə t͡ʃʰ l iː
تلخی	t ə l x iː
سٹی	s ʈ iː
اکابر	ʔ a: k a: b ɛː ɽ
معلنہ	m a ə l ə n ə ɦ
آلس	a: l ə s
پیاز	p ɪ j a: z
پرگنا	p ə r ɡ n a:
گدھ	ɡ ɪ d dʰ
مینڈس	m eː n ɖ s
شرم	ʃ ə ɽ m
افرادی	a: f ɽ a: d iː
ہچکنا	ɦ ɪ t͡ʃ ə k n a:
خود	x ʊ d
جھونکا	d͡ʒʰ uː n k a:
طرابلس	t ɽ a: b ʊ l s
ڈپٹی	ɖ ə p ʈ iː
بظاہر	b ə z a: ɦ ɪ ɽ
دیپک	d iː p ə k
ہم	ɦ ə m
ہستم	ɦ ə s t ə m
اینٹی	ʔ eː n ʈ iː
جلوس	d͡ʒ ʊ l uː s
شہزادہ	ʃ ə ɦ z a: d a:
گورو	ɡ ɔː ɽ ə ʋ
اطمینان	ɪ t m iː n a: n
سندر	s ʊ n d ə ɽ
بٹور	b ʊ t ɔː ɽ
برما	b ə ɽ m a:
کراہیت	k ɽ a: ɦ iː t
اپدهان	ʊ p dʰ a: n
پانڈیچری	p a: n ɖ iː t͡ʃ ə r iː
کواری	k ʋ a: r iː
سائز	s a: ɪ z
کھنکنا	kʰ ə n ə k n a:
لمبائی	l ə m b a: iː
رامچندر	ɽ a: m t͡ʃ ə n d ɽ ə
سیرت	s iː r ə t
مہنگا	m ə ɦ ə ɡ a:
ناظم	n a: z ɪ m
حیاتیات	ɦ ə j a: t ɪ j a: t
جدا	d͡ʒ ʊ d a:
اڈے	ə ɖ ɛː
اسکام	ə s k a: m
چھٹی	t͡ʃʰ ʊ ʈ iː
پرکلا	p ɛ ɽ k l a:
اچھا	ə t͡ʃ t͡ʃʰ a:
تیکھا	t iː kʰ a:
محشر	m ə ɦ ʃ ə ɽ
مانے	m aː n eː
محتاجی	m ʊ ɦ t a: d͡ʒ iː
گنگ	ɡ ʊ ŋ ɡ
پھیلی	pʰ eː l iː
روا	r ʋ a:
میکسیکو	m eː k s iː k oː
اشتقاق	ɪ ʃ t ɪ q a: q
خیر	x ɛː ɽ
چمو	t͡ʃ ə m uː
اشیاء	a ʃ j a: ʔ a:
بدھا	b ʊ dʰ a:
خوبانی	x uː b a: n iː
اکثریت	a k s ʊ ɽ iː t
شنتانو	ʃ ə n t ə n uː
گوگرد	ɡ oː ɡ ɪ ɽ d
تدریسی	t ə d ɽ iː s iː
ملن	m ɪ l ə n
ونا	ʋ ɪ n a:
ریاضی	ɽ ɪ j a: z iː
وویک	ʋ oː ʋ iː k
زبردستی	z ʊ b ɽ d ʊ s t iː
ذوق	z ɔː q
مکتب	m ʊ k t ə b
وینکٹ	ʋ eː n k ɪ ʈ
راکٹ	ɽ a: k ɪ ʈ
صحافی	s ɪ ɦ a: f iː
خریدوانا	x ə ɽ iː d ʋ a: n a:
عروس	a ʊ ɽ ʊ s
سمپرداے	s ə m p ɽ ə d a: eː
سابقہ	s a: b iː q a:
داعش	d a: ʔ ɪ ʃ
بلے	b ʊ l eː
تو	t uː
غلام	ɣ ʊ l a: m
مفت	m ʊ f t
اٹاپٹو	a t aː p t o
امان	ə m a: n
دلجمعی	d ə l d͡ʒ ʊ m a iː
آگاہی	a: ɡ a: ɦ iː
فون	f o: n
پراڈکٹ	p ɽ aː ɖ a k ʈ
اولمپک	ʔ aʊ l m p ɪ k
خراش	x ə ɽ a: ʃ
نسق	n ɪ s q
ڈھانپنا	ɖʰ a: p n a:
استعمال	ɪ s t eː m a: l
آفریدی	a: f ɽ iː d iː
سمجھ	s ʊ m d͡ʒʰ
چیمپین	t͡ʃ iː m p iː n
ہلڑ	ɦ ə l ɽ
ترجمان	t ə ɽ d͡ʒ ʊ m a: n
امدادی	ə m d a: d iː
برخلاف	b ɪ ɽ x ɪ l a: f
صابن	s a: b ʊ n
آسیب	a: s eː b
کیلی	k eː l iː
بڑھتا	b ə ɽ ʈ a:
پٹھان	p ə ʈʰ a: n
شخص	ʃ ə x s
جائیداد	d͡ʒ a: ɪ d a: d
اپستھت	ʊ p ə s tʰ ɪ t
بھوٹیہ	bʰ ʊ ʈ iː a:
مدعوئین	m ʊ d a ʋ i: n
ہاما	ɦ a: m a:
پرزور	p ə ɽ z ʊ ɽ
مثلا	m ə s l ə n
بینالاقوامی	b eɪ n a: l a: q ʋ a: m iː
داستان	d a: s t a:
کیتیش	k eː t iː ʃ
آلراؤنڈر	a: l r aʊ n d ə r
سنتوش	s ʊ n t oʊ ʃ
سوپراسٹار	s uː p ɽ a: s ʈ a: ɽ
نسبت	n ɪ s b ə t
الہی	ʔ ɛː l ɦ iː
ری۔ایکٹرس	ɽ eː a: ɪ k t ɽ ʊ s
گلہری	ɡ ɪ l ə ɦ ɽ iː
ہسپانیہ	ɦ ə s p a: n ɪ j ə ɦ
محروم	m ə ɦ ɽ uː m
حیوانیات	ɦ ɛː ʋ a: n ɪ j a: t
اوقافی	oː q aː f iː
شیشہ	ʃ iː ʃ a:
نظام	n ɪ z a: m
غنچہ	ɣ ʊ n t͡ʃ a:
بندیل	b ə n d iː l
شلپا	ʃ ʊ l p a:
لیسٹر	l ɛː s ʈ ə ɽ
ایذارسانی	ɛː z a: ɽ s a: n iː
ابو	ə b b uː
کیمپ	k eː m p
احترام	e ɦ t ɪ ɽ a: m
خانساماں	x a: n s a: m a:
مذمت	m ə z ə m ə t
تھیراپی	tʰ eː ɽ a: p iː
عیاشی	ʔ ə i j a: ʃ iː
دکھ	d ʊ kʰ
نافذالعمل	n aː f iː z ʔ ə l a ə m ə l
برف	b ɛː ɽ f
اپاہج	ə p a: ɦ ɪ d͡ʒ
انوراللہ	a: n ʋ ə r a: l l a: ɦ
گلو	ɡ ʊ l oː , ɡ ʊ l uː , ɡ ə l uː
ہتھیلی	ɦ ə tʰ eː l iː
جوفری	d͡ʒ o f r iː
معاملہ	m ʊ a: m l a:
ں	n
کامرس	k aː m ə ɽ s
ایشور	iː ʃ ʋ ə ɽ
وتر	ʋ ə t ə ɽ
ارکنساس	a: ɽ k ə n s a: s
ممتا	m ʊ m t a:
داڑم	d a: ɽ ɪ m
پرچم	p ə ɽ t͡ʃ ə m
چھوٹنا	t͡ʃʰ uː ʈ n a:
گائیڈنس	ɡ a: iː d n s
پنیسر	p a n iː s ɛ r
میوہ	m eː ʋ a:
بشمول	b ə ʃ m ʊ l
پوشیدہ	p oː ʃ iː d ə
سلوک	s ʊ l uː k
بتانا	b ɪ t a: n a:
مشکل	m ʊ ʃ k ɪ l
تعداد	t ə ʔ d a: d
فرق	f ɽ q
اصل	ə s ə l
بےصبری	b eː s ʊ b ɽ iː
مصنوعات	m ʊ s n u: a a: t
پاؤڈر	p a: ʊ ʈ ə ɽ
ٹھیک	ʈʰ iː k
لائے	l a: ɪ eː
معتمد	m ʊ ʔ t ə m ɪ d
کہاوت	k ə ɦ a: ʋ ə t
شبانہ	ʃ ə b a: n a:
جنت	d͡ʒ ə n ə t
فلپائن	f ɪ l ɪ p a: ɪ n
سندھ	s ɪ n dʰ
بادبانی	b a: d b a: n iː
خبریں	x ə b ɽ iː n
کھیلا	kʰ eː l a:
عمل	ə m ə l
جائے	d͡ʒ a: ɪ
بنتی	b ɪ n t iː
جوڑ	d͡ʒ oː ɽ
قمیض	q ə m iː z
دشت	d ə ʃ t
دیوبندی	d eː ʋ b ə n d iː
اژدہا	ə ʒ d ə ɦ a:
دسواں	d ə s ʋ a:
اٹاچی	ə ʈ ɛː t͡ʃ iː
مایہ	m aː j ɦ
ابابیل	ə b a: b iː l
ابودرداء	ʔ a: b uː d ə r d a: ʔ
اداس	ʊ d a: s
فوج	f ɔː d͡ʒ
خاصکر	x a: s k ə ɽ
کفر	k ə f ə r
اشبھ	ə ʃ ʊ bʰ
وشاکھا	ʋ ʊ ʃ a: kʰ a:
مرمت	m ə ɽ ə m ə t
عبادت	ɪ b a: d ə t
ممالک	m ə m a: l ɪ k
تلاش	t ə l a: ʃ
مچلکہ	m ʊ t͡ʃ a l k a:
نافرمان	n a: f ə ɽ m a: n
کلب	k ʊ l b
روچڈیل	ɽ ɔː t͡ʃ ɖ eː l
ڈاکیہ	ɖ a: k ɪ j a:
سربیائی	s ʊ r b iː a: iː
مسدود	m ʊ s d uː d
تیزاب	t eː z aː b
قبضہ	q ə b z ə
ٹینڈرس	ʈ eː n d ʊ ɽ s
انجانا	ə n d͡ʒ a: n a:
گائناکالوجی	ɡ a: iː n a: k a: l oː d͡ʒ iː
کمپ	k ə m p
وستو	ʋ ə s t uː
مشرا	m ə ʃ ɽ a:
انسان	ɪ n s a: n
بهیس	bʰ eː s
انکاؤنٹر	ɪ n k aʊ n t ɛ r
چانسلر	t͡ʃ a: n s ə l ə ɽ
احمدآباد	a: ɦ m ɛː d a: b a: d
آلودگی	a: l uː d ə ɡ iː
ظفر	z ʊ f ə r
عمان	ʔ o m a: n
نسبتا	n ɪ s b ə t ə n
ہاتھ	ɦ a: tʰ
عاص	a a: s
تبدیلی	t a b d iː l iː
فراخ۔دل	f ɽ a: x d ɪ l
جعلی	d͡ʒ a: l iː
علامت	a ʊ l aː m a t
اڑھا	a ɽʰ a:
سنجها	s ə n d͡ʒʰ a:
ذریعہ	z ə ɽ ɪ j ə
جہنم	d͡ʒ ə ɦ ə n n ə m
طالب	ʈ a: l ɪ b
مراسم	m ʊ r aː s ɪ m
جغرافیائی	d͡ʒ ʊ ɣ ɽ a: f ɪ j a: iː
انگلی	ʊ ŋ ɡ l iː
سیر	s ɛː ɽ
ہوا	ɦ ə ʋ a:
میتو	m iː t ʊ
دفتری	d ə f t ə r iː
سرزمین	s ʊ ɽ z ə m iː n
سمرتی	ɪ s m ɽ ɪ t iː
قسط	q ɪ s t
ثابت	s a: b ɪ t
جارحانہ	d͡ʒ a: ɽ ɦ a: n a:
ولتھاٹی	ʋ ʊ l tʰ a: ʈ iː
قرمزی	q ɪ ɽ m ɪ z iː
عبد	a ʊ b d
میرا	m eː ɽ a:
المسلمین	ʊ l m ʊ s l iː m iː n
انتم	ə n t ɪ m
قدیم	q ə d iː m
پکار	p ʊ k a: ɽ
عزیز	ə z iː z
سلم	s ʊ l m
کیوں	k j ɔː n
آپ	a: p
کعبہ	k a: b a:
گولمیز	ɡ oː l m iː z
غیرموسمی	ɣ ɛː ɽ m oː s m iː
چیلنج	t͡ʃ eː l n d͡ʒ
باغ	b a: ɣ
پڈوچیری	p ə ɖ oː t͡ʃ iː ɽ iː
مضحکہ	m ʊ z ɦ a: k ə
شاعرہ	ʃ a: j ɽ a:
زبان	z ʊ b a: n
ہانکنا	ɦ a: ŋ k n a:
ابهار	ʊ bʰ a: ɽ
اسپاٹ	ɪ s p a: ʈ
چھلانگ	t͡ʃʰ ə l ə ŋ ɡ
گجرات	ɡ ʊ d͡ʒ ɽ a: t
اسپیکٹرم	ə s p eː k ʈ r ʊ m
پرسکون	p ə ɽ s k uː n
تبادلہ	t ə b a: d ɪ l a ɦ
کے	k eː
کالم	k aː l ʊ m
ناساز	n a: s a: z
غرور	ɣ ʊ ɽ uː ɽ
آریامن	a: ɽ j ə m ə n
تیسرا	t iː s ɽ a:
جگنو	d͡ʒ ʊ ɡ n uː
معضون	m aː z uː n
بناوٹی	b ə n a: ʋ ə ʈ iː
اڈوائزری	ə ɖ ʋ a: ɪ z ə ɽ iː
لکشمن	l ʊ k ʃ m ʊ n
لکھنا	l ɪ kʰ n a:
شنید	ʃ ə n iː d
خونریز	x ʊ n r iː z
مضمون	m ʊ z m uː n
ٹکٹس	ʈ ɪ k ʈ s
جسونت	d͡ʒ ʊ s ʊ n t
سمراٹ	s ə m ɽ a: ʈ
رات	ɽ a: t
حلقہ	ɦ ə l q ə
یچوری	j ɛ t͡ʃ oː r iː
اکائی	a: k a: iː
کانپنا	k a: p n a:
لیول	l iː ʋ ə l
پرچی	p ə ɽ ɪ t͡ʃ ə j
بامشقت	b a: m ʃ q a t
یروشلم	j ə ɽ uː ʃ ə l ə m
میدان	m eː d a: n
منسوخی	m ʊ n s ʊ x iː
کھنن	kʰ ə n ə n
ماحول	m a: ɦ ɔː l
گردن	ɡ ə ɽ d ə n
مناسب	m ʊ n a: s ɪ b
ڈھانچہ	ɖʰ a: n t͡ʃ a:
ہونٹھ	ɦ o: ʈʰ
ٹیوب	ʈ iː ʋ b
آنسو	a: s uː
وفاق	ʋ ɪ f a: q
قرعہ	q ʊ r a a a:
دھن	dʰ ʊ n
لارینس	l a: ɽ iː n s
سواری	s ʋ a: ɽ iː
مزہ	m ə z a:
پون	p ə ʋ ə n
وزیرستان	ʋ ə z iː ɽ ə s t a: n
ختم	x ə t m
چربی	t͡ʃ ə ɽ b iː
نادان	n a: d a: n
پتلا	p ʊ t l a:
ہدیۂ	ɦ ə d iː ə
تیرھواں	t ɪ ɽ ʊ ʋ a: n
مہربن	m ə ɦ r b ə n
کھلاڑی	kʰ l a: ɽ iː
روایاتی	ɽ ʋ a: j a: t iː
عزا	a ɪ z a:
دیرینہ	d eɪ r iː n a:
بھرت	bʰ ə r t
برمنگھم	b ə ɽ m ɪ n ɡʰ ə m
ایت	ə j ʊ t
قدرت	q ʊ d ɽ a: t
اعتماد	ɪ ʔ t ɪ m a: d
جہدکار	d͡ʒ ə ɦ d k a: ɽ
بنيان	b ə n ɪ j a: n
بائیسکل	b a: iː s ɪ k ə l
سنوائی	s ʊ n oː a: iː
سمئے	s ə m ə j
کتا	k ʊ t t a:
اخروٹ	ə x ɽ oː ʈ
پھلکی	pʰ ʊ l k iː
چیرمین	t͡ʃ eː r m iː n
مکر	m ʊ k ə ɽ
بےہوش	b eː ɦ oː ʃ
سنیوگ	s ə j oː ɡ
کپاس	k ə p a: s
ادب	ɪ d b
بھائی	bʰ a: iː
آخرالزماں	a: x ɪ r a l z ʊ m a: n
گرڈ	ɡ ə ɽ ʊ ɖ
اندیشہ	ɪ n d iː ʃ a:
دیروز	d iː ɽ oː z
خلیج	x ə l iː d͡ʒ
ہوشیار	ɦ oː ʃ ɪ j a: ɽ
سوغات	s ɔː ɣ a: t
اجنبی	ə d͡ʒ n ə b iː
جلانا	d͡ʒ ə l a: n a:
کردنت	k ɽ ɪ d ə n t
لفظ	l ə f z
تمنچه	t ə m ə n t͡ʃ a:
لوشیا	l oː ʃ iː a:
دادا	d a: d a:
عبدالحمید	a b d ʊ l ɦ ə m iː d
اصطبل	ə s t ə b ə l
موظف	m ʊ z ə f
کہرا	k ʊ ɦ ɽ a:
گھڑی	ɡʰ ə ɽ iː
پستک	p ʊ s t ə k
مکل	m ʊ k l
ترقی	t ə ɽ q iː
یرمیاہ	j ɪ ɽ m ɪ j a: ɦ
وزیرداخلہ	ʋ ə z iː r d a: x l ə
الداخلہ	ʔ ɛː l d a: x l a:
پیڑ	p eː ɽ
منڈا	m ʊ n ɖ a:
معدنیات	m ʊ ʔ d ə n iː a: t
لاما	l a: m a:
کھڑے	kʰ ə ɽ eː
لیئج	l ɪ j eː d͡ʒ
منیجر	m ə n iː d͡ʒ ə r
شان	ʃ aː n
ہمدردی	ɦ ə m d ə r d iː
وجیہ	ʋ ə d͡ʒ iː ɦ
انڈیا	ɪ n ɖ ɪ j a:
اڑا	a ɽ a:
ہائیکورٹ	ɦ aː iː k ɔː ɽ ʈ
پدما	p ə d m a:
مقررہ	m ʊ q ɽ a: ɽ ə
مر	m ə ɽ
پانچوں	p a: n t͡ʃ o
ایٹا	eɪ ʈ a:
غزوۂ	ɣ ə z ʋ ə
اعزازی	a: ɪ z a: z iː
آتما	a: t m a:
احمد	ʔ ə ɦ m ə d
برڈ	b ɽ ʊ d
بچہ	b ə t͡ʃ a:
خوف	x ɔː f
پٹنہ	p a t n a:
کھڑی	kʰ ə ɽ iː
مناظر	m ə n a: z ɪ ɽ
پٹاخا	p ə ʈ a: x a:
یہ	j eː
ہمیشگی	ɦ ə m eː ʃ ɡ iː
سمن	s ʊ m ə n
سمجھنا	s ə m ə d͡ʒʰ n a:
اوقات	ɔː q a: t
دشمن	d ʊ ʃ m ə n
کیف	k eː f
راجستھان	ɽ a: d͡ʒ s tʰ a: n
