líon	lʲ iː n̪ˠ
fréimh	fʲ rʲ eː vʲ
critheann	ˈc rʲ ɪ h ə n̪ˠ
smailte	ˈsˠ mˠ æ l̠ʲ tʲ ə
oil	ɛ lʲ
béasach	ˈbʲ iː a̯ sˠ ə x
deargfaidh	ˈdʲ a ɾˠ ə k ə
d'fhill	dʲ iː lʲ
teampall	ˈtʲ ɑ u mˠ pˠ ə l̪ˠ
mórtas	ˈmˠ oː ɾˠ t̪ˠ ə sˠ
peitreal	ˈpʲ ɛ tʲ ɾʲ ə lˠ
cluas	k lˠ u ə sˠ
Í	iː
bronn	bˠ ɾˠ oː n
anlann	ˈɑ u n̪ˠ l̪ˠ ə n̪ˠ
cíos	c iː sˠ
dtuama	ˈd̪ˠ u ə mˠ ə
córas	ˈk oː ɾˠ ə sˠ
snáthaid	ˈsˠ n̪ˠ ɑː h ə d̪ˠ
gráigh	ɡ ɾˠ ɑː ɟ
foirmle	ˈfˠ ɛ ɾʲ ə mʲ lʲ ə
connadh	ˈk ɔ n̪ˠ ə
glinne	ˈɟ lʲ i n̠ʲ ə
moille	ˈmˠ ɪ l̠ʲ ə
geall	ɟ a u l̪ˠ
fionn	fʲ ũː n̪ˠ
Spáinne	ˈsˠ pˠ ɑː ɲ ɪ
seachtar	ˈʃ a x t̪ˠ ə ɾˠ
méar	mʲ iː a̯ ɾˠ
ómrach	ˈoː mˠ ɾˠ ə x
céide	ˈc eː dʲ ə
tar	t̪ˠ a ɾˠ
tae	t̪ˠ eː
puca	ˈpˠ ʊ k ə
conáil	ˈk uː nˠ æ lʲ
gair	ɡ a ɾʲ
comh	k ɔ
cáinte	ˈk ɑː n̠ʲ tʲ ə
dála	ˈd̪ˠ ɑː lˠ ə
gnóthach	ˈɡ ɾˠ ẽː h a x
puinn	pˠ iː nʲ
saol	sˠ eː l̪ˠ
brat	bˠ ɾˠ ɑ t̪ˠ
ladhar	l̪ˠ ə i ɾˠ
Peirsis	ˈpʲ ɛ ɾʲ ʃ ɪ ʃ
thiocfadh	ˈh ʊ k ə tʲ
uaibhse	ˈw æ pʲ ʃ ə
rásúirí	ˈɾˠ ɑː sˠ uː ɾʲ iː
com	k ʌ mˠ
iargúil	ˈj i ə ɾˠ ə ɡ u lˠ
gaige	ˈɡ a ɟ ɪ
feic	fʲ ɛ c
sealg	ˈʃ a l̪ˠ ə ɡ
aithinne	ˈæ h ə n̠ʲ ə
ísliú	ˈiː ʃ l̠ʲ u
mhac	vˠ ɑ k
tiarnas	ˈtʲ i ə ɾˠ n̪ˠ ə sˠ
fíoraíocht	fʲ iː ˈɾˠ i ə x t̪ˠ
d'astaigh	ˈd̪ˠ ɑ sˠ t̪ˠ ə
fan	fˠ a nˠ
leoraís	lʲ ɔ ɾˠ iː sˠ
tíortha	ˈtʲ iː ɾˠ h ə
sliabh	ʃ lʲ i ə vˠ
cúramach	ˈk uː ɾˠ ə mˠ ə x
cuinneog	k ɪ ˈɲ oː ɡ
lúthchleasaí	ˌl̪ˠ uː ç lʲ a ˈsˠ iː
lig	ˈl̠ʲ ɪ ɟ
dhearnadar	ˈj aː ɾˠ n̪ˠ ə d̪ˠ ə ɾˠ
oíche	ˈiː h ə
cleite	ˈc lʲ ɛ tʲ ə
eadhon	aː n
nífidh	ˈn̠ʲ iː h ə
cosán	k ə ˈsˠ ɑː n̪ˠ
feiceálach	ˈfʲ ɛ c a lˠ a x
leitean	ˈl̠ʲ ɛ tʲ ə nˠ
gustal	ˈɡ ʊ sˠ t̪ˠ ə l̪ˠ
cnagadh	ˈk n̪ˠ ɑ ɡ ə
Carghais	k ɑ ˈɾˠ iː ʃ
scaoileadh	ˈsˠ k iː lʲ ə
tuaighe	t̪ˠ u ə j
móide	ˈmˠ oː dʲ ə
bagairt	ˈbˠ a ɡ ə ɾˠ tʲ
asatsa	ˈɑ sˠ ə t̪ˠ sˠ ə
gcloich	ɡ l̪ˠ ɞ h
cíocras	ˈc iː k ɾˠ ə sˠ
báistigh	ˈbˠ ɑː ʃ tʲ ɪ ɟ
rr	ɾˠ
gá	ɡ ɑː
guite	ˈɡ ɪ tʲ ə
d'fhág	d̪ˠ ɑː ɡ
asamsa	ˈa sˠ ə mˠ sˠ ə
toilteanas	ˈt̪ˠ ɔ l̠ʲ tʲ ə nˠ ə sˠ
teilg	ˈtʲ ɛ lʲ ɪ ɟ
ruóg	ˈɾˠ uː oː ɡ
comharsanna	ˈk uː ɾˠ sˠ ə n̪ˠ iː
aistrím	a ʃ ˈtʲ rʲ iː mʲ
Alba	ˈa l̪ˠ ə bˠ ə
crích	c ɾʲ iː ç
lobhadh	ˈl̪ˠ ɔ . u
póg	pˠ oː ɡ
fhréimh	rʲ eː vʲ
eile	ˈɛ lʲ ə
donna	ˈd̪ˠ ɔ n̪ˠ ə
séan	ʃ eː nˠ
ranna	ˈɾˠ a n̪ˠ ə
éadach	ˈi a̯ d̪ˠ ə x
bhfaide	ˈw a dʲ ə
bus	bˠ ʊ sˠ
láib	l̪ˠ ɑː bʲ
tuill	ˈt̪ˠ iː l̠ʲ
slabhra	ˈsˠ l̪ˠ a u ɾˠ u
coigríoch	ˌk ɔ ɟ ɪ ˈɾʲ iː x
shleamhnaigh	ˈh lʲ ə u n̪ˠ ə
fionnuacht	ˈfʲ ɨ̞ n̪ˠ w a x t̪ˠ
téad	tʲ i a d̪ˠ
Brasaíl	bˠ ɾˠ a ˈsˠ iː lʲ
cearrbhach	ˈc a ɾˠ w a x
tuilleadh	ˈt̪ˠ ɪ lʲ ə
scamhán	ˈsˠ k ã u w a nˠ
tráthchlár	ˈt̪ˠ ɾˠ ɑː ˌx l̪ˠ ɑː ɾˠ
díleá	dʲ iː ˈlʲ aː
nglacfá	ŋ l ɑ k ˈf ɑː
bruithne	ˈbˠ ɾˠ ɪ h nʲ ə
buaf	bˠ u ə fˠ
binde	ˈbʲ ɪ n̠ʲ dʲ ə
pras	pˠ ɾˠ ɑ sˠ
beanna	ˈbʲ a n̪ˠ ə
lámhacán	ˈl̪ˠ ãː w ə k a nˠ
scóip	sˠ k oː pʲ
fiáin	ˈfʲ i ə nʲ
chruit	x ɾˠ ɪ tʲ
saothraigh	ˈsˠ iː ɾˠ ə
saoire	ˈsˠ iː ɾʲ ə
beithígh	bʲ ɛ ˈh iː ɟ
tréidlia	ˈtʲ ɾʲ eː dʲ lʲ i ə
bhíothadh	ˈvʲ iː uː
scéala	ˈʃ c eː lˠ ə
ármhach	ˈaː ɾˠ w a x
sula	ˈsˠ ʊ lˠ ə
ionamsa	ˈɪ n̪ˠ ə mˠ sˠ ə
reilig	ˈɾˠ ɪ lʲ ɪ ɟ
doimhneacht	ˈd̪ˠ iː nʲ ə x t̪ˠ
chúl	x uː l̪ˠ
phinc	fʲ ɪ ɲ c
adhairce	ˈə i ɾʲ c ɪ
meaits	mʲ a tʲ ʃ
tarta	ˈt̪ˠ a ɾˠ t̪ˠ ə
achasán	ˈa h a sˠ a nˠ
baoch	bˠ eː x
soilse	ˈsˠ iː lʲ ʃ ə
fuirseadh	ˈfˠ ɔ ɾˠ sˠ u
taithí	t̪ˠ a ˈh iː
tiomáint	tʲ ɪ ˈm ɑː n̠ʲ tʲ
saoir	sˠ iː ɾʲ
goidtear	ˈɡ ɛ tʲ ə ɾˠ
fodhuine	ˈfˠ ɔ ɣ ɪ nʲ ə
cathaoir	k a ˈh iː ɾʲ
fheiceadh	ˈɛ c ə x
libhse	ˈlʲ ɪ vʲ ʃ ə
deifre	ˈdʲ ɛ fʲ rʲ ə
Iodáil	ə ˈd̪ˠ ɑː lʲ
Rúis	ɾˠ uː ʃ
feasta	ˈfʲ a sˠ t̪ˠ ə
coisíocht	k ə ˈʃ i ə x t
measa	ˈmʲ a sˠ ə
libh	lʲ ɪ vʲ
súil	sˠ uː lʲ
géig	ɟ eː ɟ
droma	ˈd̪ˠ ɾˠ ɔ mˠ ə
ceas	c a sˠ
sleagh	ʃ l̠ʲ ɨ̞ ɡ
suíonn	sˠ iː n̪ˠ
traidisiún	t̪ˠ ɾˠ a dʲ ə ˈʃ uː n̪ˠ
portaireacht	ˈpˠ ɔ ɾˠ t̪ˠ ə ɾʲ ə x t̪ˠ
céibh	c eː vʲ
praiseach	pˠ ɾˠ ə ˈʃ a x
néal	nʲ iː a̯ l̪ˠ
cuirir	ˈk ɪ ɾʲ ə ɾʲ
éistim	ˈeː ʃ tʲ ə mʲ
tsín	tʲ iː nʲ
dúr	d̪ˠ uː ɾˠ
bláthnaid	ˈbˠ l̪ˠ ɑː n̪ˠ ə dʲ
ng	ŋ
litre	ˈl̠ʲ i tʲ ɾʲ ə
dheora	ˈj oː ɾˠ ə
trua	t̪ˠ ɾˠ u ə
freastal	ˈfʲ ɾʲ a sˠ t̪ˠ ə lˠ
míshásta	ˈmʲ iː h ɑː sˠ t̪ˠ ə
damhsaigh	ˈd̪ˠ a u sˠ ə
buile	ˈbˠ ɪ lʲ ə
sníomhtha	ˈʃ n̠ʲ iː w h ə
lenár	ˈlʲ ɛ nˠ ɑː ɾˠ
léachtóir	l̠ʲ eː x ˈt̪ˠ oː ɾʲ
leapa	ˈlʲ a pˠ ə
cacht	k a x t̪ˠ
dligh	dʲ lʲ ɪ ɟ
olann	ˈɔ l̪ˠ ə n̪ˠ
maidine	ˈmˠ æ dʲ ə nʲ ə
Laighin	l̪ˠ ə i nʲ
geilt	ɟ ɛ lʲ tʲ
athleagadh	ˈæ lʲ ɨ̞ ɡ u
tairngreacht	ˈt̪ˠ a ɾˠ ɡ ə ɾʲ a x t̪ˠ
éadóchas	i a̯ ˈd̪ˠ oː x ə sˠ
haige	ˈh a ɟ ɪ
fliuchlach	ˈfʲ lʲ ɨ̞ x lˠ a x
d'altadh	ˈd̪ˠ a l̪ˠ t̪ˠ ə x
baineannach	ˈbˠ a nʲ ə nˠ ə x
phearsana	ˈfʲ a ɾˠ sˠ ə nˠ ə
meana	ˈmʲ a n̪ˠ ə
mheas	vʲ a sˠ
ciúine	ˈc uː nʲ ə
siadsan	ˈʃ i ə d̪ˠ s ə nˠ
ionga	ˈuː ŋ ə
mur	mˠ ə ɾˠ
cuisle	ˈk ɪ ʃ l̠ʲ ə
fill	fʲ iː lʲ
hóbair	ˈh oː bˠ ə ɾʲ
glóir	ɡ lˠ oː ɾʲ
sanasán	sˠ ɑ n̪ˠ ə ˈsˠ ɑː n̪ˠ
plúr	pˠ lˠ uː ɾˠ
áirím	ɑː ˈɾʲ iː mʲ
síofra	ˈʃ iː fˠ ɾˠ ə
ceantar	ˈc ɑ u n̪ˠ t̪ˠ ə ɾˠ
tacht	t̪ˠ ɑ x t̪ˠ
sliasad	ˈʃ lʲ i ə sˠ ə d̪ˠ
álainn	ˈɑː l̪ˠ ɪ ɲ
faide	ˈfˠ ɪ dʲ ə
cruithneacht	ˈk ɾˠ ɪ h nʲ ə x t̪ˠ
chuain	x u ə nʲ
phósfadh	ˈfˠ oː sˠ ə x
leice	ˈl̠ʲ ɛ c ɪ
leac	l̠ʲ a k
diúic	dʲ uː c
ceirtlín	ˈc a ɾˠ h l̠ʲ i nʲ
feirge	ˈfʲ ɛ ɾʲ ɪ ɟ ɪ
lofa	ˈl̪ˠ ɔ fˠ ə
bréig	bʲ ɾʲ eː ɟ
ceanna	ˈc a n̪ˠ ə
cáin	k ɑː nʲ
aprún	ə ˈpˠ ɾˠ uː n̪ˠ
spalptha	ˈsˠ pˠ a l p iː
minc	mʲ ɪ ɲ c
tiús	tʲ uː sˠ
comórtas	k ə ˈmˠ oː ɾˠ t̪ˠ ə sˠ
Mumhan	mˠ uː nˠ
meil	mʲ ɛ lʲ
dT	d̪ˠ
siamsa	ˈʃ iː mˠ sˠ ə
Pheadar	ˈfʲ a d̪ˠ ə ɾˠ
uaibh	w æ bʲ
mhéadar	ˈvʲ eː d̪ˠ ə ɾˠ
bheo	vʲ oː
níos	n̠ʲ iː sˠ
Shligigh	ˈh lʲ ɪ ɟ iː
colúr	k ɔ ˈl̪ˠ uː ɾˠ
ceannann	ˈc a n̪ˠ ə n̪ˠ
lenarb	ˈlʲ ɛ nˠ ə ɾˠ bˠ
aiteann	ˈæ tʲ ə n̪ˠ
bhfoirgneamh	ˈvˠ ɔ ɾʲ ɪ ɟ ə nʲ ə vˠ
Volaifis	w ɔ l̪ˠ ə fʲ ɪ ʃ
tairg	ˈt̪ˠ a ɾʲ ɪ ɟ
fionnán	ˈfʲ a n̪ˠ a nˠ
moll	mˠ ʌ l̪ˠ
fiche	ˈfʲ ɪ h ə
ghaibh	ɣ a vʲ
cárb	k aː ɾˠ bˠ
babhta	ˈbˠ ɑ u t̪ˠ ə
dearbhaigh	ˈdʲ ɛ ɾʲ fʲ ə
céard	c eː ɾˠ d̪ˠ
brise	ˈbʲ ɾʲ ɪ ʃ ə
fá	fˠ aː
chuán	x uː ˈɑː n̪ˠ
fáidheanna	ˈfˠ aː j ə n̪ˠ i
abhann	ə u n̪ˠ
draein	d̪ˠ ɾˠ eː nʲ
gceantar	ˈɟ ɑ u n̪ˠ t̪ˠ ə ɾˠ
ré	rˠ eː
ise	ˈɪ ʃ ə
bolscaire	ˈbˠ ɔ l̪ˠ sˠ k ə rʲ ə
aoiligh	ˈiː lʲ ɪ ɟ
obann	ˈɔ bˠ ə n̪ˠ
blas	bˠ l̪ˠ ɑ sˠ
lámh	l̪ˠ ɑː vˠ
fiú	fʲ uː
cheana	ˈh a n̪ˠ ə
thuiscint	ˈh ɪ ʃ c ɪ n̠ʲ tʲ
aneas	ə ˈn̠ʲ a sˠ
aireachtáil	a ɾʲ ə x ˈt̪ˠ ɑː lʲ
bunaitheoir	ˌbˠ u nˠ ə ˈh oː ɾʲ
céasadh	ˈc i a̯ sˠ ə
craein	k ɾˠ eː nʲ
áladh	ˈa lˠ u
colbha	ˈk ɔ lˠ ə w ə
sneachta	ˈʃ nʲ a x t̪ˠ ə
zae	z eː
uí	iː
fola	ˈfˠ ɔ lˠ ə
chléibh	ç lʲ eː vʲ
amaideach	ˈɑ mˠ ə dʲ ə x
dtithe	ˈdʲ ɪ h ɪ
nite	ˈnʲ ɪ tʲ ə
scadán	sˠ k ə ˈd̪ˠ ɑː n̪ˠ
ciontaí	ˈc ɨ̞ n̪ˠ t̪ˠ i
seandraoi	ʃ ɑ u n̪ˠ ˈd̪ˠ ɾˠ iː
árthach	ˈɑː ɾˠ h ə x
slog	ˈsˠ l̪ˠ ɔ ɡ
abairt	ˈa bˠ ə ɾˠ tʲ
pardún	pˠ ɑː ɾˠ ˈd̪ˠ uː n̪ˠ
caoi	k eː
Bolcán	b ə l̪ˠ ˈk ɑː n̪ˠ
hail	h a lʲ
snoí	sˠ n̪ˠ iː
cneasú	ˈc ɾʲ a sˠ u
Gaeilge	ˈɡ eː lʲ ɟ ɪ
meallfaidh	ˈmʲ a u l̪ˠ h ə
gíotáil	ɟ iː ˈt̪ˠ ɑː lʲ
gránaigh	ˈɡ ɾˠ ɑː n̪ˠ ɪ ɟ
feargach	ˈfʲ a ɾˠ ə ɡ ə x
leanfaidh	ˈl̠ʲ a nˠ h ə
fágfaidh	ˈfˠ ɑː k ə
stopallán	sˠ t̪ˠ ɔ p ə ˈl̪ˠ ɑː n̪ˠ
céir	c eː ɾʲ
dlite	ˈdʲ lʲ ɪ tʲ ə
brúim	bˠ ɾˠ uː mʲ
bruite	ˈbˠ ɾˠ ɪ tʲ ə
piléar	pʲ ə ˈlʲ eː ɾˠ
múchadh	ˈmˠ uː x ə
treabhfaidh	ˈtʲ ɾʲ oː w h ə
scragall	ˈsˠ k ɾˠ a ɡ ə l̪ˠ
coitianta	k ə ˈtʲ i ə n̪ˠ t̪ˠ ə
fáinne	ˈfˠ ɑː ɲ ə
bhig	vʲ ɪ ɟ
tsléibh	tʲ lʲ eː vʲ
saorann	ˈsˠ eː ɾˠ ə n̪ˠ
haer	h eː ɾˠ
mearbhall	ˈmʲ a ɾˠ ə w ə l̪ˠ
gránna	ˈɡ ɾˠ ɑː n̪ˠ ə
culaithe	ˈk ʊ lˠ ɪ h ə
thuas	h u ə sˠ
fáisc	ˈfˠ ɑː ʃ c
collach	k ə ˈl̪ˠ ɑ x
ionas	ˈɯ n̪ˠ ə sˠ
machnamh	ˈmˠ ɑ x n̪ˠ ə vˠ
sách	sˠ ɑː x
amhlánta	ˈa u lˠ a n̪ˠ t̪ˠ ə
dil	ˈdʲ ɪ lʲ
scéal	sˠ c i a l̪ˠ
nóin	n̪ˠ oː nʲ
uath	u ə h
Seáin	ʃ ɑː nʲ
Lúnasa	ˈl̪ˠ uː n̪ˠ ə sˠ ə
sinsir	ˈʃ iː n̠ʲ sʲ ə ɾʲ
Eastóinis	ˈa sˠ tˠ oː nʲ ɪ ʃ
beithir	ˈbʲ ɛ h ə ɾʲ
glúine	ˈɡ l̪ˠ uː nʲ ə
Diarmaid	ˈdʲ i ə ɾˠ mˠ ə dʲ
Blarna	ˈbˠ lˠ ɑː ɾˠ n̪ˠ ə
tí	tʲ iː
imím	ɪ ˈmʲ iː mʲ
luachair	l̪ˠ u ə x ə ɾʲ
námhaid	ˈn̪ˠ aː w ə dʲ
Ll	l̪ˠ
gorach	ˈɡ ɔ ɾˠ ə x
bíodh	bʲ iː x
íosfaidh	ˈiː s iː
duid	d̪ˠ ɪ dʲ
fhéidir	ˈeː dʲ ə ɾʲ
bacaí	bˠ ə ˈk iː
luchóg	l̪ˠ ʊ ˈx oː ɡ
Cincís	c ɪ ɲ ˈc iː ʃ
oisir	ˈɔ ʃ ɪ ɾʲ
dícheall	ˈdʲ iː ç ə l̪ˠ
bruach	bˠ ɾˠ u ə x
gafa	ˈɡ a fˠ ə
leaga	ˈl̠ʲ a ɡ ə
leithne	ˈl̠ʲ ɪ h nʲ ə
trealamh	ˈtʲ ɾʲ a lˠ ə vˠ
giob	ɟ ɪ bˠ
drochaoibh	ˈd̪ˠ ɾˠ ɔ x iː vʲ
mbó	m oː
feirg	ˈfʲ ɛ ɾʲ ɪ ɟ
bruith	ˈbˠ ɾˠ ɪ fʲ
d'fhonn	d̪ˠ ə u n̪ˠ
einsímeach	ɛ nʲ ˈʃ iː mʲ ə x
fánach	ˈfˠ ɑː nˠ ə x
ghním	nʲ iː mʲ
cánacha	ˈk ɑː n̪ˠ ə x ə
buinneán	ˈbˠ ɪ n̠ʲ a nˠ
cearnóg	c aː ɾˠ ˈn̪ˠ oː ɡ
guíochtaint	ˈɡ iː ə x t̪ˠ ə nʲ tʲ
dhímheas	ˈj ĩː vʲ a sˠ
tréigthe	ˈtʲ ɾʲ eː c ɪ
dúch	d̪ˠ uː x
treascair	ˈtʲ rʲ a sˠ k ə ɾʲ
giuirléid	ɟ uː ɾˠ ˈlʲ eː dʲ
scríob	sˠ c ɾʲ iː bˠ
toircheas	ˈt̪ˠ ɔː ɾˠ h i sˠ
leas	l̠ʲ a sˠ
chun	x ɪ nʲ
beár	bʲ aː ɾˠ
cruinneál	ˈk ɾˠ ɪ n̠ʲ ɑː l̪ˠ
deasú	dʲ a ˈsˠ uː
ruainne	ˈɾˠ u ə n̠ʲ ə
dearmadacha	ˈdʲ a ɾˠ mˠ ə d̪ˠ ə x
soir	sˠ ɪ ɾʲ
uair	u ə ɾʲ
deichniúr	ˈdʲ ɪ n̠ʲ uː ɾˠ
ábalta	ˈɑː bˠ ə l̪ˠ t̪ˠ ə
braillín	bˠ ɑ ɾʲ ˈlʲ iː nʲ
caillfidh	ˈk æ l̠ʲ h ə
ghníomh	j nʲ iː vˠ
eitleáin	ɛ tʲ ə ˈlʲ ɑː nʲ
criadh	c ɾʲ i ə
geis	ɟ ɛ ʃ
teachtaire	ˈtʲ a x t̪ˠ ə ɾʲ ə
Gaedhlaing	ˈɡ eː l ɪ ɲ
leanúint	ˈl̠ʲ a nˠ u n̠ʲ tʲ
múnla	ˈmˠ uː n̪ˠ l̪ˠ ə
tsúil	t̪ˠ uː lʲ
airigh	ˈa ɾʲ ɪ ɟ
file	ˈfʲ ɪ lʲ ə
uafásach	ˈuː h ɑː sˠ ə x
sleán	ʃ lʲ ɑː n̪ˠ
ph	fˠ
sobal	ˈsˠ ɔ bˠ ə lˠ
feolmhach	ˈfʲ ɔː lˠ w a x i
airím	a ˈɾʲ iː mʲ
tóirse	ˈt̪ˠ oː ɾˠ ʃ ə
dtailte	ˈd̪ˠ a l̠ʲ tʲ ə
áitiú	ɑː ˈtʲ uː
bruscar	ˈbˠ ɾˠ ʊ sˠ k ə ɾˠ
átha	aː
cór	k oː ɾˠ
Bolcáin	b ə l̪ˠ ˈk ɑː nʲ
díth	dʲ iː
foide	ˈfˠ ɛ dʲ ə
ciúnas	ˈc uː nˠ ə sˠ
éanlaith	ˈeː nˠ lˠ ə
sparán	sˠ pˠ ə ˈɾˠ ɑː nˠ
forc	fˠ o ɾˠ k
luí	l̪ˠ iː
áitithe	ˈɑː tʲ ɪ h ə
áthas	ˈɑː h ə sˠ
tuir	t̪ˠ ɪ ɾʲ
dreach	dʲ ɾʲ a x
bhfear	vʲ a ɾˠ
méadar	ˈmʲ eː d̪ˠ ə ɾˠ
clogad	ˈk l̪ˠ ɔ ɡ ə d̪ˠ
paiste	ˈpˠ a ʃ tʲ ə
lasta	ˈl̪ˠ a sˠ t̪ˠ ə
cluich	k lˠ ɪ ç
seod	ʃ ɔ d̪
aiteach	ˈa tʲ ə x
ceoch	c oː x
fhiacha	ˈi ə x ə
tsnua	t̪ˠ n̪ˠ uː ə
faiteach	ˈfˠ a tʲ ə x
sothuigthe	ˈsˠ ɔ ˌh ɪ c ɪ
deacair	ˈdʲ a k ə ɾʲ
marc	mˠ a ɾˠ k
Máire	ˈmˠ ɑː ɾʲ ə
clampar	ˈk lˠ a mˠ pˠ ə ɾˠ
ceirnín	ˈc ɛ ɾˠ n̠ʲ iː nʲ
dhreas	j ɾʲ a sˠ
Ocsatánais	ˈɔ k s ə tˠ aː nˠ ɪ ʃ
dhíbh	j iː vʲ
asaibhse	ˈa sˠ ə vʲ ʃ ə
méalach	ˈmʲ eː lˠ ə x
éirím	ə i ˈɾʲ iː mʲ
gor	ɡ ɔ ɾˠ
cuirfidh	ˈk ɪ ɾʲ h ə
carraig	ˈk ɑ ɾˠ ɪ ɟ
mallaigh	ˈmˠ ɑ l̪ˠ ɪ ɟ
moill	mˠ iː lʲ
maireann	ˈmˠ ɛ ɾʲ ə n̪ˠ
toghtar	ˈt̪ˠ ɨ̥ tʲ ə ɾˠ
bhéarfadh	ˈvʲ eː ɾˠ ə tʲ
cruitchlár	ˈk ɾˠ ɪ tʲ ˌx lˠ ɑː ɾˠ
teannaim	ˈtʲ a n̪ˠ ə mˠ
thithe	ˈh ɪ h ɪ
aiste	ˈa ʃ tʲ ə
páirc	pˠ aː ɾʲ c
pianadh	ˈpʲ i ə nˠ ə
tuairisc	ˈt̪ˠ u ə ɾʲ ɪ ʃ c
marfach	ˈmˠ ɑ ɾˠ ə fˠ ə x
mairbh	ˈmˠ ɑ rʲ ə vʲ
monarc	ˈmˠ ɔ nˠ ə ɾˠ k
fíon	fʲ iː nˠ
Tuircis	ˈt̪ˠ ʊ ɾʲ c ɪ ʃ
praistéal	ˈpˠ ɾˠ æ ʃ tʲ a lˠ
mórachas	ˈmˠ ʌ rˠ a x ə sˠ
cruitíneach	k ɾˠ ə ˈtʲ iː nʲ ə x
arc	a ɾˠ k
capall	ˈk a pˠ ə l̪ˠ
cumtha	ˈk uː mˠ h ə
feamainn	ˈfʲ a mˠ ə n̠ʲ
bratach	ˈbˠ ɾˠ ɑ t̪ˠ ə x
deisceabal	ˈdʲ ɛ ʃ c ə bˠ ə lˠ
gcomhluadar	ˈɡ oː lˠ u ə d̪ˠ ə ɾˠ
aiteannach	ˈæ tʲ ə nˠ a x
otair	ˈɔ t̪ˠ ə ɾʲ
santach	ˈsˠ a i nʲ tʲ ə x
cuimil	ˈk ɪ mʲ ə lʲ
air	a ɾʲ
Veinéis	vʲ ə ˈnʲ eː ʃ
balla	ˈbˠ ɑ l̪ˠ ə
righ	ɾˠ ɪ ɟ
India	ˈɪ nʲ dʲ i ə
feadóg	ˈfʲ a d̪ˠ oː ɡ
ceannaigh	ˈc a n̪ˠ ə ɟ
damhsa	ˈd̪ˠ ə u sˠ ə
mothaítear	ˈmˠ ɔ tʲ ə ɾˠ
saibhir	ˈsˠ ɛ vʲ ə ɾʲ
arsa	ˈa ɾˠ sˠ ə
buail	bˠ u ə lʲ
aontaigh	ˈeː n̪ˠ t̪ˠ ɪ ɟ
milis	ˈmʲ ɪ lʲ ə ʃ
maorga	ˈmˠ eː ɾˠ ɡ ə
caoiche	ˈk iː ç ə
meirg	ˈmʲ ɛ ɾʲ ɪ ɟ
ualach	ˈu ə l̪ˠ ə x
fuiliceach	ˈfˠ ɪ lʲ ɪ c ə x
muinín	mˠ ɪ ˈnʲ iː nʲ
neamart	ˈn̠ʲ a mˠ ɔ ɾˠ t̪ˠ
ceannasaí	c a n̪ˠ ə ˈsˠ iː
dtóireacha	ˈd̪ˠ oː ɾʲ ə x ə
éalóim	ˈeː lˠ o i̯ mˠ
dínne	ˈdʲ iː n̠ʲ ə
beinn	bʲ e i n̠ʲ
nigh	n̠ʲ iː
righin	ɾˠ iː nʲ
Eoghan	oː n̪ˠ
difríocht	ˈdʲ ɪ fʲ ɾʲ i ə x t̪ˠ
aischuir	ˈa ʃ ˌx ɪ rʲ
spúnóg	sˠ pˠ uː ˈn̪ˠ oː ɡ
bailigh	ˈbˠ a lʲ ɪ ɟ
seasamh	ˈʃ a sˠ ə vˠ
ráit	ˈɾˠ aː tʲ
dlíthiúil	dʲ lʲ iː ˈh uː lʲ
bearaigh	ˈbʲ ɛ ɾˠ i
muintir	ˈmˠ iː n̠ʲ tʲ ə ɾʲ
fead	fʲ a d̪ˠ
cloich	k l̪ˠ ɞ h
ocras	ˈɔ k ə ɾˠ ə sˠ
toirnéis	t̪ˠ oː ɾˠ ˈn̠ʲ eː ʃ
Ph	fˠ
tomacha	ˈt̪ˠ ʌ mˠ ə x iː
meas	mʲ a sˠ
tharraing	ˈh a ɾʲ ɪ ɟ
túisce	ˈt̪ˠ uː ʃ c ɪ
urchuil	ˈʌ ɾˠ x ə l̪ˠ
péinteáil	pʲ eː nʲ ˈtʲ aː lʲ
bliosán	bʲ lʲ ə ˈsˠ ɑː n̪ˠ
eanglach	ˈɨ̞ ŋ lˠ a x
síth	ʃ iː
chara	ˈx ɑ ɾˠ ə
cloch	k l̪ˠ ɞ x
snámhaim	ˈsˠ n̪ˠ aː w ə mˠ
glór	ɡ lˠ oː ɾˠ
siúinéara	ˈʃ uː nʲ eː ɾˠ ə
beag	bʲ ɞ ɡ
tiarna	ˈtʲ i ə ɾˠ n̪ˠ ə
dorchacht	ˈd̪ˠ ɔ ɾˠ ə x ə x t̪ˠ
leic	l̠ ɛ c
éirí	ˈə i ɾʲ iː
smuga	ˈsˠ mˠ ʊ ɡ ə
ainmhí	a nʲ ə ˈvʲ ĩː
ndearnadar	ˈn̠ʲ aː ɾˠ n̪ˠ ə d̪ˠ ə ɾˠ
faraor	fˠ a ˈɾˠ iː ɾˠ
scoitheadh	ˈs k a h u
rúsc	ɾˠ uː sˠ k
Conamara	ˌk ʊ n̪ˠ ə ˈm a ɾˠ ə
crodh	ˈk ɾˠ ʊ h
chrup	x ɾˠ ʌ pˠ
adhaltranas	ˈiː l̪ˠ t̪ˠ ɾˠ ə nˠ ə sˠ
sluaigh	sˠ l̪ˠ u ə ɟ
fuaim	fˠ u ə mʲ
cuirid	ˈk ɪ ɾʲ ə dʲ
sinne	ˈʃ ɪ n̠ʲ ə
gnó	ɡ n̪ˠ oː
inti	ˈɪ n̠ʲ tʲ ə
scuabadh	ˈsˠ k u ə bˠ ə
mbrata	ˈmˠ ɾˠ a t̪ˠ ə
Chonnachta	ˈx ɔ n̪ˠ ə x t̪ˠ ə
leag	l̠ʲ a ɡ
chor	x ɔ ɾˠ
háidí	ˈh aː d iː
mart	mˠ a ɾˠ tˠ
cealgfaidh	ˈc a l̪ˠ ə k ə
fhírinne	ˈiː ɾʲ ɪ ɲ ɪ
gheala	ˈj a lˠ ə
samhnas	ˈsˠ ã u nˠ ə sˠ
otharlann	ˈɔ h ə ɾˠ l̪ˠ ə nˠ
buan	bˠ u ə n̪ˠ
adaí	ˈa d̪ˠ i
Tibéidis	tʲ ə ˈbʲ eː dʲ ə ʃ
goilfidh	ˈɡ ɪ lʲ h ə
déag	dʲ eː ɡ
siabann	ˈʃ i ə bˠ ə n̪ˠ
abar	ˈa bˠ ə ɾˠ
chuiris	ˈx ɪ ɾʲ ə ʃ
síolmhar	ˈʃ iː l̪ˠ vˠ ə ɾˠ
curtha	ˈk ʌ ɾˠ h ə
piobar	ˈpʲ ɯ bˠ ə ɾˠ
blás	ˈbˠ lˠ ɑː sˠ
biolar	ˈbʲ ɪ l ə ɾˠ
tógaim	ˈt̪ˠ oː ɡ ə mʲ
fireann	ˈfʲ ɪ ɾʲ ə n̪ˠ
téagarthach	ˈtʲ eː ɡ ə ɾˠ a x
guaillí	ˈɡ u ə l̠ʲ iː
imigh	ˈɪ mʲ ɪ ɟ
baois	bˠ iː ʃ
urchar	ˈʊ ɾˠ ə x ə ɾˠ
ois	ɪ ʃ
modhúil	ˈmˠ ʌ w ə lʲ
bhfaigheas	w ɑː sˠ
lomfad	ˈl̪ˠ ɑ u mˠ h ə d̪ˠ
cófra	ˈk oː ɾˠ h ə
cím	ˈc iː mʲ
prioslaire	ˈpʲ ɾʲ ɪ sˠ l̪ˠ ə ɾʲ ə
atá	ə ˈt̪ˠ ɑː
airíoch	ˈæ ɾʲ i a x
críonna	ˈc ɾʲ iː n̪ˠ ə
breathnaím	ˈbʲ ɾʲ a n̪ˠ iː mʲ
teoiric	ˈtʲ oː ɾʲ ɪ c
cuibhrinn	ˈk ɪ vʲ ɾʲ ə n̠ʲ
hurais	ˈh ʊ ɾˠ ə ʃ
seachas	ˈʃ a x ə sˠ
féile	ˈfʲ eː lʲ ə
cogal	ˈk ɔ ɡ ə l̪ˠ
thura	ˈh ʊ ɾˠ ə
deire	ˈdʲ ɛ ɾʲ ə
baol	bˠ eː l̪ˠ
dearthár	dʲ ɾʲ ə ˈh aː ɾˠ
domh	d̪ˠ ʊ̃ h
cothrom	ˈk ɔ h ɾˠ ə mˠ
ngreadadh	ˈɲ ɾʲ a d̪ˠ u
hair	h a ɾʲ
adhnaic	ˈə i n̪ˠ ə c
laidhre	ˈl̪ˠ ə i ɾʲ ə
féich	fʲ eː ç
corraigh	ˈk ɔ ɾˠ ɪ ɟ
gnóthachtáil	ˈɡ ɾˠ uː x t̪ˠ ɑː lʲ
faigheann	ˈfˠ ɑ j ə n̪ˠ
cuan	k u ə n̪ˠ
fír	fʲ iː ɾʲ
haithne	ˈh æ n̠ʲ ə
Críost	c ɾʲ iː sˠ t̪ˠ
trócaire	ˈt̪ˠ ɾˠ oː k ə ɾʲ ə
uaireadóir	u ə ɾʲ ə ˈd̪ˠ oː ɾʲ
dóchas	ˈd̪ˠ ɔ x ə sˠ
Caitríona	k a ˈtʲ ɾʲ iː n̪ˠ ə
eaglais	ˈa ɡ ə l̪ˠ ə ʃ
fadó	fˠ a ˈd̪ˠ oː
casfaidh	ˈk a sˠ ə
teagascóir	ˈtʲ a ɡ ə sˠ k oː ɾʲ
ndéanfaidh	ˈn̠ʲ aː nˠ h ə
sinsear	ˈʃ iː n̠ʲ sʲ ə ɾˠ
dlaoi	d̪ˠ l̪ˠ iː
bean	bʲ a n̪ˠ
cúngach	ˈk uː ŋ ɡ ə x
cúlriascach	ˈk uː lˠ ɾˠ eː s k a x
nó	n̪ˠ oː
cóngarach	ˈk oː ŋ ɡ ə ɾˠ ə x
lasadh	ˈl̪ˠ ɑ sˠ ə
díolfaidh	ˈdʲ i ə lˠ h ə
daingním	d̪ˠ a ɲ ɟ ə ˈnʲ iː mʲ
anamhaith	ˈɑ n̪ˠ ə vˠ ɑ h
sloinneadh	ˈsˠ l̪ˠ ɨ̞ n̠ʲ u
taga	ˈt̪ˠ a ɡ ə
fiacháil	ˈfʲ i a̯ x æ lʲ
pasta	ˈpˠ a sˠ t̪ˠ ə
tógaimid	ˈt̪ˠ oː ɡ ə mʲ ə dʲ
tríd	tʲ ɾʲ iː dʲ
ngréin	ɲ ɾʲ eː nʲ
gorm	ˈɡ ɔ ɾˠ ə mˠ
lem	lʲ ɛ mˠ
thoir	h ɛ ɾʲ
gránach	ˈɡ ɾˠ ɑː nˠ ə x
urramach	ˈʌ ɾˠ ə mˠ a x
ríúil	ɾˠ iː ˈuː lʲ
calma	ˈk a l̪ˠ ə mˠ ə
puball	ˈpˠ ʊ bˠ ə l̪ˠ
buíon	bˠ iː nˠ
moilt	mˠ ɪ lʲ tʲ
mhair	vˠ a ɾʲ
planda	p l̪ˠ a u n̪ˠ d̪ˠ ə
loscann	ˈl̪ˠ ɔ sˠ k ə n̪ˠ
Domhnaigh	ˈd̪ˠ uː n ə
buartha	ˈbˠ u ə ɾˠ h ə
maol	mˠ eː l̪ˠ
bhog	vˠ ɔ ɡ
tarcaisne	ˈt̪ˠ ɑ ɾˠ k ə ʃ nʲ ə
meilleog	mʲ ə ˈl̠ʲ oː ɡ
cheintiméadar	ç ɛ nʲ tʲ ə ˈmʲ eː d̪ˠ ə ɾˠ
sliogán	ʃ lʲ ə ˈɡ ɑ̃ː n̪ˠ
cosaint	ˈk ɔ sˠ ə n̠ʲ tʲ
beimid	ˈbʲ ɛ mʲ ə dʲ
chladhaire	ˈx l̪ˠ ɑ i ɾʲ ə
ceannaím	c a ˈn̪ˠ iː mʲ
lúbfad	ˈl̪ˠ uː pˠ ə d̪ˠ
nua	n̪ˠ oː
gairge	ˈɡ a ɾʲ ɪ ɟ ə
áth	ɑː
altán	ˈa l̪ˠ t̪ˠ ɑː n̪ˠ
geal	ɟ a l̪ˠ
ear	a ɾˠ
bán	bˠ ɑː n̪ˠ
cic	c ɪ c
bhfuair	vˠ u ə ɾʲ
éisteacht	ˈeː ʃ tʲ ə x t̪ˠ
barúil	bˠ ə ˈɾˠ uː lʲ
éadan	ˈeː d̪ˠ ə n̪ˠ
chéanna	ˈç iː a̯ n̪ˠ ə
faca	ˈfˠ a k ə
macra	ˈmˠ a k ɾˠ ə
fuiriste	ˈfʲ ɾʲ ɪ ʃ tʲ ə
gruaig	ɡ ɾˠ u ə ɟ
fuair	fˠ u ə ɾʲ
amhrasach	ˈɑ v ɾˠ ə sˠ ə x
anraith	ˈa n̪ˠ ɾˠ ə h
dúinn	d̪ˠ uː n̠ʲ
goidte	ˈɡ ɪ tʲ ə h ə
aclaí	ˈa k lˠ i
roithleán	ˈɾˠ ɨ̞ h lʲ a nˠ
pálás	pˠ ɑː ˈl̪ˠ ɑː sˠ
aigesan	ˈɛ ɟ ə sˠ ə n
úim	uː mʲ
glas	ɡ l̪ˠ ɑ sˠ
athraithe	ˈa h ɾˠ ɪ h ə
ógh	oː
tais	t̪ˠ a ʃ
dreoilín	dʲ ɾʲ oː ˈlʲ iː nʲ
fiuch	fʲ ɨ̞ x
ósna	ˈoː sˠ n̪ˠ ə
Eibhlín	ə i ˈlʲ iː nʲ
eireog	ˈeː ɾʲ ɔ ɡ
tS	t̪ˠ
againn	ə ˈɡ ɪ nʲ
síle	ˈʃ iː lʲ ə
céid	c eː dʲ
croíúil	k ɾˠ iː ˈuː lʲ
shín	h iː nʲ
níosa	ˈnʲ iː sˠ ə
neamhthuilleamaíoch	ˌn̠ʲ ã u ˈh i l̠ʲ ə mˠ i a x
spéir	sˠ pʲ eː ɾʲ
geise	ˈɟ ɛ ʃ ə
geit	ɟ ɛ tʲ
dearbhóchaidh	ˈdʲ a ɾˠ ə fˠ a x ə
séasúr	sˠ eː ˈsˠ uː ɾˠ
loing	l̪ˠ iː ɲ ɟ
brabúsach	bˠ ɾˠ a ˈbˠ uː sˠ ə x
ciceáil	c ɪ ˈc aː lʲ
láidre	ˈl̪ˠ ɑː dʲ ə ɾʲ ə
muidne	ˈmˠ ɪ dʲ nʲ ə
bróig	bˠ ɾˠ oː ɟ
miodóg	mʲ ɪ ˈd̪ˠ oː ɡ
luide	ˈl̪ˠ ɪ dʲ ə
lae	l̪ˠ eː
Éabha	ˈeː vˠ ə
scoláireacht	sˠ k ə ˈlˠ ɑː ɾʲ ə x t̪ˠ
caitheamh	ˈk a h ə v
colg	ˈk ɔ l̪ˠ ə ɡ
áitím	ɑː ˈtʲ iː mʲ
abaidh	ˈɑ bʲ ɪ ɟ
ollaimh	ˈɔ l̪ˠ ə vʲ
scriú	sˠ k ɾˠ uː
scriosta	ˈsˠ c ɾʲ ɨ̞ sˠ t̪ˠ ə
dreapaireacht	ˈdʲ ɾʲ a pˠ ə ɾʲ a x t̪ˠ
búch	bˠ uː x
sail	s a lʲ
pósaid	pˠ oː sˠ ə dʲ
bailithe	ˈbˠ a l iː
maireachtaint	ˈmˠ ɾˠ a x t̪ˠ ə nʲ tʲ
harc	h a ɾˠ k
caighdeánach	k ə i ˈdʲ aː n̪ˠ ə x
carball	ˈk a ɾˠ ə bˠ ə l̪ˠ
dár	d̪ˠ ɑː ɾˠ
bardasach	ˈbˠ ɑː ɾˠ d̪ˠ ə sˠ ə x
lonradh	ˈl̪ˠ ã ũ n̪ˠ ɾˠ ə
altú	ˈa l̪ˠ t̪ˠ u
neide	ˈn̠ʲ ɛ dʲ ə
cuileog	k ɪ ˈlʲ oː ɡ
seanchas	ˈʃ a n̪ˠ ə x ə sˠ
sciath	ʃ c i ə
cochán	k ə ˈx ɑː n̪ˠ
ceilg	ˈc ɛ lʲ ɪ ɟ
chugham	x uː mˠ
tóig	t̪ˠ oː ɟ
Gaeilic	ˈɡ eː lʲ ə c
tháinig	ˈh ɑː nʲ ɪ ɟ
dot	d̪ˠ ɔ t̪ˠ
oileadh	ˈɛ lʲ ə ɡ
cliathán	ˈc lʲ iː h a nˠ
gabháltas	ɡ ə ˈvˠ ɑː l̪ˠ t̪ˠ ə sˠ
fheicfeadh	ˈɛ c ə x
sioc	ʃ ʊ k
éilím	eː ˈlʲ iː mʲ
dísle	ˈdʲ iː ʃ l̠ʲ ə
aga	ˈa ɡ ə
linbhín	lʲ ɪ nʲ ə ˈvʲ iː nʲ
foghlaim	ˈfˠ oː l̪ˠ ɪ mʲ
ligh	lʲ ɪ ɟ
lus	l̪ˠ ʊ sˠ
shloinne	ˈh l̪ˠ ɪ n̠ʲ ə
méad	mʲ eː d̪ˠ
duan	d̪ˠ u ə n̪ˠ
cruinnigh	ˈk ɾˠ ɪ ɲ ɪ ɟ
seacht	ʃ a x t̪ˠ
aoi	iː
molta	ˈmˠ ɔ l̪ˠ t̪ˠ ə
iompaigh	ˈʊ mˠ pˠ ə
uaill	u ə l̠ʲ
díbríodh	dʲ iː ˈbʲ ɾʲ iː ɡ
shíl	h iː lʲ
bronntanas	ˈbˠ ɾˠ ɑ u n̪ˠ t̪ˠ ə n̪ˠ ə sˠ
tíolacthaí	ˈtʲ i ə l̪ˠ ə k i
meáite	ˈmʲ ɑː tʲ ə
chiúin	ç uː nʲ
féidir	ˈfʲ eː dʲ ə ɾʲ
madra	ˈmˠ a d̪ˠ ɾˠ ə
bhfadhb	vˠ ə i bˠ
maitheas	mˠ a h ə sˠ
eiteadha	ˈɛ tʲ uː
gamhnach	ˈɡ ã u n a x
feighil	fʲ ə i lʲ
suimiúil	sˠ ɪ ˈmʲ uː lʲ
miailíteas	ˈmʲ i ə lʲ iː tʲ ə sˠ
ciar	c i ə ɾˠ
géire	ˈɟ eː ɾʲ ə
aspal	ˈa sˠ pˠ ə lˠ
céibhe	ˈc eː vʲ ə
áras	ˈɑː ɾˠ ə sˠ
báire	ˈbˠ ɑː ɾʲ ə
bainfidh	ˈbˠ ɪ nʲ h ə
Dubhghus	ˈd̪ˠ uː ɣ u sˠ
bearrtha	ˈbʲ ɑː ɾˠ h ə
bándearg	ˈbˠ ɑː nˠ ˌdʲ a ɾˠ ə ɡ
burdún	bˠ uː ɾˠ ˈd̪ˠ uː n̪ˠ
tionscadal	ˈtʲ i n̪ˠ sˠ k ə d̪ˠ ə lˠ
deoir	dʲ oː ɾʲ
bhfaightear	ˈw a h a ɾˠ
nathair	ˈn̪ˠ ɑ h ə ɾʲ
gciliméadar	ɟ ɪ lʲ ə ˈmʲ eː d̪ˠ ə ɾˠ
tobann	ˈt̪ˠ ɔ bˠ ə n̪ˠ
réalta	ˈɾˠ eː l̪ˠ t̪ˠ ə
táille	ˈt̪ˠ ɑː lʲ ə
cardáil	k ɑː ɾˠ ˈd̪ˠ ɑː lʲ
ómáideach	ˈoː mˠ æ dʲ a x
neimhe	ˈn̠ʲ ɨ̞̃ vʲ ə
arís	ə ˈɾʲ iː ʃ
Fínín	fʲ iː ˈnʲ iː nʲ
Corcaigh	ˈk ɔ ɾˠ k ə ɟ
brúigh	bˠ ɾˠ uː ɟ
smionagar	ˈsˠ mʲ ɨ̞ nˠ ə ɡ ə ɾˠ
Páras	ˈpˠ ɑː ɾˠ ə sˠ
boird	bˠ oː ɾˠ dʲ
seachain	ˈʃ a x ə nʲ
osna	ˈɔ sˠ n̪ˠ ə
umhal	u ə l̪ˠ
mion	mʲ ɨ̞ n̪ˠ
desean	ˈdʲ ɛ ʃ ə n̪ˠ
cléibh	c lʲ eː vʲ
rámha	ɾˠ ɑ̃ː
uile	ˈɪ lʲ ə
cornadh	ˈk oː ɾˠ n̪ˠ ə
aibíd	ˈæ bʲ iː dʲ
ciseáin	c ɪ ˈʃ aː nʲ
geaitire	ˈɟ a tʲ ə ɾʲ ə
raithneach	ˈɾˠ æ h nʲ a x
ráthanna	ˈɾˠ aː x ə n̪ˠ i
airm	ˈɪ ɾʲ ə mʲ
mallacht	mˠ ə ˈl̪ˠ ɑ x t̪ˠ
déanaidís	ˈdʲ iː n ə dʲ iː ʃ
colla	ˈk ʌ l̪ˠ ə
spliota	ˈsˠ pʲ lʲ ɨ̞ t̪ˠ ə
bhfréimh	vʲ rʲ eː vʲ
deise	ˈdʲ ɛ ʃ ə
canfaidh	ˈk a nˠ h ə
cosúil	k ə ˈsˠ uː lʲ
tíor	tʲ iː ɾˠ
litear	ˈl̠ʲ ɪ tʲ ə ɾˠ
teora	ˈtʲ oː ɾˠ ə
monarcaí	mˠ ɔ nˠ ə ɾˠ ˈk iː
Chásca	ˈx ɑː sˠ k ə
candála	ˈk a n̪ˠ d̪ˠ ɑː l̪ˠ ə
orthusan	ˈɔ ɾˠ ə pˠ sˠ ə n
aer	eː ɾˠ
shínigh	ˈh iː nʲ ɪ ɟ
sealadach	ˈʃ a lˠ ə d̪ˠ ə x
agamsa	ˈa ɡ ə mˠ sˠ ə
alpán	ɑ l̪ˠ ˈpˠ ɑː n̪ˠ
domsa	ˈd̪ˠ ɔ mˠ sˠ ə
eolas	ˈoː lˠ ə sˠ
broc	bˠ ɾˠ ɔ k
thú	h uː
cuain	k u ə nʲ
aichear	ˈa ç ə ɾˠ
shéabraí	ˈh eː bˠ ɾˠ iː
casaoid	k ə ˈsˠ iː dʲ
maoin	mˠ iː nʲ
tarraing	ˈt̪ˠ a ɾʲ ɪ ɟ
fáilte	ˈfˠ ɑː lʲ tʲ ə
lic	l̠ʲ ɪ c
céibheanna	ˈc eː vʲ ə n̪ˠ iː
Rr	ɾˠ
litiam	ˈl̠ʲ ɪ tʲ i ə mˠ
fáilt	fˠ ɑː lʲ tʲ
ceárta	ˈc aː ɾˠ t̪ˠ ə
beirtear	ˈbʲ ɛ ɾʲ t ə ɾʲ
páiste	ˈpˠ ɑː ʃ tʲ ə
buíochán	bˠ i ə ˈx ɑː n̪ˠ
toghadh	ˈt̪ˠ a u . ə
faighinn	ˈfˠ a i ə n̠ʲ
banana	bˠ ə ˈn̪ˠ a n̪ˠ ə
toir	t̪ˠ ɛ ɾʲ
múinteoir	mˠ uː n̠ʲ ˈtʲ oː ɾʲ
théann	h eː n̪ˠ
eisceacht	ə ʃ ˈc a x t̪ˠ
foclóirí	fˠ ə ˈk l̪ˠ oː ɾʲ iː
fosclóchaidh	ˈfˠ ɔ sˠ k lˠ a x i
fraoch	fˠ ɾˠ eː x
paráistí	pˠ ə ˈɾˠ ɑː ʃ tʲ iː
bacadh	ˈbˠ ɑ k ə
fágáil	fˠ ɑː ˈɡ ɑː lʲ
mhéad	vʲ eː d̪ˠ
suime	ˈsˠ ɪ mʲ ə
chuig	x ɪ ɟ
cé	c eː
muirear	ˈmˠ ɪ ɾʲ ə ɾˠ
chailín	x a ˈlʲ iː nʲ
dhiúil	j uː lʲ
ceoltóir	c oː l̪ˠ ˈt̪ˠ oː ɾʲ
bheanna	ˈvʲ a n̪ˠ ə
sna	sˠ nˠ ə
d'fhágadh	ˈd̪ˠ ɑː ɡ ə x
teaghlach	ˈtʲ ə i ɫ̪ ə x
cléireach	ˈc lʲ eː ɾʲ ə x
frithir	ˈfʲ ɾʲ ɪ h ə ɾʲ
meáchan	ˈmʲ aː x ə nˠ
chrann	x ɾˠ a u n̪ˠ
blí	ˈbʲ lʲ i ə
tit	tʲ ɪ tʲ
athróidh	ˈɑ ɾˠ oː
crogall	ˈk ɾˠ ɔ ɡ ə l̪ˠ
théas	h eː sˠ
bheirid	ˈvʲ ɛ ɾʲ ə dʲ
ról	ɾˠ oː lˠ
dheinim	ˈj ɛ nʲ ɪ mʲ
ts	t̪ˠ
chiardhuibh	ˈç i ə ɾˠ ɣ ɪ vʲ
dhiaidh	j i ə ɟ
goid	ɡ ɛ dʲ
só	sˠ oː
cnámha	ˈk ɾˠ ãː w ə
úir	uː ɾʲ
sothuigsithe	ˈsˠ ɔː ˌh ɪ c ʃ i
saillfidh	ˈsˠ æ l̠ʲ h ə
caoile	ˈk iː lʲ ə
trínár	ˈtʲ ɾʲ iː nˠ ɑː ɾˠ
ndéanas	ˈn̠ʲ iː n ə sˠ
thogh	h eː
fhís	iː ʃ
dhona	ˈɣ ɔ n̪ˠ ə
fén	fʲ eː n̪ˠ
carbón	k ə ɾˠ ə ˈbˠ oː n̪ˠ
fága	ˈfˠ ɑː ɡ ə
Protastúnach	pˠ ɾˠ ɔ t̪ˠ ə sˠ ˈt̪ˠ uː n̪ˠ ə x
beacht	bʲ a x t̪ˠ
críochnaigh	ˈc ɾʲ iː x n̪ˠ ɪ ɟ
suaimhneach	ˈsˠ u ə nʲ ə x
guid	ɡ ɪ dʲ
anseo	ə n̪ˠ ˈʃ ɔ
adhlaic	ˈə i l̪ˠ ə c
bhean	vʲ a n̪ˠ
shnua	h n̪ˠ uː ə
id	ɪ d̪ˠ
Ceallach	c ə ˈl̪ˠ a x
ócáid	oː ˈk ɑː dʲ
dul	d̪ˠ ʊ lˠ
Doire	ˈd̪ˠ ɪ ɾʲ ə
fuinneoga	fˠ ɪ ˈɲ oː ɡ ə
mura	ˈmˠ ʊ ɾˠ ə
fuaigh	fˠ u ə ɟ
scion	ʃ c ɨ̞ nˠ
Aibreán	a bʲ ə ˈɾʲ ɑː n̪ˠ
gruama	ˈɡ ɾˠ u ə mˠ ə
buairt	bˠ u ə ɾˠ tʲ
crúbchrois	ˈk ɾˠ uː bˠ ˌx ɾˠ ʌ ʃ
buin	bˠ ɪ nʲ
rinn	ɾˠ ɪ n̠ʲ
sponc	sˠ pˠ ɔ ŋ k
gealach	ɟ ə ˈl̪ˠ ɑ x
maidhm	mˠ ə i mʲ
fhéir	eː ɾʲ
carthanas	ˈk a ɾˠ h ə nˠ ə sˠ
ardintinneach	ˌɑː ɾˠ d̪ˠ ˈiː n tʲ ə n̠ʲ ə x
stiúrú	ʃ tʲ uː ˈɾˠ uː
dúradh	ˈd̪ˠ uː ɾˠ ə ɡ
taoide	ˈt̪ˠ iː dʲ ə
bheatha	ˈvʲ a h ə
adhall	ˈə i ə l̪ˠ
beaga	bʲ ɞ ɡ ə
mhitheas	ˈvʲ ɪ h ə sˠ
léití	lʲ eː ˈtʲ iː
teorainn	ˈtʲ oː ɾˠ ə nʲ
bachall	ˈbˠ ɑ x ə l̪ˠ
garg	ˈɡ ɑ ɹ ɡ
glaise	ˈɡ lˠ a ʃ ə
saibhris	ˈsˠ ɛ vʲ ə ɾʲ ə ʃ
órga	ˈoː ɾˠ ɡ ə
cac	k ɑ k
gcóstaí	ɡ oː sˠ ˈt̪ˠ iː
geac	ɟ a k
nod	n̪ˠ ɔ d̪ˠ
tséabra	ˈtʲ eː bˠ ɾˠ ə
bheadh	vʲ ɛ x
chileagram	ˈç ɪ lʲ ə ɡ ɾˠ a mˠ
éasca	ˈiː ɑ̯ s k ə
clois	k lˠ ɔ ʃ
snua	sˠ n̪ˠ uː ə
aithne	ˈɑ h ə nʲ ə
aonaid	ˈeː nˠ ə dʲ
cailleadh	ˈk a l̠ʲ ə
aibidh	ˈa bʲ ɪ ɟ
bláthach	ˈbˠ l̪ˠ ɑː h ə x
boiriceach	ˈbˠ ɛ ɾʲ ɪ c ə x
gaiste	ˈɡ a ʃ tʲ ə
náisiún	n̪ˠ ɑː ˈʃ uː n̪ˠ
garbh	ˈɡ ɑ ɾˠ ə vˠ
chneasta	ˈç nʲ a sˠ t̪ˠ ə
bhligh	vʲ lʲ ɪ ɟ
bearrfaidh	ˈbʲ aː ɾˠ h ə
finne	ˈfʲ ɪ n̠ʲ ə
spideog	s pʲ iː ˈd̪ˠ oː ɡ
liobarnach	ˈlʲ ɨ̞ bˠ ə ɾˠ n̪ˠ ə x
mhill	ˈvʲ ɪ l̠ʲ
phráis	fˠ ɾˠ ɑː ʃ
deoise	ˈdʲ oː ʃ ə
iascach	ˈi ə s k ə x
shil	h ɪ lʲ
slige	ˈʃ l̠ʲ ɪ ɟ ɪ
concas	ˈk uː ŋ k ə sˠ
treabhsar	ˈtʲ ɾʲ ə u sˠ ə ɾˠ
aithníonn	ˈa h nʲ iː n̪ˠ
eiscir	ˈɛ ʃ c ə ɾʲ
traona	ˈt̪ˠ ɾˠ eː nˠ ə
seilg	ˈʃ ɛ lʲ ɪ ɟ
seisear	ˈʃ ɛ ʃ ə ɾˠ
dhóigh	ɣ oː ɟ
crómatach	ˈk ɾˠ oː mˠ ə t̪ˠ ə x
giolcach	ˈɟ ɨ̞ lˠ k a x
uasal	ˈu ə sˠ ə lˠ
ag	ə
scóir	sˠ k oː ɾʲ
oiliúin	ˈɛ l uː n
Ciarraí	ˈc i ə ɾˠ iː
sonrú	sˠ ɔ n̪ˠ ˈɾˠ uː
ngleann	ɲ lʲ ɑ u n̪ˠ
rochtain	ˈɾˠ ɔ x t̪ˠ ə nʲ
drithle	ˈdʲ ɾʲ ɨ̞ h ə lʲ ə
pé	pʲ eː
raibh	ɾˠ ɛ vʲ
sár	sˠ ɑː ɾˠ
deas	dʲ a sˠ
cead	c a d̪ˠ
ngrian	ɲ ɾʲ iː a̯ n̪ˠ
bíonns	bʲ iː n̪ˠ sˠ
baothchaifeach	ˈbˠ iː ˌx a fʲ a x
oirnis	ˈə u ɾʲ n̠ʲ ə ʃ
maitheamh	ˈmˠ a h ə vˠ
slánlus	ˈsˠ l̪ˠ aː n̪ˠ l̪ˠ ə sˠ
drochamhras	ˈd̪ˠ ɾˠ ʌ h ã ũ ɾˠ ə sˠ
troigh	t̪ˠ ɾˠ ɪ ɟ
scuab	sˠ k u ə bˠ
mothaím	ˈmˠ uː . iː mʲ
bábhún	ˈbˠ aː w ə nˠ
ort	ɔ ɾˠ t̪ˠ
chaoil	x iː lʲ
leathuair	ˈl̠ʲ a ˌh u ə ɾʲ
mbeinn	mʲ e i n̠ʲ
eisigh	ˈɛ ʃ ɪ ɟ
ná	n̪ˠ ɑː
míorúilteach	mʲ iː ˈɾˠ uː l̪ˠ t̪ˠ ə x
bleán	bʲ lʲ ɑː nˠ
ásc	ɑː sˠ k
peacadh	ˈpʲ a k u
Gardaí	ɡ ɑː ɾˠ ˈd̪ˠ iː
cíora	ˈc iː ɾˠ ə
fascadh	ˈfˠ ɑ sˠ k ə
náireach	ˈn̪ˠ ɑː ɾʲ ə x
píosa	ˈpʲ iː sˠ ə
láithreach	ˈlˠ ɑː h ə ɾʲ ə x
caolú	k eː ˈl̪ˠ uː
duilleach	ˈd̪ˠ ɪ l̠ʲ ə x
thair	h a ɾʲ
múin	mˠ uː nʲ
shnaidhm	h n̪ˠ ĩː mʲ
muca	ˈmˠ ʊ k ə
scian	sˠ c i ə n̪ˠ
baos	bˠ iː sˠ
luígí	ˈl̪ˠ iː ɟ iː
meánaois	mʲ ɑ̃ː n̪ˠ ˈeː sˠ
donas	ˈd̪ˠ ɔ nˠ ə sˠ
Victeoiria	vʲ ɪ c ˈtʲ oː ɾʲ i ə
déanaigí	ˈdʲ iː n ɪ ɟ iː
piocadh	ˈpʲ ʊ k ə
léis	l̠ʲ eː ʃ
cogús	k ə ˈɡ uː sˠ
dair	d̪ˠ a ɾʲ
bhunadh	ˈvˠ ʊ n̪ˠ ə
aird	ɑː ɾˠ dʲ
beartach	ˈbʲ a ɾˠ t̪ˠ ə x
tóra	ˈt̪ˠ oː ɾˠ ə
mhéir	vʲ eː ɾʲ
bromach	bˠ ɾˠ ə ˈmˠ ɑ x
síochán	ʃ iː ˈx ɑː n̪ˠ
th	h
anall	ə ˈn̪ˠ ɑ u l̪ˠ
dua	d̪ˠ u ə
iontach	ˈuː n̪ˠ t̪ˠ ə x
tiorma	ˈtʲ ɾʲ ʊ m ə
sceideal	ˈʃ c ɛ dʲ ə lˠ
chrainn	x ɾˠ a i ɲ
sáinn	sˠ ɑː n̠ʲ
sochreidte	ˈsˠ ɔ ˌç ɾʲ ɛ tʲ ə
geoin	ɟ oː nʲ
fheabhas	ə u sˠ
carcair	ˈk a ɾˠ k ə ɾʲ
scaraid	ˈsˠ k a ɾˠ ə dʲ
preas	pʲ ɾʲ a sˠ
fleaite	ˈfʲ lʲ a tʲ ə
searbh	ˈʃ a ɾˠ ə vˠ
dhorcha	ˈɣ ɔ ɾˠ ə x ə
gC	ɡ
nóinín	n̪ˠ oː ˈnʲ iː nʲ
píbe	ˈpʲ iː bʲ ə
sleamhna	ˈʃ l̠ʲ ã u nˠ ə
troime	ˈt̪ˠ ɾˠ ɪ mʲ ə
dúras	ˈd̪ˠ uː ɾˠ ə sˠ
straitéis	sˠ t̪ˠ ɾˠ a ˈtʲ eː ʃ
tuiscint	ˈt̪ˠ ɪ ʃ c ɪ nʲ tʲ
thaitin	ˈh æ tʲ i nʲ
uaigh	u ə ɟ
gléas	ɟ lʲ eː sˠ
Vallúinis	w a l̪ˠ uː nʲ ɪ ʃ
uaimh	u ə vʲ
smiolgadán	ˈsˠ mʲ ɪ l̪ˠ ə ɡ ə d̪ˠ ɑː n̪ˠ
dorrga	ˈd̪ˠ ɔ ɾˠ ə ɡ ə
Bíobla	ˈbʲ iː bˠ l̪ˠ ə
pheata	ˈfʲ a t̪ˠ ə
cruithneachta	ˈk ɾˠ ɪ h nʲ ə x t̪ˠ ə
glé	ɟ lʲ eː
collaíocht	ˈk ɔ l̪ˠ iː x t
neach	nʲ a x
voiceless	ˈv ɔ ɪ s l ə s
cun	k ʊ n̪ˠ
fiafraí	ˈfʲ i ə ɾˠ iː
tusa	ˈt̪ˠ ʊ sˠ ə
bráithre	ˈbˠ ɾˠ ɑː ɾʲ ə
pósad	ˈpˠ oː sˠ ə d̪ˠ
boscaí	bˠ ɔ sˠ ˈk iː
fiaclóir	fʲ i ə ˈk l̪ˠ oː ɾʲ
Antóin	a n̪ˠ t̪ˠ oː nʲ
dhe	j ɛ
milseán	mʲ ɪ lʲ ˈʃ aː n̪ˠ
Bealtaine	ˈbʲ a l̪ˠ t̪ˠ ə nʲ ə
umhlú	uː ˈl̪ˠ uː
balsamach	ˈbˠ a lˠ sˠ ə mˠ ə x
bocht	bˠ ɔ x t̪ˠ
ngeall	ɲ a u l̪ˠ
seimint	ˈʃ ɛ mʲ ə nʲ tʲ
iascaire	ˈi ə sˠ k ə ɾʲ ə
agair	ˈa ɡ ə ɾʲ
í	iː
feoigh	fʲ ɔː ɟ
scamhóg	sˠ k ə ˈvˠ oː ɡ
fuaireadar	ˈfˠ u ə ɾˠ ə d̪ˠ ə ɾˠ
gliomach	ɟ lʲ ɨ̞ ˈmˠ a x
tobán	t̪ˠ ə ˈbˠ ɑː n̪ˠ
stail	sˠ t̪ˠ a lʲ
mbeanna	ˈmʲ a n̪ˠ ə
cuntas	ˈk uː n̪ˠ t̪ˠ ə sˠ
chnoc	x n̪ˠ ʊ k
naoi	n̪ˠ iː
Fearghas	fʲ a ˈɾˠ iː sˠ
cibeal	ˈc ɪ bʲ ə l̪ˠ
stollaire	ˈsˠ t̪ˠ ɔ l̪ˠ ə ɾʲ ə
tinte	ˈtʲ ɪ n̠ʲ tʲ ə
chama	ˈx a mˠ ə
teilifís	ˈtʲ ɛ lʲ ɪ fʲ iː ʃ
sciobtha	ˈʃ c ʊ pˠ iː
trínarb	ˈtʲ ɾʲ iː nˠ ə ɾˠ bˠ
fuil	fˠ ɪ lʲ
éigin	ˈeː ɟ ɪ nʲ
tsá	t̪ˠ ɑː
práidhinneach	ˈpˠ ɾˠ aː j i n̠ʲ a x
daill	d̪ˠ ɪ l̠ʲ
bail	bˠ a lʲ
dháréag	ɣ ɑː ˈɾˠ eː ɡ
freagra	ˈfʲ ɾʲ a ɡ ə ɾˠ ə
aithin	ˈa h ə nʲ
guth	ɡ ʊ h
liobar	ˈl̠ʲ ɨ̞ bˠ ə ɾˠ
seomra	ˈʃ oː mˠ ɾˠ ə
dhéanfaí	ˈj iː n fˠ iː
eitre	ˈɛ tʲ ə ɾʲ ə
amhgar	ˈã u ɡ ə ɾˠ
portach	pˠ ə ɾˠ ˈt̪ˠ a x
diucs	ˈdʲ ɯ k s
turadh	ˈt̪ˠ ʊ ɾˠ ə
sáim	sˠ ɑː mʲ
allta	ˈa u l̪ˠ t̪ˠ ə
áisiúil	ˈaː ʃ uː lʲ
mís	mʲ iː ʃ
áirid	ˈɑː ɾʲ ə dʲ
coisin	ˈk ɔ ʃ ɪ nʲ
mholadh	ˈvˠ ɔ lˠ ə
slogaim	ˈsˠ l̪ˠ ɔ ɡ ə mʲ
bligh	bʲ lʲ ɪ ɟ
gamhain	ˈɡ ã u w ə nʲ
mairt	mˠ a ɾˠ tʲ
maraigh	ˈmˠ ɑ ɾˠ ɪ ɟ
bhó	vˠ oː
stopadh	ˈsˠ t̪ˠ ɔ pˠ ə
ngeallann	ˈɲ a l̪ˠ ə n̪ˠ
meallta	ˈmʲ a l̪ˠ t̪ˠ ə
buíocha	ˈbˠ iː x ə
chab	x ɑ bˠ
chugamsa	ˈh ɞ ɡ ə mˠ sˠ ə
gaile	ˈɡ æ lʲ ə
bídeach	ˈbˠ iː dʲ a x
Malaeis	ˈmˠ a lˠ eː ɪ ʃ
Gaelach	ˈɡ eː l̪ˠ ə x
rois	ɾˠ ɔ ʃ
lite	ˈl̠ʲ ɪ tʲ ə
tsluaigh	t̪ˠ l̪ˠ u ə ɟ
rabhthar	ˈɾˠ o w h ə ɾˠ
leacht	l̠ʲ a x t̪ˠ
smearadh	ˈsˠ mʲ a ɾˠ ə
goldar	ˈɡ ʌ l̪ˠ d̪ˠ ə ɾˠ
gradam	ˈɡ ɾˠ ɑ d̪ˠ ə mˠ
cúirialta	k uː ˈɾʲ i ə l̪ˠ t̪ˠ ə
dearmadach	ˈdʲ a ɾˠ ə mˠ ə d̪ˠ ə x
adhmad	ˈə i mˠ ə d̪ˠ
tuig	t̪ˠ ɪ ɟ
póirse	ˈpˠ oː ɾˠ ʃ ə
bhraith	w ɾˠ a
reath	ɾˠ a h
scríobhaim	sˠ c ɾʲ iː mʲ
amharc	ˈa vˠ ə ɾˠ k
báis	bˠ ɑː ʃ
gúnga	ˈɡ ɾˠ uː ŋ ɡ ə
sodhantach	ˈsˠ oː n̪ˠ t̪ˠ a x
Aindriú	ˈa nʲ ɾʲ uː
gcúinne	ˈɡ uː n̠ʲ ə
gleo	ɟ lʲ oː
cluinfidh	ˈk lˠ ɨ̞ nʲ h ə
claonadh	ˈk l̪ˠ eː n̪ˠ ə
dúnmharú	ˈd̪ˠ uː n̪ˠ vˠ a ɾˠ uː
prás	pˠ ɾˠ ɑː sˠ
doire	ˈd̪ˠ ɛ ɾʲ ə
uasghrádaigh	u ə sˠ ˈɣ ɾˠ ɑː d̪ˠ ɪ ɟ
fothain	ˈfˠ ɪ h ə nʲ
lítear	ˈl̠ʲ iː tʲ ə ɾˠ
cloisteáil	ˈk lˠ ɔ ʃ tʲ ɑː lʲ
pince	ˈpʲ ɪ ɲ c ɪ
lianna	ˈl̠ʲ i ə n̪ˠ ə
báine	ˈbˠ ɑː nʲ ə
Rinne	ˈɾˠ ɪ n̠ʲ ə
éagrábhadh	ˈeː k ɾˠ ɑː vˠ
baintrí	ˈbˠ æ n̠ʲ tʲ ɾʲ ə i̯
tamall	ˈt̪ˠ ɑ mˠ ə l̪ˠ
ainmneacha	ˈa nʲ ə mʲ nʲ ə x ə
deinim	ˈdʲ ɛ nʲ ɪ mʲ
meaingeal	ˈm æ ɲ ɟ ə l
báisteach	ˈbˠ ɑː ʃ tʲ ə x
leis	l̠ʲ ɛ ʃ
aistritheoir	ˈa ʃ tʲ ɾʲ ə h oː ɾʲ
samhlaigh	ˈsˠ ə u l̪ˠ ə
fearr	fʲ ɑː ɾˠ
bhéarfá	ˈvʲ eː ɾˠ ɑː
cáiliúil	k ɑː ˈlʲ uː lʲ
sábhálfaidh	ˈsˠ aː w a lˠ ə
mún	mˠ uː n̪ˠ
faighfeá	ˈfˠ a i ɑː
agad	ˈa ɡ ə d̪ˠ
síleáil	ʃ iː lʲ aː lʲ
litir	ˈlʲ ɪ tʲ ə ɾʲ
cam	k a u mˠ
folamh	ˈfˠ ɔ l̪ˠ ə vˠ
bácáil	bˠ ɑː ˈk ɑː lʲ
cúntóir	ˈk uː nˠ t̪ˠ oː ɾʲ
Catalóinis	ˈk a tˠ ə l̪ˠ oː nʲ ə ʃ
eangach	ˈa ŋ ɡ ə x
soineanta	ˈsˠ ɪ nʲ ə n̪ˠ t̪ˠ ə
Gaedhilge	ˈɡ eː lʲ ɟ ə
mairnéalach	ˈmˠ aː ɾˠ n̠ʲ a lˠ a x
ngearradh	ˈɲ a ɾˠ ə
cafarr	ˈk a fˠ ə ɾˠ
dhínne	ˈj iː n̠ʲ ə
ligean	ˈlʲ ɪ ɟ ə n̪ˠ
crosóg	k ɾˠ ə ˈsˠ oː ɡ
bille	ˈbʲ ɪ lʲ ə
stócáil	ˈsˠ t̪ˠ oː k ɑː lʲ
gróigeán	ˈk ɾˠ ɔː ɟ a nˠ
fillfir	ˈfʲ iː lʲ h ə rʲ
Fionn	fʲ ũː n̪ˠ
gríobh	ˈɟ ɾʲ iː w
cruach	k ɾˠ u ə x
straidhn	sˠ t̪ˠ ɾˠ ɑ i nʲ
bacáil	ˈbˠ a k æ lʲ
leafaos	ˈlʲ a ˈfˠ eː sˠ
aniar	ə ˈn̠ʲ i ə ɾˠ
gamal	ˈɡ a mˠ ə l̪ˠ
cheas	ç a sˠ
cuideog	ˈk ɪ tʲ a ɡ
cloigeann	ˈk lˠ ɛ ɟ ə n̪ˠ
aghaidh	ə i ɟ
úsáideoirí	uː ˈsˠ ɑː dʲ oː ɾʲ iː
seinm	ˈʃ ɛ nʲ ə mʲ
caoga	ˈk eː ɡ ə
héis	h eː ʃ
buntáiste	bˠ ə n̪ˠ ˈt̪ˠ ɑː ʃ tʲ ə
neimheadh	ˈnʲ ɛ vʲ ə
aithníodh	ˈa h nʲ iː ɡ
bheifeá	ˈvʲ ɛ h ɑː
fhagháilt	ɑː lʲ tʲ
nEoin	n̠ʲ oː nʲ
ghobadh	ˈɣ ɔ bˠ ə
béas	bʲ iː a̯ sˠ
lúbaim	ˈl̪ˠ uː bˠ ə mʲ
meisce	ˈmʲ ɛ ʃ c ɪ
smólach	ˈsˠ mˠ oː l̪ˠ ə x
dona	ˈd̪ˠ ɔ n̪ˠ ə
ceo	c oː
buí	bˠ iː
obair	ˈɔ bˠ ə ɾʲ
airde	ˈɑː ɾˠ dʲ ə
bláthmhar	ˈbˠ lˠ ɑː fˠ ə ɾˠ
caladh	ˈk ɑ l̪ˠ ə
fhreagair	ˈɾʲ a ɡ ə ɾʲ
díchéillí	ˈdʲ iː ˌç eː l̠ʲ iː
Pádraig	ˈpˠ ɑː d̪ˠ ə ɾˠ ɪ ɟ
chuicise	ˈh ɛ c ɪ ʃ ə
téigh	tʲ eː ɟ
stoptha	s ˈt̪ˠ ɔ pˠ ə
rialta	ˈɾˠ i ə l̪ˠ t̪ˠ ə
iompair	ˈʊ mˠ pˠ ə ɾʲ
mear	mʲ a ɾˠ
d'éalaigh	ˈdʲ i a l̪ˠ ɪ ɟ
bairéad	bˠ a ˈɾʲ eː d̪ˠ
lón	l̪ˠ oː n̪ˠ
ndiaidh	n̠ʲ i ə
cearnóga	c aː ɾˠ ˈn̪ˠ oː ɡ ə
paidreacha	ˈpˠ a dʲ ə ɾʲ ə x ə
cuiseog	k ə ˈʃ oː ɡ
poill	pˠ ə i l̠ʲ
sheaicéad	h a ˈc eː d̪ˠ
anamacha	ˈa nˠ ə mˠ ə x ə
maratón	mˠ ɑ ɾˠ ə ˈt̪ˠ oː n̪ˠ
d'fhógair	ˈd̪ˠ oː ɡ ə ɾʲ
línéadach	lʲ iː ˈnʲ iː a̯ d̪ˠ ə x
pobalscoil	ˈpˠ ɔ bˠ ə lˠ ˌsˠ k ɛ lʲ
goileann	ˈɡ ɛ lʲ ə n̪ˠ
Airméinis	ˈa ɾʲ ə mʲ eː nʲ ə ʃ
éar	eː ɾˠ
chéibh	ˈç eː vʲ
caiple	ˈk a pʲ lʲ ə
amparán	ˌa u m pˠ ə ˈɾˠ ɑː n̪ˠ
gréisceach	ˈɟ ɾʲ eː ʃ c ə x
bunadh	ˈbˠ ʊ n̪ˠ ə
glóire	ˈɡ lˠ oː ɾʲ ə
déanach	ˈdʲ eː n̪ˠ ə x
ionadaí	ˈi . ɴˠ ə . dˠ iː
sibhse	ʃ ɪ vʲ ʃ ə
stróic	sˠ t̪ˠ ɾˠ oː c
nG	ŋ
dealg	ˈdʲ a l̪ˠ ə ɡ
géagach	ˈɟ eː ɡ ə x
fuáil	fˠ uː ˈɑː lʲ
fúithi	ˈfˠ ʊ h ə
sa	sˠ ə
éileamh	ˈeː lʲ uː
corrú	k ɔ ˈɾˠ uː
amharclann	ˈə u ɾˠ k lˠ ə n̪ˠ
áille	ˈɑː l̠ʲ ə
pór	pˠ oː ɾˠ
béic	bʲ eː c
sil	ʃ ɪ lʲ
hálainn	ˈh ɑː l̪ˠ ɪ ɲ
ligthe	ˈl̠ʲ ɪ c ɪ
Tomás	t̪ˠ ə ˈmˠ ɑː sˠ
draíochta	ˈd̪ˠ ɾˠ i ə x t̪ˠ ə
griandó	ˈɟ ɾʲ i ə n̪ˠ ˌd̪ˠ oː
maithe	ˈmˠ a h ə
dímheas	ˈdʲ ĩː vʲ a sˠ
piont	ˈpʲ uː n̪ˠ t̪ˠ
clóscríobhaithe	ˈk lˠ oː ʃ c ɾʲ iː w iː
cáinfidh	ˈk aː nʲ h ə
mearadh	ˈmʲ a ɾˠ ə
aibhneacha	ˈa vʲ nʲ ə x ə
brac	bˠ ɾˠ a k
iníon	ɪ ˈnʲ iː n̪ˠ
diúil	dʲ uː lʲ
airí	ˈæ ɾʲ i
clog	k l̪ˠ ɔ ɡ
fút	fˠ uː t̪ˠ
adhlacadh	ˈʌ lˠ k u
snaidhm	sˠ n̪ˠ iː mʲ
cat	k ɑ t̪ˠ
gealt	ɟ a l̪ˠ t̪ˠ
brobh	bˠ ɾˠ ɔ vˠ
gabha	ˈɡ ə u . ə
breoite	ˈbʲ ɾʲ oː tʲ ə
aithint	a n̠ʲ tʲ
lúb	l̪ˠ uː bˠ
gleann	ɟ lʲ ɑ u n̪ˠ
bhíothas	ˈvʲ iː h ə sˠ
ceamach	ˈc ɨ̞ mˠ a x
ósta	ˈoː sˠ t̪ˠ ə
fos	fˠ ɔ sˠ
íseal	ˈiː ʃ ə l̪ˠ
pite	ˈpʲ ɪ tʲ ə
ciseal	ˈc ɪ ʃ ə lˠ
luite	ˈl̪ˠ ɪ tʲ ə
rainnt	ɾˠ ɑ i nʲ tʲ
chuathas	ˈx u ə h ə sˠ
foireann	ˈfˠ ɪ ɾʲ ə n̪ˠ
bradach	ˈbˠ ɾˠ ɑ d̪ˠ ə x
blífidh	ˈbʲ lʲ i h ə
blitear	ˈbʲ lʲ ɪ tʲ ə ɾˠ
aisteoir	ə ˈʃ tʲ oː ɾʲ
péacógach	pʲ eː ˈk oː ɡ ə x
folt	fˠ ɞ l̪ˠ t̪ˠ
ban	bˠ a nˠ
óstach	ˈoː sˠ t̪ˠ ə x
gram	ˈɡ ɾˠ a mˠ
comhionann	ˈk ũ . a nˠ ə n̪ˠ
hÉirinn	ˈh eː ɾʲ ə n̠ʲ
spaisteoireacht	sˠ pˠ æ ʃ ˈtʲ oː ɾʲ ə x t̪ˠ
pingin	ˈpʲ ɪ ɲ ɟ ə nʲ
Eadáine	ˈa d̪ˠ ɑː n̠ʲ ə
neosad	ˈnʲ oː sˠ ə d̪ˠ
éadmhar	ˈeː d̪ˠ u ɾˠ
astusan	ˈɑ sˠ t̪ˠ ə pˠ sˠ ə n
hata	ˈh ɑ t̪ˠ ə
sagart	ˈsˠ ɑ ɡ ə ɾˠ t̪ˠ
dearg	ˈdʲ a ɾˠ ə ɡ
toighte	ˈt̪ˠ ɨ̞ tʲ ə
folláin	fˠ ə ˈl̪ˠ ɑː nʲ
asainn	ˈa sˠ ə n̠ʲ
díog	ˈdʲ iː ɡ
tromán	t̪ˠ ɾˠ ə ˈmˠ ɑː n̪ˠ
thuaidh	h u ə ɟ
dromán	d̪ˠ ɾ ə ˈmˠ ɑː n̪ˠ
giorria	ˈɟ ɪ ɾˠ i ə
tiomáin	tʲ ə ˈmˠ ɑː nʲ
slisne	ˈʃ l̠ʲ ɪ ʃ n̠ʲ ə
feá	fʲ aː
eicínt	ə ˈc iː n̠ʲ tʲ
fairsingeachas	ˈfˠ a ɾˠ sˠ n̠ʲ a x ə sˠ
clúmh	k l̪ˠ uː vˠ
soirbhigh	ˈsˠ ɛ ɾʲ ə vʲ i
deirge	ˈdʲ ɛ ɾʲ ɪ ɟ ɪ
teastas	ˈtʲ a sˠ t̪ˠ ə sˠ
miúil	mʲ uː lʲ
gceilt	ɟ ɛ lʲ tʲ
práinneach	ˈpˠ ɾˠ aː j i n̠ʲ a x
gairm	ˈɡ a ɾʲ ə mʲ
sceitimíní	sˠ c ɛ tʲ ə ˈmʲ iː nʲ iː
múnaid	ˈmˠ uː n̪ˠ ə dʲ
dharna	ˈɣ ɑː ɾˠ n̪ˠ ə
acaiseach	ˈæ k ə ʃ ə x
anchroí	ˈɑ n x ɾˠ ə
brisfidh	ˈbʲ ɾʲ ɪ ʃ ə
chasta	ˈx ɑ sˠ t̪ˠ ə
bíobhanta	ˈbʲ iː w i ə n̪ˠ t̪ˠ ə
luach	l̪ˠ u ə x
déarfad	ˈdʲ eː ɾˠ h ə d̪ˠ
thuilleamar	ˈh ɪ l̠ʲ ə mˠ ə ɾˠ
dóim	d̪ˠ oː mʲ
téann	tʲ eː n̪ˠ
bhealach	vʲ ə ˈl̪ˠ ɑ x
sé	ʃ eː
aeróstach	eː ɾˠ ˈoː sˠ t̪ˠ ə x
Seosamh	ˈʃ oː sˠ ə vˠ
eim	ɛ mʲ
chéim	ç eː mʲ
thraoith	ˈh ɾˠ iː
taspáin	t̪ ə ˈs pˠ ɑː nʲ
altfadh	ˈa l̪ˠ t̪ˠ ə x
dearnadar	ˈdʲ aː ɾˠ n̪ˠ ə d̪ˠ ə ɾˠ
dia	dʲ i ə
cultúr	k ʊ l̪ˠ ˈt̪ˠ uː ɾˠ
acht	ɑ x t̪ˠ
bonnán	ˈbˠ u n̪ˠ ɑː nˠ
coireach	ˈk ɨ̞ ɾˠ h a x
piana	ˈpʲ i ə nˠ ə
muis	ˈmˠ ɪ ʃ
bandach	ˈbˠ ɑ n̪ˠ d̪ˠ ə x
ára	ˈɑː ɾˠ ə
pioc	pʲ ʊ k
shnámh	h n̪ˠ ɑː vˠ
leamhnacht	ˈlʲ a u n̪ˠ ə x t̪ˠ
amháin	ə ˈvˠ ɑː nʲ
fágann	ˈfˠ ɑː ɡ ə n̪ˠ
éineacht	ʲeː nʲ ə x t̪ˠ
culaith	k l̪ˠ ɪ h
farc	fˠ a ɾˠ k
péatar	ˈpʲ eː t̪ˠ ə ɾˠ
tréith	tʲ ɾʲ eː
fhágaint	ˈɑː ɡ ə nʲ tʲ
tSín	tʲ iː nʲ
díslí	ˈdʲ iː ʃ l̠ʲ iː
aidmhigh	ˈæ dʲ i
beir	bʲ ɛ ɾʲ
Polainnis	ˈpˠ ɔ l̪ˠ ə n̠ʲ ɪ ʃ
dtiocfá	ˈdʲ ʊ k fˠ ɑː
ponc	pˠ ʊ ŋ k
tollfaidh	ˈt̪ˠ ʌ l̪ˠ h i
fhuinneoig	ə ˈɲ oː ɟ
fána	ˈfˠ ɑː n̪ˠ ə
fásach	ˈfˠ ɑː sˠ ə x
bríomhar	ˈbʲ ɾʲ iː vˠ ə ɾˠ
socraigh	ˈsˠ ɔ k ɾˠ ɪ ɟ
seang	ˈʃ a n̪ˠ ə ɡ
clibirt	ˈc lʲ ɪ bʲ ə ɾˠ tʲ
píoba	ˈpʲ iː bˠ ə
ghearrtaí	j aː ɾˠ ˈt̪ˠ iː
cuimhnigh	ˈk iː nʲ ɪ ɟ
máistreás	mˠ ɑː ʃ ˈtʲ ɾʲ ɑː sˠ
bearna	ˈbʲ ɑː ɾˠ n̪ˠ ə
airgeadúla	a ɾʲ ɪ ɟ ə ˈd̪ˠ uː lˠ ə
Nollaig	ˈn̪ˠ ɔ l̪ˠ ɪ ɟ
Albanach	ˈa lˠ ə bˠ ə nˠ ə x
cuimhniú	ˈk iː mʲ ɾʲ uː
las	l̪ˠ a sˠ
Gaeil	ɡ eː lʲ
bánaigh	ˈbˠ ɑː n̪ˠ ɪ ɟ
liom	lʲ ʊ mˠ
dáta	ˈd̪ˠ ɑː t̪ˠ ə
sleá	ˈʃ l̠ʲ ɑː
srón	sˠ ɾˠ oː nˠ
tabhartha	ˈt̪ˠ uː ɾˠ h ə
mhuirnín	vˠ uː ɾˠ ˈnʲ iː nʲ
ithir	ˈɪ h ə ɾʲ
gróig	ˈk ɾˠ ɔː ɟ
airne	ˈɑː ɾˠ n̠ʲ ə
déanas	ˈdʲ iː n ə sˠ
tairseach	ˈt̪ˠ ɔ ɾˠ sˠ a x
tlú	t̪ˠ l̪ˠ uː
binse	ˈbʲ ɛ n̠ʲ ʃ ə
Bascais	ˈbˠ a sˠ k ə ʃ
bréagach	ˈbʲ ɾʲ i a ɡ ə x
fharraige	ˈa ɾˠ ə ɟ ɪ
let	lʲ ɛ t̪ˠ
bhfeis	vʲ ɛ ʃ
uncail	ˈʊ ŋ k ə lʲ
creidte	ˈc ɾʲ ɛ tʲ ə
maidne	ˈmˠ æ n̠ʲ ə
cinnire	ˈc ɪ n̠ʲ ə ɾʲ ə
bealaigh	ˈbʲ a l̪ˠ ɪ ɟ
stua	sˠ t̪ˠ u ə
anonn	ə ˈn uː n̪ˠ
billiún	ˈbʲ i l̠ʲ uː nˠ
neoin	n̠ʲ oː nʲ
fuarthas	fʲ ɾʲ iː vˠ
scór	sˠ k oː ɾˠ
sailchuach	sˠ a lˠ ˈx u ə x
dhínn	j iː n̠ʲ
tóigeáil	ˈt̪ˠ oː ɟ ɑː lʲ
Nóra	ˈn̪ˠ oː ɾˠ ə
laghdaigh	ˈl̪ˠ eː d̪ˠ i
ail	a lʲ
dóighiúil	ˈd̪ˠ ɔː j u lʲ
badráil	bˠ ɑ d̪ˠ ˈɾˠ ɑː lʲ
deich	dʲ ɛ ç
tulach	t u l ə x
lochta	ˈl̪ˠ ɔ x t̪ˠ ə
míghreann	ˈmʲ iː ɾʲ ə n̪ˠ
calrach	ˈk a l̪ˠ ɾˠ ə x
tibhe	ˈtʲ ɪ vʲ ə
géag	ɟ iː a̯ ɡ
tiomsú	ˈtʲ ɨ̞ mˠ sˠ u
grean	ɟ ɾʲ a n̪ˠ
dochreidte	d̪ˠ ɔ ˈç ɾʲ ɛ tʲ ə
fianaise	ˈfʲ i ə n̪ˠ ə ʃ
amárach	ə ˈmˠ ɑː ɾˠ ə x
can	k a n̪ˠ
dramanna	ˈd̪ˠ ɾˠ a mˠ ə n̪ˠ iː
dhom	ɣ ɔ mˠ
ina	ˈɪ nˠ ə
suím	sˠ iː mʲ
gcéibheanna	ˈɟ eː vʲ ə n̪ˠ iː
áiteamh	ˈɑː tʲ ə vˠ
gcairde	ˈɡ ɑː ɾˠ dʲ ə
síl	ʃ iː lʲ
cigil	ˈc ɪ ɟ ɪ lʲ
abarthach	ˈa bˠ ə ɾˠ ə x
siopa	ˈʃ ɯ pˠ ə
meaisín	mʲ ə ˈʃ iː nʲ
dúshlán	ˈd̪ˠ uː l̪ˠ a nˠ
craicne	ˈk ɾˠ æ c nʲ ə
dos	d̪ˠ ɔ sˠ
cuing	k iː ɲ ɟ
báille	ˈbˠ ɑː l̠ʲ ə
glacfaidh	ˈɡ lˠ a k ə
d'fhuafaí	ˈd̪ˠ u ə fʲ i
rialtas	ˈɾˠ i ə l̪ˠ t̪ˠ ə sˠ
gcurach	ɡ ə ˈɾˠ a x
bí	bʲ iː
phus	fˠ ʊ sˠ
linne	ˈlʲ ɪ n̠ʲ ə
iarraidh	ˈi ə ɾˠ ɪ ɟ
amuigh	ə ˈmˠ ɪ ɟ
eich	ɛ ç
tráthnóna	t̪ˠ ɾˠ ɑː n̪ˠ ˈh oː n̪ˠ ə
spleáchas	ˈsˠ pʲ lʲ aː x ə sˠ
ciúin	c uː nʲ
bhinde	ˈvʲ ɪ n̠ʲ dʲ ə
corrlach	ˈk ɔ ɾˠ l̪ˠ a x
taobh	t̪ˠ eː vˠ
ciglis	ˈc ɪ ɟ ɪ lʲ ə ʃ
sciúlán	ʃ c uː ˈl̪ˠ ɑː n̪ˠ
rugadh	ˈɾˠ ʊ ɡ ə ɡ
eilit	ˈɛ h lʲ ə dʲ
gníomh	ɟ nʲ iː vˠ
cóngar	ˈk uː ŋ ɡ ə ɾˠ
snag	sˠ n̪ˠ a ɡ
chaol	x eː l̪ˠ
eadrainne	ˈaː t̪ˠ ɾˠ ə n̠ʲ ə
Connacht	ˈk ɔ n̪ˠ ə x t̪ˠ
tuaisceart	ˈt̪ˠ u ə ʃ c ə ɾˠ t̪ˠ
tarraingím	ˈt̪ˠ a ɾʲ ɪ ɟ iː mʲ
troithe	ˈt̪ˠ ɾˠ ɪ h ə
camall	ˈk a mˠ ə l̪ˠ
Meireacá	ˈmʲ ɛ ɾʲ ə k ɑː
leathanach	ˈl̠ʲ a h ə nˠ ə x
bpéin	bʲ eː nʲ
sheanléim	ˈh æ n̠ʲ l̠ʲ eː mʲ
maiseach	ˈmˠ a ʃ ə x
brionglóid	ˈbʲ ɾʲ ɪ ŋ lˠ oː dʲ
scrios	sˠ c ɾʲ ɨ̞ sˠ
paindéim	pˠ a nʲ . dʲ eː mʲ
oirim	ˈɪ ɾʲ ə mʲ
Giúdach	ˈɟ uː d̪ˠ ə x
fórsa	ˈfˠ oː ɾˠ sˠ ə
fara	ˈfˠ a ɾˠ ə
críon	c ɾʲ iː nˠ
cotadh	ˈk ɔ t u
chead	ç a d̪ˠ
mhadadh	ˈw a d̪ˠ ə
gliogar	ˈɟ lʲ ɪ ɡ ə ɾˠ
soicind	ˈsˠ ɛ c ə nʲ dʲ
carria	ˈk a ɾˠ i ə
bháis	vˠ ɑː ʃ
coiste	ˈk ɔ ʃ tʲ ə
d'iarr	dʲ i ə ɾˠ
ailse	ˈæ l̠ʲ ʃ ə
fhéar	eː ɾˠ
fadhbanna	ˈfˠ ə i bˠ ə n̪ˠ ə
ciallmhar	ˈc i ə l̪ˠ vˠ ə ɾˠ
gearrtha	ˈɟ aː ɾˠ h ə
cúigiú	k uː ˈɟ uː
tsuim	t̪ˠ a i mʲ
daid	ˈd̪ˠ a dʲ
tharlaigh	ˈh ɑ ɾˠ l̪ˠ ɪ ɟ
timpeall	ˈtʲ iː mˠ pˠ ə l̪ˠ
ceathrúnaí	ˈc æː ɾˠ uː n̪ˠ iː
baineann	ˈbˠ ɪ ɾʲ ə n̪ˠ
choillte	ˈx iː lʲ tʲ ə
iomarcach	ˈʊ mˠ ə ɾˠ k ə x
saor	sˠ eː ɾˠ
suipéar	sˠ ɪ ˈpʲ eː ɾˠ
cogain	ˈk ɔ ɡ ə nʲ
líne	ˈl̠ʲ iː nʲ ə
éadroma	ˈiː a̯ d̪ˠ ə ɾˠ ə mˠ ə
teithim	ˈtʲ ɛ h ə mʲ
murnán	mˠ uː ɾˠ ˈn̪ˠ aː n̪ˠ
damnaigh	ˈd̪ˠ ɑ mˠ ə n̪ˠ ɪ ɟ
bhróin	vˠ ɾˠ oː nʲ
faochóg	ˈfˠ iː x ɔ ɡ
maíomh	mˠ iː vˠ
Catalóin	k a tˠ ə ˈl̪ˠ oː nʲ
breabadh	ˈbʲ ɾʲ a bˠ ə
cian	c i ə nˠ
bláthanna	ˈbˠ l̪ˠ ɑː h ə n̪ˠ ə
cársán	ˈk ʌ ɾˠ sˠ a nˠ
caithfidh	ˈk a h ə
cluinim	ˈk lˠ ɨ̞ nʲ ə mˠ
gréasán	ɟ ɾ i a ˈsˠ ɑː n̪ˠ
saibhre	ˈsˠ ɛ vʲ ɾʲ ə
cuntais	ˈk uː n̪ˠ t̪ˠ ə ʃ
siúinéir	ˈʃ uː nʲ eː ɾʲ
rinneas	ˈɾˠ ɪ n̠ʲ ə sˠ
riail	ɾˠ i ə lʲ
dada	ˈd̪ˠ a d̪ˠ ə
broslú	ˈbˠ ɾˠ ɔ sˠ l̪ˠ u
litriú	lʲ ə tʲ ə ˈɾʲ uː
seanmóntaidhe	ˈʃ a nˠ ə mˠ a n̪ˠ t̪ˠ i
sciobaim	ˈsˠ c ɪ bˠ ə mʲ
ormsa	ˈɔ ɾˠ ə mˠ sˠ ə
frisnéiseach	ˈfʲ ɾʲ ɪ ʃ n̠ʲ æ ʃ a x
riugadar	ɾʲ ʊ ɡ ə d̪ˠ ə ɾˠ
córam	ˈk oː ɾˠ ə mˠ
créacht	c ɾʲ eː x t̪ˠ
caoinfidh	ˈk iː nʲ h ə
comhla	ˈk õː l̪ˠ ə
diúracas	ˈdʲ uː ɾˠ ə k ə sˠ
leáigh	lʲ ɑː ɟ
chlé	ç lʲ eː
sneachtúil	ʃ nʲ a x ˈt̪ˠ uː lʲ
léise	ˈl eː ʃ ə
éirigh	ˈə i ɾʲ ɪ ɟ
tinnis	ˈtʲ ɪ n̠ʲ ə ʃ
mboicht	mˠ ɔ x tʲ
pinginí	pʲ ɪ ɲ ə ˈnʲ iː
foréigean	fˠ ɔ ɾˠ ˈeː ɟ ɪ nˠ
ochtó	ˈo x t̪ˠ oː
ceoil	c oː lʲ
seagal	ˈʃ a ɡ ə lˠ
cheatha	ˈç a h ə
fíniúnach	fʲ iː ˈnʲ uː n̪ˠ ə x
speireach	ˈsˠ p ʌ ɾˠ a x
giolla	ˈɟ ɪ l̪ˠ ə
feidhmeannach	ˈfʲ ə i mʲ ə n̪ˠ ə x
olla	ˈɔ l̪ˠ ə
ar	ɛ ɾʲ
gléasann	ˈɟ lʲ eː s ə n̪ˠ
feistigh	ˈfʲ ɛ ʃ tʲ ɪ ɟ
sciurdadh	ˈʃ c ɨ̞ ɾˠ d̪ u
dreas	dʲ ɾʲ a sˠ
gcapall	ˈɡ a pˠ ə l̪ˠ
ciotach	c ə ˈt̪ˠ a x
Shínigh	ˈh iː nʲ ɪ ɟ
scillinge	ˈʃ c ɪ l̠ʲ n̠ʲ ə
chúcha	ˈx uː x ə
chiliméadar	ç ɪ lʲ ə ˈmʲ eː d̪ˠ ə ɾˠ
síol	ʃ iː ə l̪ˠ
féasóg	fʲ iː a̯ ˈsˠ oː ɡ
duaidh	ˈd̪ˠ u ə ɟ
aiféala	ˈa fʲ eː lˠ ə
foighid	fˠ a i dʲ
ollmhór	ˈə u l̪ˠ ˌvˠ oː ɾˠ
Cháit	x ɑː tʲ
spréifidh	ˈsˠ pʲ ɾʲ eː ç i
gall	ɡ ɑː l̪ˠ
morg	ˈmˠ ɔ ɾˠ ə ɡ
fearthainn	ˈfʲ a ɾˠ h ə ɲ
búistéara	ˈbˠ uː ʃ tʲ eː ɾˠ ə
fuath	fˠ u ə
seada	ˈʃ a d̪ˠ ə
draig	dˠ ɾˠ a ɟ
díbhse	ˈdʲ iː vʲ ʃ ə
sál	sˠ ɑː l̪ˠ
comhluadar	k oː ˈl̪ˠ u ə d̪ˠ ə ɾˠ
sháigh	h ɑː ɟ
dreolán	dʲ ɾʲ oː ˈl̪ˠ ɑː n̪ˠ
rialacha	ˈɾˠ i ə l̪ˠ ə x ə
cruaim	k ɾˠ u ə mʲ
úlla	ˈuː l̪ˠ ə
scréach	ʃ c ɾʲ eː x
oideachas	ˈɛ dʲ ə x ə sˠ
míleach	ˈmʲ iː lʲ ə x
thoirt	h ɔ ɾˠ tʲ
tuirseach	t̪ˠ ə ɾˠ ˈʃ a x
féachaint	ˈfʲ i a x ɪ nʲ tʲ
aoibhneas	ˈiː vʲ nʲ ə sˠ
daidí	ˈd̪ˠ a dʲ iː
tánaiste	ˈt̪ˠ ɑː n̪ˠ ə ʃ tʲ ə
t'	t̪ˠ
múinid	ˈmˠ uː nʲ ə dʲ
baile	ˈbˠ a lʲ ə
seánra	ˈʃ ɑː n̪ˠ ɾˠ ə
amaid	ˈa mˠ ə dʲ
beacha	ˈbʲ a x ə
aithghiorra	ˈa i ç ə ɾˠ ə
faoisean	ˈfˠ iː ʃ ə nˠ
trosc	t̪ˠ ɾˠ ɔ sˠ k
coscartha	ˈk a sˠ k ə ɾˠ ə
cabhrach	ˈk ə u ɾˠ ə x
mhúchadh	ˈvˠ uː x ə
canna	ˈk a n̪ˠ ə
duit	d̪ˠ ɪ tʲ
leás	l̠ʲ ɑː sˠ
lice	ˈl̠ʲ ɪ c ɪ
ainbhios	ˈæ n ə ʃ
bindealán	bʲ i n̠ʲ dʲ ə ˈl̪ˠ ɑː n̪ˠ
ndearnas	ˈn̠ʲ aː ɾˠ n̪ˠ ə sˠ
troimide	ˈt̪ˠ ɾˠ ɪ mʲ ə dʲ ə
fitear	ˈfʲ ɪ tʲ ə ɾˠ
ndara	ˈn̪ˠ ɑ ɾˠ ə
tinneas	ˈtʲ ɪ nʲ ə sˠ
Laidin	ˈl̪ˠ a dʲ ɪ nʲ
rís	ɾˠ iː ʃ
roinn	ɾˠ a i ɲ
ngaoith	ŋ iː h
bradaigh	ˈbˠ ɾˠ ɑ d̪ˠ ɪ ɟ
orm	ˈɔ ɾˠ ə mˠ
gasúir	ɡ ɑ ˈsˠ uː ɾʲ
caifé	ˈk a fʲ eː
chuala	ˈx u ə l̪ˠ ə
míreanna	ˈmʲ iː ɾʲ ə n̪ˠ ə
breáichte	ˈbʲ ɾʲ aː x tʲ ə
deiseanna	ˈdʲ ɛ ʃ ə n̪ˠ ə
anas	ˈa nˠ ə sˠ
cnuic	k n̪ˠ ɪ c
arm	ˈɑ ɾˠ ə mˠ
bambairne	ˈbˠ ɑ u mˠ bˠ ə ɾˠ nʲ ə
gloine	ˈɡ lˠ ɪ nʲ ə
mbuailte	ˈmˠ u ə l̠ʲ tʲ ə
charad	ˈx a ɾˠ ə d̪ˠ
sorcha	ˈsˠ ɔ ɾˠ ə x ə
Sadhbh	ˈsˠ ə i̯ vˠ
uaiféalta	ˈu ə fʲ iː a̯ l̪ˠ t̪ˠ ə
Éireannach	ˈeː ɾʲ ə n̪ˠ ə x
shlí	ˈh lʲ iː
meán	mʲ aː nˠ
oisín	ə ˈʃ iː nʲ
ealaíonta	ˈa lˠ i n̪ˠ t̪ˠ ə
hÍ	h iː
spriog	sˠ pʲ ɾʲ ʊ ɡ
troscadh	ˈt̪ˠ ɾˠ ʌ sˠ k ə
coinscleo	ˈk ɪ n̠ʲ ʃ c lʲ ɔ
salú	sˠ ə ˈl̪ˠ uː
marcach	ˈmˠ a ɾˠ k ə x
tuismigh	ˈt̪ˠ ɪ ʃ m ɪ ɟ
mothaíonn	ˈm uː . iː n̪ˠ
toirt	t̪ˠ ɔ ɾˠ tʲ
dara	ˈd̪ˠ ɑ ɾˠ ə
leáim	ˈl̠ʲ eː j ə mˠ
deora	ˈdʲ oː ɾˠ ə
éigiall	ˈeː ɟ i ə l̪ˠ
mheáití	vʲ ɑː ˈtʲ iː
tlig	tʲ lʲ ɪ ɟ
fusa	ˈfˠ ʊ sˠ ə
scanrú	sˠ k a u n̪ˠ ˈɾˠ uː
gaibh	ɡ a vʲ
dóimid	ˈd̪ˠ oː mʲ ə dʲ
taifead	ˈt̪ˠ a fʲ ə d̪ˠ
géarleanúint	ˈɟ eː ɾˠ lʲ a nˠ ũː n̠ʲ tʲ
saile	ˈs a lʲ ə
crúigh	k ɾˠ uː ɟ
bhrata	ˈvˠ ɾˠ a t̪ˠ ə
siúcra	ˈʃ uː k ɾˠ ə
bruis	bˠ ɾˠ ɪ ʃ
baisteadh	ˈbˠ a ʃ tʲ ə
tuathal	ˈt̪ˠ u ə h ə l̪ˠ
asainne	ˈa sˠ ə n̠ʲ ə
baintreach	ˈbˠ a nʲ tʲ ɾʲ ə x
máthair	ˈmˠ ɑː h ə ɾʲ
céas	c i a̯ sˠ
cnó	k n̪ˠ oː
thairg	ˈh a ɾʲ ɪ ɟ
diúl	dʲ uː lˠ
urchóid	ʊ ɾˠ ə ˈx oː dʲ
lóistín	l̪ˠ oː ʃ ˈtʲ iː nʲ
torc	t̪ˠ ɔ ɾˠ k
dínn	dʲ iː n̠ʲ
do	d̪ˠ ɔ
Árannach	ˈɑː ɾˠ ə n̪ˠ ə x
dtrí	dʲ ɾʲ iː
fachta	ˈfˠ ɑ x t̪ˠ ə
málóid	mˠ ɑː ˈl̪ˠ oː dʲ
uaire	ˈu ə ɾʲ ə
aice	ˈa c ɪ
dearbhaím	ˈdʲ a ɾˠ ə w i m
ancaire	ˈɑ ŋ k ə ɾʲ ə
drochbhéasach	d̪ˠ ɾ ɔ x ˈvʲ eː sˠ ə x
puimcín	pˠ ɪ mʲ ˈc iː n
giodalach	ˈɟ ɨ̞ d̪ˠ ə lˠ a x
comrádaithe	ˈk ʊ mˠ ɾˠ ɑː d̪ˠ iː
ait	a tʲ
cur	k ʊ ɾˠ
ceannas	ˈc a n̪ˠ ə sˠ
log	l̪ˠ ɔ ɡ
aimhleas	ˈiː lʲ ə sˠ
mian	mʲ i ə n̪ˠ
neart	nʲ a ɾˠ t̪ˠ
anró	ˈaː nˠ ɾˠ ɔ
chucusan	ˈh ɞ k ə pˠ sˠ ə n
bog	bˠ ɔ ɡ
mháthair	ˈvˠ ɑː h ə ɾʲ
pianfaidh	ˈpʲ i ə n h ə
téarma	ˈtʲ eː ɾˠ mˠ ə
leithigh	ˈl̠ʲ ɛ h i
riarann	ˈɾˠ i ə ɾˠ ə n̪ˠ
pointe	ˈpˠ iː n̠ʲ tʲ ə
meidhir	ˈmʲ ə i rʲ
gnótha	ˈɡ ɾˠ ẽː h ə
Mhuire	ˈvˠ ɪ ɾʲ ə
athuair	ˈa h u ə ɾʲ
airc	a ɾʲ c
dhíom	j iː mˠ
geimhrí	ɟ iː ˈɾʲ iː
saint	sˠ ɪ n̠ʲ tʲ
cheird	ç ə i ɾˠ dʲ
oiriúint	ə ˈɾʲ uː nʲ tʲ
cairdiúil	k ɑː ɾˠ ˈdʲ uː lʲ
cuiscreach	ˈk ɪ ʃ c ɾʲ ə x
compordach	k uː mˠ ˈpˠ oː ɾˠ d̪ˠ ə x
láthair	ˈl̪ˠ ɑː h ə ɾʲ
pionós	ˈpʲ ɨ̞ n u s
cnáib	k nˠ ɑː bʲ
sócúl	sˠ oː ˈk uː l̪ˠ
uaigneas	ˈu ə ɟ ɪ nʲ ə sˠ
loistín	l̪ˠ ɞ ʃ ˈtʲ iː nʲ
bráthair	ˈbˠ ɾˠ ɑː h ə ɾʲ
griosálfaidh	ˈɟ ɾʲ ɪ sˠ a lˠ i
billí	ˈbʲ ɪ lʲ iː
thiocfainn	h ʊ k ə n̠ʲ
doirtear	ˈd̪ˠ ɨ̞ ɾˠ tʲ ə ɾˠ
freagair	ˈfʲ ɾʲ a ɡ ə ɾʲ
Nollag	ˈn̪ˠ ɔ l̪ˠ ə ɡ
néalta	ˈn̠ʲ eː l̪ˠ t̪ˠ i
innseann	ˈiː nʲ ʃ ə n̪ˠ
straiméad	ˈsˠ t̪ˠ ɾˠ aː mʲ æ dʲ
innealtóir	ˈi nʲ ə lˠ t̪ˠ oː ɾʲ
thoiligh	ˈh ɞ lʲ ɪ ɟ
campa	ˈk a mˠ pˠ ə
tuga	ˈt̪ˠ ʊ ɡ ə
íobairt	ˈiː bˠ ə ɾˠ tʲ
éanacha	ˈeː n̪ˠ ə x iː
breathnaigh	ˈbʲ ɾʲ a n̪ˠ ə
dearcán	ˈdʲ a ɾˠ k a nˠ
uaigneach	ˈu ə ɟ ɪ nʲ ə x
scóp	sˠ k oː pˠ
díolann	ˈdʲ iː l̪ˠ ə n̪ˠ
tormas	ˈt̪ˠ ʌ ɾˠ ə mˠ ə sˠ
coisric	ˈk ɛ ʃ ɾʲ ɪ c
ónarbh	ˈoː nˠ ə ɾˠ vˠ
dortha	ˈd̪ˠ ʌ ɾˠ h ə
Ceanada	ˈc a nˠ ə d̪ˠ ə
uirrim	ˈɪ ɾʲ ə mʲ
cipín	c ɪ ˈpʲ iː nʲ
mímhúinte	ˈmʲ iː ˌw uː n̠ʲ tʲ ə
cheoil	ç oː lʲ
diaspóra	dʲ i ə ˈsˠ pˠ oː ɾˠ ə
eol	oː lˠ
oifig	ˈɛ fʲ ɪ ɟ
aidmheáil	ˈa dʲ vʲ æ lʲ
círe	ˈc iː ɾʲ ə
cúlú	k uː ˈl̪ˠ uː
cosc	k ɔ sˠ k
Béarla	ˈbʲ iː a̯ ɾˠ l̪ˠ ə
ghob	ɣ ɔ bˠ
gcaoirigh	ˈɡ iː ɾʲ ɪ ɟ
gaothrán	ɡ iː ɾ̥ˠ ɑː n̪ˠ
díomá	dʲ iː mˠ ˈvˠ ɑː
smíste	ˈsˠ mʲ iː ʃ tʲ ə
lean	lʲ a n̪ˠ
finn	fʲ iː ɲ
imní	ɪ mʲ ə ˈnʲ iː
chairde	ˈx ɑː ɾˠ dʲ ə
sráide	sˠ ɾˠ aː dʲ ə
íoth	iː
comhdheas	ˈk ũː j a sˠ
againne	ˈa ɡ ə n̠ʲ ə
samhlú	ˈsˠ a u l̪ˠ uː
ghiob	j ɪ bˠ
stadta	ˈsˠ t̪ˠ a t̪ˠ ə
easbhaidh	ˈa sˠ w i
tuile	ˈt̪ˠ ɪ lʲ ə
diúlfaidh	ˈdʲ uː lˠ h i
buíochas	bˠ eː x ə sˠ
ll	l̪ˠ
slí	ˈʃ lʲ iː
dainséar	d̪ˠ a i nʲ ˈʃ eː ɾˠ
gharbh	ˈɣ ɑ ɾˠ ə vˠ
cúthail	ˈk uː h ə lʲ
phis	fʲ ɪ ʃ
ola	ˈɔ lˠ ə
díthairbheach	ˈdʲ iː ˌh æ ɾʲ ə vʲ ə x
mall	mˠ ɑ u l̪ˠ
riabhóg	ɾˠ i ə ˈvˠ oː ɡ
éadálach	i a̯ ˈd̪ˠ ɑː l̪ˠ ə x
buimpéis	bˠ iː mʲ ˈpʲ eː ʃ
fhágadh	ˈɑː ɡ ə x
caolas	ˈk eː l̪ˠ ə sˠ
iarracht	ˈi ə ɾˠ ə x t̪ˠ
goilliúint	ˈɡ ɪ l̠ʲ uː n̠ʲ tʲ
clairnéid	k lˠ ɑː ɾˠ ˈnʲ eː dʲ
raon	ˈɾˠ eː n̪ˠ
mbreathnaíonn	ˈmʲ ɾʲ a n̪ˠ iː n̪ˠ
leithid	ˈl̠ʲ ɛ h ə dʲ
buntús	ˈbˠ u nˠ . ˈtˠ uː sˠ
gcósta	ˈɡ oː sˠ t̪ˠ ə
agaibhse	ˈa ɡ ə vʲ ʃ ə
chiseanna	ˈç ɪ ʃ ə n̪ˠ ə
éalóigh	ˈeː lˠ ɔ j
Caoimhe	ˈk iː vʲ ə
pluma	ˈpˠ lˠ ʊ mˠ ə
fagháilt	fˠ ɑː lʲ tʲ
naofa	ˈn̪ˠ eː fˠ ə
phlainc	fˠ lˠ a ɲ c
caiseal	ˈk a ʃ ə l̪ˠ
ionnas	ˈɯ n̪ˠ ə sˠ
deiseal	ˈdʲ ɛ ʃ ə lˠ
phonc	fˠ ʊ ŋ k
gaol	ɡ eː l̪ˠ
toinne	ˈt̪ˠ ɪ n̠ʲ ə
cuireann	ˈk ɪ ɾʲ ə n̪ˠ
snaoisín	sˠ n̪ˠ iː ˈʃ iː nʲ
bhíodh	vʲ iː x
Poncán	pˠ ə ŋ ˈk ɑː n̪ˠ
broim	bˠ ɾˠ a i mʲ
fí	fʲ iː
thig	h ɪ ɟ
aincheart	ˈɑ u n̪ˠ ˌç a ɾˠ t̪ˠ
abhaill	ˈə u w ə l̠ʲ
rámhaíocht	ɾˠ ɑ̃ː ˈvˠ i ə x t̪ˠ
as	a sˠ
thá	h ɑː
feirm	ˈfʲ ɛ ɾʲ ə mʲ
mac	mˠ ɑ k
laethanta	ˈl̪ˠ eː h ə n̪ˠ t̪ˠ ə
ruaig	ɾˠ u ə ɟ
barrach	ˈbˠ a ɾˠ ə x
mairteoil	ˈmˠ a ɾʲ tʲ oː lʲ
d'aithin	ˈd̪ˠ a h ə nʲ
shaoil	h iː lʲ
coill	k iː lʲ
soipín	sˠ ə ˈpʲ iː nʲ
fhiáin	i ə nʲ
briosca	ˈbʲ ɾʲ ɪ sˠ k ə
moch	mˠ ʊ x
mhaígh	w ĩː vʲ
Béarlach	ˈbʲ eː ɾˠ l̪ˠ ə x
gceann	ɟ a u n̪ˠ
díonmhar	ˈdʲ i ə nˠ u ɾˠ
fútsa	ˈfˠ uː t̪ˠ sˠ ə
geallta	ˈɟ a u l̪ˠ t̪ˠ ə
spreagadh	ˈsˠ pʲ ɾʲ a ɡ ə
cráite	ˈk ɾˠ ɑː tʲ ə
aighneas	ˈa i . nʲ ə sˠ
beadh	bʲ ɛ x
ciotrúnta	c ɨ̞ t̪ˠ ə ˈɾˠ uː n̪ˠ t̪ˠ ə
codlatach	ˈk ɔ l̪ˠ ə t̪ˠ ə x
Cáisc	k ɑː ʃ c
har	h a ɾˠ
ball	bˠ ɑ u l̪ˠ
cruth	k ɾˠ ɞ h
gheobhadh	ˈj a u ə x
suaimhneas	ˈsˠ u ə nʲ ə sˠ
scuaid	sˠ k u ə dʲ
ceilpe	ˈc ɛ lʲ pʲ ə
oileann	ˈɛ lʲ ə n̪ˠ
thuama	ˈh u ə mˠ ə
cimileáil	c ɪ mʲ ə ˈlʲ ɑː lʲ
dá	d̪ˠ ɑː
ceannasach	ˈc a n̪ˠ ə sˠ ə x
fuaire	ˈfˠ u ə ɾʲ ə
scamall	ˈsˠ k a mˠ ə l̪ˠ
fuinneog	fʲ ɪ ˈɲ uː ɡ
chuaigh	x u ə
éilítear	ˈeː lʲ iː ɾʲ
díobhálach	dʲ iː ˈvˠ ɑː l̪ˠ ə x
fria	fˠ ɾˠ eː
ísligh	ˈiː ʃ l̠ʲ i
iomadúil	ʊ mˠ ə ˈd̪ˠ uː lʲ
tugann	ˈtˠ ʊ ɡ ə n̪ˠ
beirim	ˈbʲ ɛ ɾʲ ə mʲ
badhbh	bˠ ə i vˠ
binn	bʲ a i ɲ
Aoife	ˈiː fʲ ə
ór	oː ɾˠ
caismirt	ˈk æ ʃ mʲ ə ɾˠ tʲ
taom	t̪ˠ eː mˠ
seans	ʃ a n̪ˠ sˠ
agat	ˈa ɡ ə t̪ˠ
ríogach	ˈɾˠ iː ɡ ə x
bas	bˠ a sˠ
Vín	vʲ iː nʲ
strapaire	ˈsˠ t̪ˠ ɾˠ ɑ pˠ ə ɾʲ ə
iall	i ə l̪ˠ
bara	ˈbˠ a ɾˠ ə
cneasta	ˈc nʲ a sˠ t̪ˠ ə
meilfidh	ˈmʲ ɛ lʲ h ə
gcuraigh	ˈɡ ʊ ɾˠ ɪ ɟ
fuacht	fˠ u ə x t̪ˠ
nglacfaidh	ˈŋ lˠ a k ə
cealgaire	ˈc a lˠ ə ɡ ə ɾʲ ə
abhna	ˈoː n̪ˠ ə
beannaithe	ˈbʲ æ n̪ˠ iː
acmhainn	ˈa x vˠ ə n̠ʲ
aonbheannach	ˈeː nˠ . ˈvʲ a . nˠ ə x
tiocfad	ˈtʲ ʊ k ə d̪ˠ
achadh	ˈa x ə
dhéanfá	ˈj iː n ɑː
dúirt	d̪ˠ uː ɾʲ tʲ
mogall	ˈmˠ ɔ ɡ ə l̪ˠ
dalba	ˈd̪ˠ a lˠ ə bˠ ə
scoile	ˈsˠ k ɞ lʲ ə
gaoithe	ˈɡ iː h ə
fód	fˠ oː d̪ˠ
céalacan	ˈc i ə l̪ˠ ə n̪ˠ i
scilling	ˈʃ c ɪ lʲ ɪ ɲ
shráid	h ɾˠ ɑː dʲ
geanntracha	ˈɟ ɑː n̪ˠ t̪ˠ ɾˠ ə x iː
oileáin	ə ˈlʲ ɑː nʲ
seift	ʃ ɛ fʲ tʲ
séad	ʃ iː a̯ d̪ˠ
di	dʲ ɪ
abhras	ˈə u ɾˠ ə sˠ
bás	bˠ ɑː sˠ
níonn	n̠ʲ iː n̪ˠ
lúbaire	ˈl̪ˠ uː bˠ ə ɾʲ ə
cá	k ɑː
míol	mʲ iː l̪ˠ
Gearmáinis	ɟ a ɾˠ ə ˈmˠ ɑː nʲ ɪ ʃ
goideann	ˈɡ ɛ dʲ ə n̪ˠ
broinn	bˠ ɾˠ iː n̠ʲ
ceirbreach	ˈc ɛ ɾʲ ə bʲ ɾʲ ə x
tosnaigh	ˈt̪ˠ ɔ sˠ ə n̪ˠ ɪ ɟ
blátha	ˈbˠ lˠ aː h ə
rógaire	ˈɾˠ oː ɡ ə ɾʲ ə
Aoibhe	ˈiː vʲ ə
cana	ˈk a nˠ ə
leanbhín	lʲ a n̪ˠ ə ˈvʲ iː nʲ
déanta	ˈdʲ eː n̪ˠ t̪ˠ ə
damáiste	d̪ˠ ə ˈmˠ ɑː ʃ tʲ ə
mbeas	mʲ ɛ ɪ sˠ
bhodhraigh	ˈw oː ɾˠ ə
bochtaineacht	ˈbˠ ɔ x t̪ˠ ə nʲ ə x t̪ˠ
cuisliméara	ˈk ɪ ʃ lʲ ə mʲ eː ɾˠ ə
scannán	sˠ k ə ˈn̪ˠ aː n̪ˠ
snaga	ˈsˠ n̪ˠ a ɡ ə
ndéanfainn	ˈn̠ʲ aː n h ə n̠ʲ
chloisfeadh	ˈx lˠ ɔ ʃ ə tʲ
meáim	ˈmʲ ɑː mʲ
éadtualaing	ˈeː d̪ˠ ɔ l ə n
soc	sˠ ɔ k
spreagtha	ˈsˠ pʲ rʲ a k ə
ciardhubh	ˈc i ə ɾˠ ɣˠ ʊ vˠ
cúil	k uː lʲ
h	h
mílte	ˈmʲ iː l̠ʲ tʲ ə
dath	d̪ˠ a h
síolraigh	ˈʃ iː l̪ˠ ɾˠ ɪ ɟ
méadaigh	ˈmʲ eː d̪ˠ ɪ ɟ
giúistís	ˈɟ uː ʃ tʲ i ʃ
breithimh	ˈbʲ ɾʲ ɛ h ə vʲ
iománaíocht	ə ˈmˠ ɑː n̪ˠ i ə x t̪ˠ
chos	x ɔ sˠ
cuntar	ˈk uː n̪ˠ t̪ˠ ə ɾˠ
rún	ɾˠ uː n̪ˠ
briseann	ˈbʲ ɾʲ ɪ ʃ ə n̪ˠ
dúiseacht	ˈd̪ˠ uː ʃ ə x t̪ˠ
amhlaidh	ˈɑ̃ ũ l̪ˠ ɪ ɟ
sméar	sˠ mʲ i a̯ ɾˠ
draighean	ˈd̪ˠ ɾˠ a i ə n̪ˠ
gaosán	ɡ eː ˈsˠ ɑː n̪ˠ
péiste	ˈpʲ eː ʃ tʲ ə
eascaine	ˈa sˠ k ə nʲ ə
shagart	ˈh a ɡ ə ɾˠ t̪ˠ
bolraíoch	ˈbˠ ɔ lˠ ɾˠ i a x
bhfeiceanna	ˈvʲ ɛ c ə n̪ˠ ə
caoimhe	k iː
strainséir	sˠ t̪ˠ ɾˠ ɑː nʲ ˈʃ eː ɾʲ
bréige	ˈbʲ ɾʲ eː ɟ ɪ
Ulaidh	ˈʊ l̪ˠ ɪ ɟ
cóiriú	ˈk oː ɾʲ uː
ceintiméadar	c ɛ nʲ tʲ ə ˈmʲ eː d̪ˠ ə ɾˠ
thusa	ˈh ʊ sˠ ə
Rosa	ˈɾˠ ɔ sˠ ə
fóirsteanach	ˈfˠ ɔː ɾˠ sˠ tʲ ə nʲ a x
sú	sˠ uː
faighigí	ˈfˠ ɑː h iː
chéad	ç eː d̪ˠ
paragraf	ˈpˠ a ɾˠ ə ɡ ɾˠ a fˠ
ciardhuibhe	ˈc i ə ɾˠ ɣ ɪ vʲ ə
dtreo	dʲ ɾʲ oː
clamhsán	ˈk lˠ a u sˠ ɑː nˠ
gaineamh	ˈɡ ɑ nʲ ə vˠ
mús	mˠ uː sˠ
dúlamán	d̪ˠ uː l̪ˠ ə ˈmˠ ɑː n̪ˠ
beireadh	ˈbʲ ɛ ɾʲ ə x
tháthaigh	h aː j
d'fhreagair	ˈdʲ ɾʲ a ɡ ə ɾʲ
clogaide	ˈk lˠ ɔ ɡ ə dʲ ə
d'ullmhaigh	ˈd̪ˠ ʊ l̪ˠ ə vˠ ɪ ɟ
nochtacht	ˈn ɔ x t̪ˠ ə x t̪ˠ
aosta	ˈeː sˠ t̪ˠ ə
barúlach	bˠ a ˈɾˠ uː l̪ˠ ə x
thuig	h ɪ ɟ
bearraim	ˈbʲ aː ɾˠ ə mʲ
easpaig	ˈa sˠ pˠ ɪ ɟ
stá	sˠ t̪ˠ ɑː
sciathán	sˠ c i ə ˈh ɑ̃ː n
cuach	k u ə x
bainis	ˈb a nʲ ə ʃ
grád	ɡ ɾˠ ɑː d̪ˠ
péin	pʲ eː nʲ
gcuan	ɡ u ə nˠ
falsa	ˈfˠ a l̪ˠ sˠ ə
síobadh	ˈʃ iː bˠ ə
gnóthaigh	ɡ ɾˠ uː
cáis	k ɑː ʃ
ciseán	c ɪ ˈʃ aː n̪ˠ
gaoth	ɡ eː h
téaltó	tʲ i a̯ l̪ˠ ˈt̪ˠ oː
haill	h ɑː l̠ʲ
neamhshuimiúil	ˈn̠ʲ ã u h ɨ̞ mʲ u lʲ
ea	a
gnách	ɡ n̪ˠ ɑː x
fhada	ˈɑ d̪ˠ ə
bóthar	ˈbˠ oː h ə ɾˠ
bhris	vʲ ɾʲ ɪ ʃ
Nollaigí	ˈn̪ˠ ɔ l̪ˠ ə ɟ iː
drong	d̪ˠ ɾˠ ɔ ŋ
chráigh	x ɾˠ aː ɟ
clú	k l̪ˠ uː
téanam	ˈtʲ i a̯ n̪ˠ ə mˠ
dealbh	ˈdʲ a lˠ ə vˠ
neamartach	ˈn̠ʲ a mˠ ɔ ɾˠ t̪ˠ a x
scaid	sˠ k æ dʲ
lonta	ˈl̪ˠ ʊ n̪ˠ t̪ˠ ə
corr	k ə u ɾˠ
réimeanna	ˈɾˠ eː mʲ ə n̪ˠ ə
chnuic	x n̪ˠ ɪ c
nach	n̪ˠ a x
ghreadadh	ˈj ɾʲ a d̪ˠ u
gheallta	ˈj a u l̪ˠ t̪ˠ ə
leoraí	ˈlʲ ɔ ɾˠ iː
léan	lʲ iː a̯ n̪ˠ
ch	x
huile	ˈh ɪ lʲ ə
faill	fˠ ɑ i lʲ
naoscainn	ˈn̪ˠ iː sˠ k ə n̠ʲ
rialtais	ˈɾˠ i ə l̪ˠ t̪ˠ ə ʃ
cuarc	k u ə ɾˠ k
comhar	k õː ɾˠ
glaoigh	ɡ l̪ˠ iː
péacán	pʲ eː ˈk ɑː n̪ˠ
sloinne	ˈsˠ l̪ˠ ɪ n̠ʲ ə
faighte	ˈfˠ ɑ tʲ ə
cleasaí	c lʲ a ˈsˠ iː
Mhí	vʲ iː
giosta	ˈɟ ɪ sˠ t̪ˠ ə
chíd	ˈç iː dʲ
caipín	k ɑ ˈpʲ iː nʲ
chás	x ɑː sˠ
doirse	ˈd̪ˠ oː ɾˠ ʃ ə
trácht	t̪ˠ ɾˠ ɑː x t̪ˠ
olca	ˈɔ lˠ k ə
sileadh	ˈʃ ɪ lʲ ə
síoraí	ʃ iː ˈɾˠ iː
ghnách	ɣ n̪ˠ ɑː x
paidir	ˈpˠ ɑ dʲ ə ɾʲ
geala	ˈɟ a lˠ ə
tréin	tʲ ɾʲ eː nʲ
loirgim	ˈl̪ˠ ɞ ɾʲ ɪ ɟ ə mʲ
óige	ˈoː ɟ ɪ
chontráilte	ˈx uː n̪ˠ t̪ˠ ɾˠ ɑː l̠ʲ tʲ ə
triail	tʲ ɾʲ i ə lʲ
cheo	ç oː
cnámh	k n̪ˠ ɑː vˠ
romhat	ɾˠ uː t̪ˠ
ngeimhreadh	ˈɲ iː ɾʲ ə
thaiscigh	t̪ˠ æ ʃ c ɪ
dhéag	j eː ɡ
oiltear	ˈɛ lʲ tʲ ə ɾˠ
beidh	bʲ ɛ ɟ
áiféis	ɑː ˈfʲ eː ʃ
áiteacha	ˈɑː tʲ ə x iː
thuigfeadh	ˈh ɪ c ə x
dh'	ɣ
bhall	vˠ ɑ u l̪ˠ
liopard	ˈlʲ i . pˠ ə ɾˠ dˠ
aoibhinn	ˈiː vʲ ɪ ɲ
iarrfaidh	ˈi ə ɾˠ h ə
Chian	ç i ə nˠ
nd	n̪ˠ
taoisigh	ˈt̪ˠ iː ʃ ɪ ɟ
ceannach	ˈc a n̪ˠ ə x
rath	ɾˠ ɑ h
cuma	ˈk ʊ mˠ ə
tabharfad	ˈt̪ˠ uː ɾˠ h ə d̪ˠ
trasinscneach	t̪ˠ ɾˠ a sˠ ˈɪ n̠ʲ ʃ c nʲ ə x
pána	ˈpˠ ɑː n̪ˠ ə
coll	k a l̪ˠ
comhchruinniú	ˈk ũː x ɾˠ ɨ̞ n̠ʲ u
prásach	ˈpˠ ɾˠ ɑː sˠ ə x
bac	bˠ ɑ k
colm	ˈk ɔ l̪ˠ ə mˠ
matrarcach	ˈmˠ ɑ t̪ˠ ɾˠ ə ɾˠ k ə x
dumha	ˈd̪ˠ ũː . i
déine	ˈdʲ iː nʲ ə
leáis	l̠ʲ ɑː ʃ
mbád	ˈmˠ ɑː d̪ˠ
caisleán	k ə ˈʃ lʲ ɑː n̪ˠ
deargadh	ˈdʲ a ɾˠ ə ɡ ə
inne	ˈɪ n̠ʲ ə
féilire	ˈfʲ eː lʲ ə ɾʲ ə
cata	ˈk ɑ t̪ˠ ə
tharlódh	ˈh ɑː ɾˠ l̪ˠ oː tʲ
speisialta	ˈsˠ pʲ ɛ ʃ i ə l̪ˠ t̪ˠ ə
gliocas	ˈɟ l ʊ k ə sˠ
tur	t̪ˠ ʊ ɾˠ
stádas	ˈsˠ t̪ˠ ɑː d̪ˠ ə sˠ
bhróga	ˈvˠ ɾˠ oː ɡ ə
eallach	ˈa l̪ˠ ə x
faighidh	ˈf ˈa i ə
prioc	pʲ ɾʲ ʊ k
féadaim	ˈfʲ eː d̪ˠ ə mʲ
bhlais	vˠ l̪ˠ a ʃ
conartha	ˈk ʌ n̪ˠ ə ɾˠ ə
cnocán	k n̪ˠ ə ˈk ɑː n̪ˠ
daichead	ˈd̪ˠ a . h ə d̪ˠ
go	ɡ ɔ
gcéibh	ˈɟ eː vʲ
muirir	ˈmˠ ɪ ɾʲ ə ɾʲ
alta	ˈa l̪ˠ t̪ˠ ə
eachtra	ˈa x t̪ˠ ɾˠ ə
Eabhrac	ˈə u ɾˠ ə k
liúr	lʲ uː ɾˠ
stadaim	ˈsˠ t̪ˠ ɑ d̪ˠ ə mʲ
coscairt	ˈk ɔ sˠ k ə ɾʲ tʲ
déarfadh	ˈdʲ eː ɾˠ h ə x
torann	ˈt̪ˠ ɔ ɾˠ ə n̪ˠ
moladh	ˈmˠ ɔ l̪ˠ ə
choscair	ˈx ɔ sˠ k ə ɾʲ
cháiliúil	x ɑː ˈlʲ uː lʲ
d'íosfadh	ˈdʲ iː s ə tʲ
Éirinn	ˈeː ɾʲ ə n̠ʲ
goib	ɡ ɪ bʲ
brón	bˠ ɾˠ oː n̪ˠ
ceonna	ˈc oː n̪ˠ ə
dhearnas	ˈj aː ɾˠ n̪ˠ ə sˠ
spéis	sˠ pʲ eː ʃ
seic	ʃ ɛ c
Naoise	ˈn̪ˠ iː ʃ ə
Adhamhnán	ˈiː nˠ a nˠ
gáire	ˈɡ ɑː ɾʲ ə
dhíot	j iː t̪ˠ
callóid	ˈk a u lˠ æ dʲ
biachlár	ˈbʲ i ə x lˠ ɑː ɾˠ
seanscéal	ʃ a n̪ˠ ˈʃ c i a l̪ˠ
cumas	ˈk ʊ mˠ ə sˠ
biail	bʲ i ə lʲ
dráma	ˈd̪ˠ ɾˠ ɑː mˠ ə
tafann	ˈt̪ˠ a u̯ h ə n̪ˠ t̪ˠ
tábhacht	t̪ˠ ɑː x t̪ˠ
anfa	ˈa nˠ ə fˠ ə
úsáideoir	uː ˈsˠ ɑː dʲ oː ɾʲ
imirt	ˈɪ mʲ ə ɾˠ tʲ
breoim	bʲ ɾʲ oː mʲ
Mícheál	ˈmʲ iː ɑː l̪ˠ
sealga	ˈʃ a l̪ˠ ə ɡ ə
cliabhrach	ˈc lʲ i ə vˠ ɾˠ ə x
spíon	sˠ pʲ iː n̪ˠ
pléigh	pʲ lʲ eː ɟ
abú	ə ˈbˠ uː
uaimse	ˈw æ mʲ ʃ ə
rópa	ˈɾˠ oː pˠ ə
crosta	ˈk rˠ ɔ s̪ˠ t̪ˠ ə
nóiméad	ˈn̪ˠ uː mʲ eː d̪ˠ
gort	ɡ ʌ ɾˠ t̪ˠ
spealadóir	sˠ pʲ a l̪ˠ ə ˈd̪ˠ oː ɾʲ
feadha	fʲ ɑː
amhráin	ə u ˈɾˠ ɑː nʲ
tagtar	ˈt̪ˠ a ɡ t̪ˠ ə ɾˠ
préachán	pʲ ɾʲ iː ˈx ɑː n̪ˠ
goirid	ˈɡ ɨ̞ ɾʲ ə dʲ
conairt	ˈk ɔ n̪ˠ ə ɾˠ tʲ
brúitín	bˠ ɾˠ uː ˈtʲ iː nʲ
buaigh	bˠ u ə ɟ
pós	pˠ oː sˠ
féarach	ˈfʲ i a r ə x
bun	bˠ ʊ n̪ˠ
anagheairid	ɑ n ɑ ˈj a ɾʲ ə dʲ
tair	t̪ˠ a ɾʲ
píb	pʲ iː bʲ
beorach	ˈbʲ oː ɾˠ ə x
faigh	fˠ ə i
gréasáin	ɟ ɾ i a ˈsˠ ɑː nʲ
ceap	c a pˠ
maireachtáil	ˈmˠ a ɾʲ ə x t̪ˠ ɑː lʲ
suíomh	sˠ iː vˠ
pictiúr	pʲ ɪ c ˈtʲ uː ɾʲ
éagaoin	ˈeː ɡ iː nʲ
áibhéis	ˈaː vʲ ɛ ʃ
lios	l̠ʲ ɪ sˠ
tslabhradh	ˈt̪ˠ lˠ a u ɾˠ u
deol	dʲ oː l̪ˠ
cnáimh	k n̪ˠ ɑː vʲ
smigín	sˠ mʲ ɪ ˈɟ iː nʲ
fiar	fʲ i ə ɾˠ
bua	bˠ u ə
ríomh	ɾˠ iː vˠ
briste	ˈbʲ ɾʲ ɪ ʃ tʲ ə
amscaí	ˈa mˠ sˠ k iː
chistin	ˈç ɪ ʃ tʲ ə nʲ
maise	ˈmˠ a ʃ ə
ach	ɑ x
thorann	ˈh ɔ ɾˠ ə n̪ˠ
dreoite	ˈdʲ ɾʲ oː tʲ ə
mire	ˈmʲ ɪ ɾʲ ə
rua	ɾˠ u ə
