دار	d ɑ r
سلفراسید	s ʊ l f r ɑ s i d
تاوتریخجنټکونه	t ɑ w t r i x d͡ʒ n ʈ k o n ə
ځانه	ʐ ɑ n a
کیږی	k iː ʒ iː
ابن	ɑ b n
لېونی	l e w a n a i
ډریور	ɖ r ɪ j ə r
بدنروغ	b ə d n r o ɣ
ټولد	ʈ o l d
وساتی	w s a t i
غنمو	ɣ n ə m o
بوډا	b o ɖ ɑ
پخوراکي	p x o r ɑ k i
کړي	k ə ɽ i
اوسسطل	ɑ w s s t l
جګړن	d͡ʒ ə ɡ ɺ ˞ ə n
برابر	b a r ɑ b a r
کڅوړوبارکول	k ʈʂ ʊ ɽ ʊ b ɑ r k ʊ l
پوهیدم	p w h i d m
طبیعت	t̪ ə b iː ʕ ə t̪
میلیونو	m i l i w o n w o
تیږو	t i ʐ u
کړو	k ɽ u
سلطنت	s ə l t ə n ə t
غوول	ɣ o w ə l
ښکار	x k ɑ r
قه	q ə
ځېل	d͡z e l
ډولهمېږيان	ɖ o l ə m ʐ i ɑ n
سترګه	s t̪ ə r ɡ a
کالنی	k ɑ l a n a i
لورده	l o r d ə
مرغان	m ə r ɣ ɑ n
غلا	ɣ l ɑ
قومن	q o m n
ټنډه	ʈ ə n ɖ a
خوه	x w ə h
اوبوته	o b o t ə
ککړ	k k ɻ
داد	d ɑ d
ناوړه	n ɑ w ɽ a
همت	h ə m t
ګورم	ɡ o r ə m
سندرې	s ʊ n d r ə i
واخلئ	w ɑ x l ə
ډولو	ɖ o l o
نجونې	n d͡ʒ o u n e
ټبر	ʈ a b a r
ولسوالۍ	w ə l ə s w ɑ l ə i
سخت	s x t
کسوویلزه	k s o w i l z ə
اوسیده	ɑ o s i d a
شکلو	ʃ k l o
تمرین	t̪ ə m ɾ iː n
تښتید	t ʂ t i d
خل	x ə l
ښارونه	x ɑ r o n a
لوړل	l o ɽ ə l
چوپړ	t͡ʃ o p ə ɻ
نوم	n o m
تادل	t aː d l
بسکړل	b s k ɽ l
خويندو	x w i n d o
پوهاند	p o h ɑ n d
سیندونو	s i n d o n o
خبرد	x b r d
خولی	x o l i
زاڼه	z ɑ ɳ a
خوخرغمجن	x w x r ɣ m ʤ n
پراخې	p r ɑ x e
نوکغوڅی	n u k ɣ w ə t͡s a i
غپل	ɣ a p ə l
بندې	b n d e
استراحتسره	a s t r a h t s r h
نهو	n ɛ h o
کیلومتره	k i l o m t̪ r e
لامل	l ɑ m ə l
خوښۍ	x o ʂ ə i
ډیرو	ɖ i r ʊ
کتل	k a t ə l
بېرته	b e r t a
اسټراليا	a s ʈ r ɑ l j ɑ
واورېد	w a w r e d
زړه	z ɻ ə
پراختیا	p r ɑː x t iː ɑː
فرانسه	p r ɑ n s a
بیا۵	b i ɑ 5
دښته	d x t h
برېت	b r e t̪
روانه	ɾ w a n h a
رامين	r ɑ m i n
سپره	s p ə r a
ویې	w iː e
مهربانه	m a h r b ɑ n a
دروغوويلو	d r o ɣ o w i l o
ننوست	n n o s t
ورشي	w ə r ʃ i
ګيټۍ	ɡ i ʈ ə i
توتي	t̪ u t̪ i
مړې	m ə ɽ e
ويلواه	w i l w ɑ h
ډالره	ɖ ɑ l ə ɾ ə
خپور	x ə p o r
زهر	z ə h r
دېو	d̪ e o
تون	t̪ u n
ډنډ	ɖ a n ɖ
ځنګلونو	ʣ ə ŋ g l w n w
بندي	b ə n d̪ i
فرانسوي	f ə r ɑ n s ə w i
لاړو	l ɑ r ʊ
زامنر	z ɑ m n r
ډیرو	ɖ iː r oː
شالي	ʃ ɑ l i
مخره	m x r ə
زیانونو	z i ɑ n o n o
غوبه	ɣ o b a
بند	b ə n d̪
نمرکزونو	n m r k z o n o
کب	k a b
دېګلی	d̪ e ɡ l a ɪ
رت	r ə t
استاد	ɑː s t ɑː d
جګ	d͡ʒ ɪ ɡ
پرېکړه	p r e k ɻ a
پاکوونکو	p ɑ k o w n k o
سبزیو	s b z i w o
ګېنډی	ɡ e n ɖ a ɪ
ارزان	a r z ɑ n
لوړوي	l o r o j
پیغام	p i ɣ ɑ m
ساپټ	s ɑ p a ʈ
نيوکه	n i w ə k a
سرو	s ə r o
ولټوله	w ʊ l t uː l ə
توکي	t̪ w k iː
پدیده	p d iː d ə
ګاډی	ɡ ɑ ɖ a ɪ
مزد	m ə z d̪
زیاتوي	z i ɑ t o w i
لېور	l e w a r
غوښتونکی	ɣ o ʂ t o n k i
اوسسطل	oː s s ʈ l
بیا۵	b i ɑ 5
تېرۀ	t̪ e r ə
سږى	s ə ɡ a ɪ
هڅې	h ʦ e
فایبر	f ɑ j b ɾ
انتقال	a n t q a l
څښي	ʈ͡ʂ ə x i
ریګ	r iː ɡ
سپیو	s p i j o
کوټ	k o ʈ
سزا	s z ɑː
برابره	b r ɑ b ə r a
کړي	k ɽ i
لوند	l u n d̪
کسوویلزه	k s uː w iː l z h
نه	n ə
ځل	d͡z ə l
باید	b ɑ j i d̪
همدې	h ʌ m d eɪ
هوښیارییب	h o ʂ j ɑ r i j b
فابریکو	f ɑ b r ɪ k o
شئ	ʃ ɑː iː
حرکت	h r k t̪
نڅا	n ʂ ɑ
دروند	d̪ r u ŋ d̪
بابل	b ɑ b ə l
پلورونکي	p l ɔ ɾ w ə n k ə i
خوشې	x o ʂ e
زهرجن	z ə h r j ə n
ګورمنوکله	ɡ o r m n o k l e
خپله	x p ə l ə
وېرېدل	w e r e d ə l
څکل	t s k a l
خولی	x o l i
چونګښې	t͡ʃ o ŋ x e
لام	l ɑː m
غواړي	ɣ o ɑ ɽ i
هرصورت	h ə r s o r t
توپان	t̪ o p ɑ n
اپريدی	a p r i d̪ a ɪ
دروبوټ	d r w b w ʈ
كوي	k oː iː
وی	w iː
غنماو	ɣ n m ɑ w
هڅه	h a t͡s a
ژبپوهنه	ʒ ə b p o h ə n a
سخی	s x a ɪ
دبولو	d̪ b o l o
لور	l o r
مدیر	m ə d i r
تاوول	t ɑ w a w ə l
مرګاويا	m r ɡ aː w j a
هیل	h i l
پښتنه	p a x t̪ a n a
اړیکه	ɑː ɖʐ iː k ə
ناسم	n ɑ s ə m
زوئلا	z w ʔ l a
ګوړه	ɡ w ə ɽ a
خت	x ə t̪
لارۍ	l ɑ r ə i
اوښخر	ɑ w x kʰ r
ما	m ɑ
تاوتریخجنټکونه	t ɑː w t r i x d͡ʒ n ʈ k uː n ə
پوستکی	p w s t k i
اګل	a ɡ a l
شپه	ʃ p a
فضا	f ə z ɑː
زیانهم	z iː ɑː n ə h m
کوونکی	k o w ə n k i
غیر	ɣ a i r
مشورې	m ʂ o r e
بچیان	b ə t͡ʃ iː ɑː n
سیټ	s iː ʈ
ریس	r i s
تند	t ə n d
کوچنی	k u t͡ʃ n a i
روانه	r w a n h
اړه	ɑ ɻ ə
زهرجن	z ə h r ʤ n
سیند	s iː n d
شيګره	ʃ i ɡ a r a
مل	m ʊ l
هرکار	h ə r k ɑ r
نيا	n j ɑ
کیمیاوی	k i m i ɑ w i
لشه	l a ʃ a
زوړ	z w r
سمیرا	s m iː r ɑ
کمښت	k ə m ʂ t
پرتله	p a r t̪ a l a
وران	w r ɑː n
ژررانه	ʒ r r ɑː n ə
سندره	s n d r e
اتيا	a t̪ j ɑ
غويی	ɣ w a j a ɪ
درنکړم	d r n k ɽ m
ویلو	w iː l uː
درجې	d r ə d͡ʒ e
اري	a r i
شهزادګۍ	ʃ ə h z ɑ d ɡ e
ياله	j ɑ l ə
یوازې	y o a z e
ارزښت	a r z ə x t̪
نوي	n a w i
دروغویلو	d̪ r o ɣ o w i l o
کورله	k o r l ə
ژغورلې	ʐ ɣ w r l e
پخلی	p ə x l a i̯
تېر	t̪ ɛ r
اوبدل	o b d̪ ə l
ټاکلي	ʈ ɑ k l i
خپلک	x p ə l k
وضعیت	w z ʕ i t
پرانستل	p r ɑː n s t l
ډا	ɖ ɑ
پتخ	p a t a x
ژامه	ʒ ɑ m a
وتلو	uː t l u
لوښي	l o ʃ i
امن	ɑ m n
بغور	b ə ɣ w ə r
زامنر	z ɑ m n ə r
اورلوبه	o r l o b a
مۍ	m ə iː
خپلک	x p ə l k
بيول	b i w ə l
اغېزه	a ɣ e z h a
ګول	ɡ o l
کړل	k ɽ l
کړل	k ɻ ə l
وټاکي	w ʈ ɑ k i
ټوکو	ʈ ə w k o
رسنۍ	r ə s ə n a i
ښود	x u d
بیه	b i h
واړ	w ɑ ɽ
لږوو	l ʈ͡ʂ o w
آيات	ɑ j ɑ t̪
ویده	w iː d ə
دړ	d̪ ə ɺ ˞
ګرانی	g r ɑ n i
خوبه	x o b e
سورخالو	s o r x ɑ l o
وېښتان	w e ʃ t̪ ɑ n
معتدل	m uː ʕ t ə d ə l
سورلنډی	s u r l ə n ɖ a i
آره	ɑ r a
بارکړم	b ɑː r k ɹ ə m
واخلي	w ɑ x l i
يونی	y u n a i
کونج	k o u n d͡ʒ
پاکوونکو	p aː k uː w n k u
مليکنه	m l i k n h a
ځایه	ʐ ɑː j ə
اغیزمنه	ɑː ɣ iː z m ʊ n ə
شیه	ʃ i h
اسپانيا	ɑ s p ɑ n j ɑ
دکار	d k ɑ r
سهارریما	s ə h ɑ r r i m ɑ
کړیوه	k ɹ iː oː h ə
ریګنه	r iː ɡ ə n ə
وویل	w w iː l
چوڼيا	t͡ʃ u ɳ j ɑ
چونګښې	t͡ʃ uː ŋ x e
ډبل	ɖ a b ə l
پاړو	p ɑ ɻ u
زیاتې	z i ɑ t ɛ
شکر	ʂ k r
پراخې	p r ɑː x e
ماتی	m ɑː t iː
ښځه	x ə d͡z a
غوړ	ɣ oː ɖʐ
کړم	k ɽ m
موند	m u n d
ټولنیزه	ʈ o l n i z a
کوټې	k ʊ ʈ ə i
ژوندی	ʒ w ə n d̪ a i
ځينې	d z i n e
خولې	x o l e
ویده	w i d h a
څیرې	t͡s i r e
لوړې	l u ɾ e
زمااندازه	z m ɑ ɑ n d ɑ z ə
دوبي	d̪ o b i
پاڼه	p ɑ ɳ a
اوربشې	a w r b ʃ e
سرطان	s r ʈ ɑ n
راته	r ɑ t ə
موقعیت	m oː q ɑː ʕ iː t
خل	x l
اوارخطاوه	o ɑː r x ʊ t ɑː w ə
دریم	d̪ r i m
مېوه	m e w e
پیرودلو	p i r o d̪ l o
کافی	k ɑ f i
اته	a t̪ ə
زمانېښد	z m ɑ n e x d̪
راټولیږي	ɾ a ʈ u l i ʐ i
اوړېدل	a w ɽ e d ə l
تانوکی	t̪ ɑ n u k a ɪ
ناوړه	n ɑ w ɽ ə
وغواړی	w ɣ w ɑː r i
ښکلیدیزه	ʂ k l i d i z ə
زهر	z ʊ h r
کسانو	k s ɑː n uː
کیمیاوي	k i m i ɑ w i
مني	m a n i
دیچی	d i c i
وړلی	w ɻ l i
ایستل	ɑ j s t l
کو	k o
پنځوس	p ə n d z o s
وګوره	w ə ɡ u r ə
مهمه	m ɛ h m ɛ
وګړپوهنه	w ə ɡ ə ɻ p o h ə n a
جنګ	d͡ʒ ə ŋ ɡ
ګردی	ɡ ə r d̪ a i
ځینې	ʣ i n e
شونی	ʃ o n a i
منټ	m ɪ n ə ʈ
صنعتونو	s n ʕ t w n w
ویلي	w i l i
راځی	r ɑː ʐ i
يوهنخيتار	j u h n x iː t ɑː r
لوړوي	l ʊ r ʊ j
سټک	s a ʈ a k
ورسره	w ə r s r ə
همبرداشت	h m b r d ɑ ʂ t
بابل	b ɑ b l
پیدا	p i d ɑ
لیوالتیا	l j o w ɑ l t j ɑ
ونډه	w ʊ n ʈ ə
حرکت	h r k t
منظم	m ə n z̪ ə m
ګډی	ɡ ə ɖ a ɪ
پلاره	p l aː r h
پرېز	p a r e z
مسموم	m ə s m uː m
اشخاصو	ɑ ʃ x ɑ s ə w
نولسمې	n o l s ə m e
بونا	b o n ɑ
څښم	ʦ ʊ m
تږییی	t ʒ i i i
شډل	ʃ ə ɖ ə l
نړیوالو	n ɻ j w a l o
یاد	j ɑ d
اص	ɑ s
اوبو	ɑ w b o
ڼږ	ɳ ʒ
نومونه	n o m u n e
آزاد	ɑ z ɑ d
جهيل	d͡ʒ ə h i l
ډیری	ɖ i r i
ګټه	ɡ ə ʈ a
سبزي	s ə b z i
ورکړل	w ə r k ɽ ə l
ماما	m ɑ m ɑ
پوستکی	p uː s t k iː
شونیه	ʃ o n iː a
نجونې	n ə d͡ʒ u n e
اويم	o j ə m
ګرد	ɡ ə r d
اوولس	u w ə l a s
فعالوي	f ʕ ɑ l o i
انتقال	ɑ n t ɪ q ɑ l
همغږي	h ə m ɣ ʐ i
څرخیدو	ʂ r x iː d oː
لرم	l r m
شامل	ʂ ɑ m l
مړۍ	m a ɺ̢ ə i̯
جریان	d͡ʒ r i ɑ n
انسانانو	ɑ n s ɑ n ɑ n o
ونيو	w n i w
دویو	d o w iː o
وخه	w x ə
کوي	k o w i
افریقایي	ɑ f r i q ɑ i i
مګرولې	m ɡ r w l eː
ننوتلو	n ə n o t̪ l o
وایم	w ɑ j m
جلا	d ʒ ə l ɑ
وزن	w z n
درلودله	d ə r l u d ə l ə
صنعت	s n ʕ t
واخیسته	w ɑː x iː s t ə
شکلو	ʃ ʊ k l ʊ
څپېړه	t͡s a p e ɽ a
پايول	p ɑ y a w ə l
وړيا	w ə ɻ j ɑ
سړک	s ɖ k
ګرمدیځ	ɡ ə r m d i ʐ
اويو	oː iː oː
کرکره	k a r k a r a
ومومي	w m u m i
ماته	m ɑ t ə
خردرلود	x ə r d̪ ə r l o d̪
کوو	k o w
نیمه	n i m ə
ځایونه	ʒ ɑ j ə w ə n ə
شهزادګۍ	s h z a d g e
اغیزه	ɑː ɣ iː z ə
آیایا	ɑ i ɑ i ɑ
هدف	a d ə p
ښکلی	x k w ə l a i
پوهیږم	p o h i ʝ m
وکولیشم	w k o l i ʃ m
اسمان	a s m ɑ n
خاندي	x ɑ n d i
شم	ʃ m
توازنیی	t o a z n i i
چلولو	t͡ʃ l w l w
تانۀ	t̪ ɑ n ə
دېګ	d̪ e ɡ
روغتيا	r o ɣ t j ɑ
اخیستلو	ɑː x iː s t l uː
پوه	p o h
سورپوستکي	s o r p o s t k i
ورزشته	w o r z ʃ t ə
کاف	k ɑː f
هیوادونه	h iː w ɑ d o n a
ماښامه	m ɑː x ɑː m a
ووینه	w o w i n ə
اسانۍ	ɑ s ɑ n ə i̯
نومونو	n o m u n o
روغتون	r o ɣ t̪ u n
وويلهو	w ə w i l ə h ə w
ابنسینایو	ɑ b n s i n ɑ j o
اوواښه	a w w a x h
غښتل	ɣ ə x t̪ ə l
درېدل	d̪ r e d̪ ə l
نیشکیبی	n i ʂ k i b i
رسوي	r ə s w i
وغواړی	w ɣ w ɑ ɻ i
پروت	p r o t̪
غونډیو	ɣ o n ɖ iː o
پاي	p a i
يوازېتو	j o ɑ z e t o
ککړونکي	k ʊ k ɔ ɻ ʊ n k i
راوستل	r ɑ w ə s t̪ ə l
راشي	r ɑ ʃ i
بلکې	b ə l k e
بوټو	b o ʈ o
ورځندا	w r z n d ɑ
اړم	ɑ ʂ m
نولسمې	n uː l s m e
اوسیدونکو	ɑ w s i d u n k o
اوویې	ɑ w o v e
پدی	p ə d i
اپریکړه	ɑ p r i k ɽ a
پیښیږي	p i ʂ i ʐ i
يوازېتو	j o ɑ z e t o
ذکر	z ɪ k ə r
می	m i
ډکتاج	ɖ ə k t ɑ j
رنګرومي	r n ɡ r ʊ m i
ځړول	ʐ ə r o l
کتلرامين	k ə t ə l ə r ɑ m i n
ليدل	l i d ə l
میوې	m i w e
وختوه	uː x t uː h
ارما	ɑ r m ɑ
شومېر	ʃ u m e r
بوى	b u j
شل	ʃ ə l
نړیواله	n r j w ɑ l ə
ژوپوهنه	ʒ o p o h ə n a
خوښي	x w ʈ͡ʂ i
هیوادونو	h i w ɑ d w o n o
ګلانو	ɡ l a n u
ګازونه	ɡ ɑ z u n e
بڼ	b a ɳ
ووایم	w o ɑ j m
آسیم	ɑː s iː m
افو	ɑ f o
کو	k o
کېدل	k e d ə l
لورته	l o r t a
انګلستان	e ŋ ɡ l ɪ s t̪ ɑ n
وده	w ə d a
لویانو	l w j ɑ n w
اېکوادور	e k w ɑ d o r
نیسي	n i s i
ګواښوي	ɡ w ɑ ʂ o i
نولس	n u l a s
کثافا	k ʂ ɑ f ɑ
تقویم	t ɑ q w i m
وموند	uː m uː n d
چیر	t͡ʃ i r
درزونه	d ə r z u n ə
ویښتان	w i ʂ t ɑ n
سکالو	s k ɑ l o
کلتور	k ʊ l t̪ u r
غواړي	ɣ w ɑː r i
کمښت	k ʊ m x t
قومن	q oː m n
چاکلیټ	t͡ʃ ɑ k l i ʈ
سروه	s r oː h ə
بدنروغ	b d n r oː ɣ
پرته	p ə r t ə h
نولسمې	n o l s m e
ثانيه	θ ɑ n i e
دروغویلو	d r uː ɣ w iː l u
ليکوال	l i k w ɑ l
سیمې	s i m e
مېشکوړ	m e ʃ k o ɻ
ترسره	t r s r ə
ونشي	v ə n ʃ iː
خپلو	x p ə l o
زه	z ə
حیوان	ħ i w ɑ n
واخلي	w ɑ x l i
لوري	l uː r i
حشرات	h ʃ r ɑː t̪
وه	w ə
ووایم	w o ɑ i m
حیرانتیا	ħ iː r ɑː n t iː ɑː
څنډه	t s ə n ɖ a
غلط	ɣ a l a t̪
عاد	ʕ ɑ d
ولاړ	w o l ɑ ɻ
ډېره	ɖ e r ə
ښاد	ʂ ɑ d
غریب	ɣ ə r iː b
اد	a d
لاملکیدی	l ɑ m ə l k i d i
شیدې	ʃ i d e
جام	d͡ʒ ɑ m
خورن	x ʊ r n
مودې	m o d e
پنجره	p n ʤ r a
پایه	p ɑ j e
مترو	m ə t r oː
تور	t̪ o r
درملپوهنه	d̪ ə r m ə l p o h ə n a
تیز	t iː z
زغمل	z ɣ a m ə l
ډکدی	ɖ k d i
اوربشې	o r b ə ʃ e
دیو	d i w
معاشونه	m ʕ ɑ ʃ o n ə
ځغلم	d z ɣ ə l ə m
تيپي	t̪ i p i
باندې	b ɑ n d e
لرغوني	l r ɣ u n i
زبرځواک	z ə b ə r d͡z w ɑ k
کتلرامين	k t ʊ l r ɑː m i n
انتخاب	ɪ n t ɪ x ɑː b
غورځ	ɣ oː r ʒ
کوونکې	k o w u n k ə
وياړي	w i ɑ ɽ i
کونګرى	k u n ɡ r a ɪ
ناسته	n ɑː s t ə
ورکړ	w o r k ɻ
اوسم	o s ə m
څښاک	t͡s x ɑ k
چا	tʃ aː
پې	p e
نش	n ə ʂ
خمچې	x ə m a t͡ʃ e
وینې	w i n e
بوځي	b u ʐ i
بوزېدل	b u z e d ə l
مقدار	m q d a r
شاهد	ʃ ɑ h e d
پوخ	p o ʊ x
اوويښتان	o w i x t ɑ n
لوري	l o r i
لښتو	l ə x t o
رسیدلی	r s iː d l i
پوښتلڅه	p w x t l ʂ ə h
هل	h ə l
خرسونو	x ə r s u n o
طریقه	ʈ r i q ə
والونه	w ɑ l uː n ə
همبرداشت	h ə m b ə r d ɑ ʂ t
وزیرستان	w ə z i r ɪ s t̪ ɑ n
بهر	b h r
ملګرې	m ə l ɡ ə r e
عرب	ʕ r b
سرونو	s r o n o
ډګرونو	ɖ ə ɡ ɾ o n o
وچکړه	w t͡ʃ k ɻ a
ورځو	w o r ʐ o
ګرانو	ɡ ə ɾ ɑ n o
نرخونه	n ə ɾ x w n ə
څنګ	t s a n ɡ
ورکول	w a r k a w ə l
ماهم	m ɑ h m
شګو	ʃ ɡ w
کلونو	k l o n o
زهٔ	z ə
بېل	b e l
لمانځل	l m ɑ n d͡z ə l
رسیدلی	r ə s i d ə l i
ډیرو	ɖ iː r o
شرکت	ʃ ə r k ə t
الرګي	ɑ l r ɡ i
زهرجن	z a h r ɟ n
بېړۍ	b e ɽ ə i
ما	m ɑː
ای	ɑ i
زیانمنه	z i ɑ n m ə n ə
موټک	m u ʈ a k
حیرانوونکی	x iː r ɑː n ʊ w ʊ n k i
ځی	d͡z a i
حبوباتو	ħ b uː b ɑː t u
سړه	s ə ɻ a
سوداګرۍ	s u d ɑ ɡ r e
ګټوره	ɡ ʈ oː r ə
يهک	j h a k
جنۍ	d ʒ i n ə i
یوربشې	j o r b ə ʂ e
ایالاتو	a j a l a t o
كوتره	k a w t̪ ə r a
پیړیو	p iː ɽ iː w
سومر	s u m ə r
ښکارکوونکو	x k ɑː r k w w n k w
نیولیوو	n i u l i u w
اوښانله	ɑ o x ɑ n l a
دهلیزو	d̪ a h l i z o
حیواناتو	x i w ɑ n ɑ t o
چارې	t͡ʃ ɑ ɾ ɛ
کښتاندونیزیا	k ʂ t ɑ n d o n i z i ɑ
روان	r w ɑ n
زمرۍ	z m a r ə i
تقویمونه	t ə q w i m u n ə
ونه	w ə n a
میوې	m i w e
منشي	m n ʂ i
خوښشوم	x w ɔ ʂ w o m
ایښو	ɑ i x o
ټاکلي	ʈ ɑː k l i
زیرکۍ	z iː r k ə
پلورنځي	p ə l o ɾ n d͡z i
حرارت	x r ɑː r ʊ t
څیړنې	ʂ iː r n e
اوسیده	ɑ w s i d ɑ
خدمتګار	x d m t ɡ ɑː r
بغری	b a ɣ a r a ɪ
دانګ	ɖ ɑ ŋ ɡ
کاربن	k ɑ r b ə n
دلی	d̪ l iː
خپره	x p r h
رامینځته	r ɑ m i n ʐ t ə
پاڅیدم	p ɑ ʦ i d m
هلکغمجنشو	h l k ɣ m d͡ʒ n ʃ u
عقل	ʕ q l
مختلف	m x t l f
کرنه	k r ə n ə
وکتل	w k t l
کونړ	k u n a ɻ
نویمنځ	n o w i m n ʂ
خړ	x ə ɻ
تېروتل	t̪ e r w a t̪ ə l
خوخرغمجن	x o x r ɣ m ʤ n
وکړ	w k ɽ
موټرد	m o ʈ r d
دوامداره	d oː ɑː m d ɑː r ə
بړستن	b ɺ ˞ ə s t ə n
نیم	n i m
نویمنځ	n ɔ j iː m ə n ʈ͡s
اوږ	o ʐ
خړه	x r ə h
بارکړم	b ɑ r k ɻ m
ګورې	ɡ o r e
اخیستلو	a x i s t l u
عدني	ʕ d n i
عقل	ɑ q l
واقعادا	w ɑ q e ɑ d ɑ
کرنې	k ə r n ə i
کېښودې	k e x o d e
دولتلیواله	d o l t l i w ɑ l ə
باکتریاوې	b ɑː k t r iː ɑː w eː
تهو	t ə w o
حیواناتو	h j w ɑ n ɑ t̪ o
سترطبیب	s ə t̪ ɾ ə t̪ b iː b
ناروغۍ	n ɑ r w ɣ e
له	l a
لږه	l ʐ ə
ونیول	w ə n i o l
حجم	ħ ə ʤ m
وهلې	w h l e
کونج	k w ə n̪ d͡ʒ
جالڅخه	d͡ʒ ɑ l ʈ͡s ə x ə
یوې	j o e
انار	a n ɑ r
اوښسپورچی	o x s p o r t͡ʃ i
مطالعه	m t ɑ l ʕ a
ګوره	ɡ o r a
غټ	ɣ a ʈ
مودې	m o d ə i̯
دلې	d̪ ə l e
صورت	s o r a t
دروازه	d r w ɑ z a
څاښکه	s ɑ x k a
کړل	k ə ɽ l
رت	r ə t
غوږونه	ɣ o ʐ o n a
درزي	d̪ a r z i
ګړند	ɡ ʂ n d
پروړه	p r o ɻ a
راوړئ	r a w ɽ ʔ
خبره	x b ə r a
يوهنخيتار	j o h ə n x i t ɑ r
څنګل	t͡s ə ŋ ɡ ə l
کېښوده	k e x u d a
اکسیجن	ɑ k s i d͡ʒ n
همېل	a m e l
سرو	s r o
ځان	d z ɑ n
وویلنه	w o j l n ə
لویاهد	l uː j aː h d
خپور	x p o ɾ
اوارخطاوه	ɑ w ɑ r x t ɑ w ə
غپېدل	ɣ a p e d ə l
ترشا	t ə r ʃ ɑ
ډاکټرانو	ɖ ɑː k t r ɑː n o
خوښشوم	x w ʂ w m
ګلان	ɡ l ɑ n
ډکدی	ɖ k ə d i
ځلی	z l i
جهيلونو	d͡ʒ ə h i l w n w
لوبډلو	l u b ɖ l u
کڅوړوبارکول	k t͡s o ɽ o b ɑ r k u l
بلې	b ə l e
موند	m o n d
اوسیدونکو	ɑ w s i d w n k w
لوستلو	l w s t l u
ییه	j i ə
اپين	a p i n
وېره	w e r a
اغیزمنه	ɑ ɣ i z m ə n ə
یوهلښته	j o h l ʂ t ə
لار	l ɑ r
ورکړي	w o r k ʂ i
بڼکی	b ə ɳ k a ɪ
سبب	s ə b ə b
نفرتوز	n f r t w z
ملکه	m l k ɛ
بکاڼه	b a k ɑ ɳ a
بڼوال	b ə ɳ w ɑ l
خپګان	x p ɡ ɑ n
لویو	l oː iː o
لګولو	l ɡ o l o
دواړه	d w ɑ ɻ a
ګړندي	ɡ ɻ n d i
دوبي	d̪ o b i
داتمو	d ɑ t m w
سمیر	s m iː r
ویشي	v iː ʃ iː
هریو	h ə r i j o
لرغونی	l ə r ɣ oː n iː
قانعکړي	q ɑ n ʕ k ə ɽ i
خواړه	x w ɑ ɻ a
مازدیګر	m ɑ z d̪ i ɡ ə r
پکان	p a k ɑ n
بیه	b i h e
شنو	ʃ n oː
زیاتې	z i j ɑ t e
بېلتون	b e l t̪ u n
مدیریت	m ə d i r i t
جنکۍ	d͡ʒ i n ə k ə i
ډولهمېږيان	ɖ o l ə m e ʐ i ɑ n
بدلېدل	b a d l e d ə l
داگر	d ɑː ɡ r
راضي	r ɑ ð i
وموندلې	w m o n d l ə
نېغه	n e ɣ ə
اې	a e
نفرتوز	n f r t o z
سیوري	s i o r i
غونډیو	ɣ o n ɖ i o
ګاونډ	ɡ ɑ w n ɖ
آيرلنډ	ɑ j r l ə n ɖ
کیږم	k i ʂ m
داتوازن	d ɑ t w ɑ z n
کېږ	k e ʐ
جنګيالی	d͡ʒ ə ŋ ɡ j ɑ l a i
ښوونه	x w u n a
كره	k a r a
روغتانۀ	r o ɣ t̪ ɑ n ə
درېږم	d a r e ɡ ə m
اصلی	ɑ ʂ l i
ستړییم	s t̪ ɻ i j i m
غږ	ɣ ʐ
جګتيا	d͡ʒ ə ɡ t̪ j ɑ
اس	a s
دماغکې	d m ɑ ɣ k ɛ
اخښی	a x a i
کوي	k o j
خپګان	x p ɣ ɑ n
اړه	ɑ ɽ ə
کوچني	k o t͡ʃ n i
غيڼ	ɣ i ɳ
دا	d̪ ɑ
کال	k ɑ l
ماهم	m ɑː h m
ډېر	ɖ e r
غوسه	ɣ uː s ə
اخښل	a x ə l
هڅې	h ʊ ʦ e
خېټه	x e ʈ a
غلام	ɣ l ɑː m
مشرهوه	m ʂ r h w a
طبیعي	ʈ b iː ʔ iː
اندېښمن	ɑ n d e x m ə n
نيلي	n i l i
څرخیدل	t͡s r x i d l
بوخت	b o x t̪
پوښتلڅه	p o x t l ʦ ɑ
ښودلې	ʂ o d l e
ښځې	x ʈʂ e
ویشي	w i ʃ i
اورې	ɑː w r e
اوم	u m
کېدای	k eɪ d aɪ
یوروبایوازې	j o ɾ o b ɑ j w ɑ z e
لوبډلو	l o b ɖ l o
حیواناتو	ħ i w ɑ n ɑ t o
ډانډ	ɖ ɑ ŋ ɖ
رامين	r ɑ m i n
وو	w o
شیشې	ʃ i ʃ e
افرادو	ɑ f r ɑ d o
شلتالو	ʃ a l t̪ ɑ l u
نېښ	n eɪ ʂ
غږېدل	ɣ a ɡ e d̪ ə l
درنده	d r n d ə h
ځینو	ʐ i n o
دېرش	d̪ e r ʃ
اوری	a u r iː
اچول	a t͡ʃ a w ə l
دملکې	d m l k ə i̯
واخلئ	w ɑ x l ʔ
وزله	w z l h
بیاګلختمي	b i ɑ ɡ l x t ə m i
مودې	m u d e
کمپیوټر	k m p i w ʈ r
ورځده	w ɾ z d a
وټاکي	w ʈ a k i
کړل	k ʊ r l
غنمو	ɣ n m o
لمسول	l ə m s ə w ə l
ماښام	m ɑ x ɑ m
چاپیریال	t͡ʃ ɑ p i r i ɑ l
وريژې	w r i ʒ e
ویده	v iː d ə
کثافات	k ə s ɑ f ɑ t
هوښیارتیا	h ʊ x j ɑː r t iː ɑ
ډولي	ɖ ə ʊ l i
کاګل	k ɑ ɡ ə l
وويل	w o i l
نا	n ɑ
هره	h ə r ə
راننوتې	r ɑ n n o t e
تويول	t o j a w ə l
ګرمدیځ	ɡ r m d i ʝ
تدابیر	t ə d ɑː b iː r
شاګردانو	ʃ ɑ ɡ r d̪ ɑ n o
آیا	ɑ j ɑ
تعقیبکړه	t ʕ ɑ q i b k ɽ ə
غوږونو	ɣ o ʐ u n o
پلاره	p l ɑ ɾ ə
وياړي	w i j ɑ ɽ i
ګراوه	ɡ r aː w h
کڅوړو	k ʈ͡ʂ o ɽ o
قوماندانییر	q w m ɑ n d ɑ n i j r
لرغونپوهنه	l ə r ɣ u n p o h ə n a
توان	t̪ o ɑ n
نړۍ	n ə ɽ ə i
موقعیت	m o q ɑ i t
ژېړ	z j a ɻ
زغره	z ɣ a r a
کړي	k ə ɽ i
شاګردانو	s a ɡ r d a n o
غوسه	ɣ o s ə
اونا	ɑ w n ɑ
مرغانو	m r ɣ ɑ n ʊ
ونډه	w n ɖ a
ګوره	ɡ oː r ə
غوښې	ɣ o x ɛ
ویلزه	w i l z ə
احمد	ɑ ħ m ə d
پوهیږي	p o h i ʐ i
صنایعو	ʂ n ɑ i̯ ʕ o
قطارونو	q t aː r u n u
کړئ	k ɻ ə
توازن	t o ɑ z n
اوریدو	o r i d o
واکمن	w ɑ k m a n
پوستکی	p o s t k i
پیښه	p i x ə
ناروغ	n a r w ɣ
حوضپوری	ħ o s p o r i
ګډون	ɡ a ɖ u n
توازنیی	t o ɑ z n i i
دبولو	d b oː l o
واقعادا	w ɑː q iː ɑː d ɑː
مالکینو	m ɑ l k i n o
ژوروالی	ʐ o r w a l i
مسؤل	m s ʔ l
نس	n a s
مۍ	m ə i̯
اچوي	a t͡ʃ o i
راغله	r ɑ ɣ l ə
یوسي	j o w s i
لومړیتوب	l o m ɻ i t̪ o b
پیسې	p i s e
کان	k ɑː n
اورګاډی	o r ɡ ɑ ɖ a ɪ
شرکت	ʂ r k t
خوبي	x uː b i
مسموم	m ə s m u m
ښکنځل	x k ə n d͡z ə l
ته	t a
شامل	ʃ ɑː m l
سوړ	s o ɻ
خورن	x o r n
اورېدونکی	a w r e d u n k a i
زموږ	e m i ʒ
معاینه	m a y n h
آزادول	ɑ z ɑ d w l
مسله	m ə s l ə
لښتي	l x t i
ګراوه	ɡ r ɑ w ə
ټوکر	ʈ u k ə r
پروسې	p ɾ u s e
ځکمی	t͡s k m i
ستونزو	s ə t u n z ə w
خوړنځی	x w ə ɻ ə n d͡z a ɪ
خدمتګار	x d m t ɡ ɑ r
قطارونو	q t ɑː r uː n uː
خرد	x r d
کلنۍ	k ə l n e
ریس	r iː s
راغلی	r ɑː ɣ l iː
او	a w
مر	m ə r
ګرمي	ɡ a r m i
خام	x ɑ m
تودوخي	t ə w d u x i
څراغولری	t͡s ə ɾ ɑ ɣ o l ə ɾ i
ورو	w r o ʊ
ساعته	s a a t h
کولوومور	k o l o w o m o r
ډېرې	ɖ e r e
خاندي	x ɑː n̪ d i
ګرځېدل	ɡ ə r d͡z e d̪ ə l
کړک	k ɚ k
سوکالۍ	s o k ɑ l e
ورته	w o r t a
ژر	ʐ r
وترنرۍ	w t r n r ə i
وړئ	w ə r ə j
اشاره	a s a r h
ورکړحمي	w o r k ɻ ħ m i
درېيمه	d ə r e j m ə
وړی	w r i
رېبز	r e b ə d͡ʒ
موټرد	m o ʈ r d
درجې	d ə r d͡ʒ e
لهشکه	l ə ʃ k ə
ښوونکې	x o w u n k e
وټه	w ə ʈ a
خونه	x u n a
اوریالته	ɑː w r iː ɑː l t̪ ə
مګرولې	m ɡ r uː l e
ګبين	ɡ a b i n
تند	t̪ n d̪
ويده	w i d ə
ډولونه	ɖ o l o n h
پاککیدی	p ɑ k k i d i
پرانیستله	p r ɑ n i s t l ə
ناړولی	n ɑ ɻ a w ɘ l a i
ویزه	w i z h a
لوړې	l o ɻ e
سرطان	s r t̪ ɑ n
اخيستل	a x i s t ə l
پاکستان	p ɑ k ɪ s t̪ ɑ n
موند	m o n d
پرانستله	p r ɑː n ə s t ə l ə
کریم	k r i m
ګۍ	ɡ e
کېیخ	k e i x
تقویمونه	t ɑː q w iː m uː n ə
کېهګۍ	k ɛ h ɡ ɛ
داسې	d ɑ s e
شاګردانو	ʃ ɑ ɡ ə r d ɑ n o
سانتيګراد	s a n t i ɡ r a d
وسایلو	w s aː j l u
کابل	k ɑ b ə l
ورکړاو	w ɔ ɾ k ɻ ɑ w
اومامي	u m ɑ m i
راولې	r ɑ w ə l e
وچلوم	w ə t͡ʃ l o m
ناک	n ɑ k
انصاف	ɑ n s ɑ f
اتڼ	a t̪ a ɳ
توده	t̪ a w d̪ a
پشۍ	p ə ʃ ə i̯
غمجن	ɣ a m d͡ʒ a n
ساړه	s ɑ ɺ̢ ə
پایلوڅخه	p ɑ i l u t͡s x ə
اندیښنه	ɑ n d i x n ə
هوکړه	h o k ɻ a
دروزه	d̪ r u z a
وزن	w o z n
ام	ɑ m
ځلانده	t͡s l ɑ n d a
ښځی	x z i
شی	ʃ i
هوي	h oː iː
ګېډه	ɡ e ɖ a
ژمي	ʒ ə m i
سلطنت	s ə l t̪ n ə t
بیر	b i r
ابنسینایو	ɑ b n s i n ɑ j o
وران	w o r ɑ n
بارول	b ɑ r a w ə l
اويو	o w j o
واخلم	w ɑ x l m
راغ	r a ɣ
چیو	t͡ʃ i o
تل	t æ l
ولاړیم	w o l ɑ ɽ i m
وڅښي	w ə ʈ ʂ ə x i
لخوا	l x w ɑ
زهرجن	z ɛ h r d͡ʒ n
ووړکۍ	w o ɺ̢ k ə i
مغز	m ɣ z
شاملیدو	ʂ ɑ m l i d w o
باد	b ɑ d
ځواک	d͡z w ɑ k
تنفسي	t ə n f s i
پيل	p a ɪ l
همبرداشت	h ə m b r d ɑ ʂ t
ماشید	m ɑ ʃ i d
پوهېږې	p o h e ʐ e
واحد	w ɑ h d
جوړې	d͡ʒ o r e
اوورته	ɑ w o r t ə
بيژکۍ	b i ʒ a k ə i
وکړم	w k ɻ m
کاره	k ɑ r ə h
ښه	x a
لیرې	l i r e
ایازه	i j ɑ z ə
دماغکې	d m ɑ ɣ k e
ماشییو	m ɑː ʃ iː j oː
وه	w ə
چیغې	t͡ʃ i ɣ ɛ
الصحه	ɑ l s ʕ h ə
وړل	w ɻ l
منظم	m ʊ n z ə m
دود	d̪ o d̪
شاید	ʃ ɑː j ə d
حبوباتو	ħ b o b ɑ t o
لومړي	l o m ʊ r i
خطبقه	x t b q ə h
دایمي	d ɑ i m i
تودوخې	t o d o x e
سیمې	s ɪ m e
حشره	h ʃ r ə
تبا	t b ɑ
هېلۍ	h e l ə i
اوسېدونکی	o s e d̪ u n k a ɪ
هڅوي	h ə t͡s o j
کړې	k ə ɽ e
واوره	w ɑ u̯ r a
کوونکې	k o w u n k e
برايي	b ə r ɑ j i
درلوده	d r l o d ə
پارسه	p ɑ r s a
مهمه	m h m a
وویو	w o i o
ورکوله	w r k u l h
اوریدلو	ɑ o r i d l o
دروغویل	d̪ r o ɣ o w i l
وړاندې	w r ɑ n d e
راغلی	r ɑ ɣ l i
غوړ	ɣ o ɽ
لکه	l k ə
دادېوالو	d ɑː d e w ɑː l o
لکهګرم	l k h ɡ r m
بابل	b ɑː b l
دروغویلو	d ə r o ɣ o i l o
خرسبیا	x r s b i ɑ
غالۍ	ɣ ɑ l ə i
بدلول	b ə d̪ l a w ə l
ورکولې	w ə r k uː l e
نیول	n iː uː l
لمريز	l m a r i z
قطر	k a t ə r
خرسد	x r s d
چم	t͡ʃ ə m
خوښي	x o ʂ i
کښې	k x e
انسان	ɑ n s ɑ n
وم	w ə m
غږواورېد	ɣ ʐ o ɑ w ə r ə d
پرځای	p r z aː j
همبرداشت	h m b r d ɑ ʃ t
سړکونو	s ɻ k u n o
حمامیا	ħ m ɑ m i ɑ
واورید	w ɑ w r i d
یوه	j o ə
کوڼ	k u ɳ
چیچلو	t͡ʃ i t͡ʃ l w
مخهو	m x w
کشف	k ʃ f
راتلونکی	r a t l w n k i
توګه	t w ɡ ə
اړینه	ɑ ɽ i n ə h
کافیی	k ɑ f i j
ښیي	x iː i
خل	x ə l
غریب	ɣ r i b
بولم	b o l ə m
ډک	ɖ a k
دويم	d̪ w a i m
باور	b ɑ w ə r
پټي	p ʈ i
ډګرونو	ɖ ə ɡ r ə w ə n ə w
زړونو	z ə r o n o
خلکو	x l k o
عین	ʕ i n
رګونو	r ɡ uː n u
سوماليا	s o m ɑ l j ɑ
شهزادګۍ	ʃ ə h z ɑː d ɡ ə
قاموس	k ɑ m o s
دښته	d ʂ t ə
موږک	m u ɡ ə k
ستر	s t ə r
بدمخی	b ə d m ə x a i
الوزم	a l w ə z ə m
مصر	m i s a r
ستوری	s t̪ o r a ɪ
مینځ	m i n ʈ͡s
شاوخوا	ʃ ɑ w x w ɑ
اړتیا	ɑ ɽ t j ɑ
ومومئ	w m u m ʔ i
خوامې	x w ɑ m e
ژره	ʐ ə r ə
کېیو	k eɪ j oː
بچیانو	b ʈ͡ʃ i ɑ n w
ښکلیدیزه	x k ə l i d i z ə
رامینځته	r ɑː m iː n ʈ ə
تیرې	t iː r e
میرمن	m i r m ə n
نو	n o
وويلهو	w o w i l ə h o
درمل	d̪ a r m a l
ماو	m a w
ټوټه	ʈ o ʈ ə
جال	d͡ʒ aː l
غاړې	ɣ a r e
بیلګه	b i l ɡ a
پوهېدل	p o h e d ə l
تازه	t ɑ z a
لامبو	l ɑ m b o
ورسیږي	w ə r s i ʐ i
ډوډۍ	ɖ o ɖ ə i
غومبه	ɣ u m b a
زباتل	z b ɑ t̪ ə l
ويورکې	w i j o r k e
واورتون	w ɑ w r a t̪ u n
غورځوي	ɣ o ɾ ʝ o j
پدیده	p ə d i d ə h ə
لا	l ɑ
والونه	w ɑ l o n ə
حاصلاتو	ħ ɑː s ɪ l ɑː t o
خيرن	x i r ə n
وړتیاوو	w ɽ t i ɑ w o
ښوونځي	x uː n ʣ i
مرغ	m r a ɣ
سبزيجاتو	s b z i d͡ʒ ɑ t̪ o
دوو	d w w
اېموجي	e m o d͡ʒ i
اېخ	e x
تیر	t i r
بييی	b i j a ɪ
بهېږم	b a h e ɡ ə m
پلاروصیت	p l ɑ r o s i t
سمندر	s ə m ə n d̪ ə r
پسرلی	p ə s ə r l a i
باکتریا	b ɑ k t ə r i ɑ
مرخېړی	m a r x e ɺ̢ a i
اورم	a w r ə m
زبرګ	z b ə r ɡ
شکایت	ʃ k ɑ j i t̪
اغزی	a ɣ z a i
ستايل	s t̪ ɑ j ə l
سپوږمۍ	s p o ɡ m ə i
لاړل	l ɑ r ə l
تلل	t̪ l ə l
کرنې	k r n e
مشر	m ə ʃ r
ډای	ɖ ɑ i
ډکه	ɖ k h
بدلاری	b a d l ɑ r a i
ځکه	d͡z ə k a
کاپيوره	k ɑ p i w a r a
لمردی	l ə m r ə d i
دوولس	d w o l a s
کونه	k w ə n a
نشوه	n ʃ o a
ډکه	ɖ k ə
بلل	b a l ə l
نشو	n ə ʃ o
ورسید	w o r s i d
پیژندلو	p i ʒ n d l ʊ
شوني	ʃ w n i
اورېدلي	ɑ o r e d l i
اسانه	a s ɑ n a
شو	ʃ ʊ
اړخ	a ɺ̢ x
کوې	k ʊ ə i
رسولی	r s o l i
ککړونکي	k ə k ɽ o n k i
سپیو	s p iː w
کوی	k w i
فاطمې	f ɑ t̪ m e
باڼه	b ɑ ɳ ə
کېښود	k e x o d
لمریز	l ə m r i z
ګټل	ɡ a ʈ ə l
سړییم	s ɽ i j m
بیرته	b i r t ə
ناورین	n ɑ w ɾ iː n
ګرمدیځ	ɡ r m d i ʐ
کنګل	k n ɡ l
کچالو	k ʊ t͡ʃ ɑː l o
غونډ	ɣ w ə ŋ ɖ
زیرمه	z i r m ə
ټوللاغمجن	ʈ uː l l ɑː ɣ m d͡ʒ n
نوۍ	n w ə i
وېرېږه	w e ɾ e ʐ h a
توپیر	t oː p iː r
کبانو	k b ɑ n o
پنير	p a n i r
پراخې	p r ɑ x e
شته	ʃ t̪ e
دالتهاب	d ɑ l t ə h ɑ b
هګیو	h ɡ i o
راغلې	r ɑː ɣ l e
نودا	n u d ɑ
شو	ʃ oː
مسله	m ə s l ə
چاينک	t͡ʃ ɑ i n ə k
پوهیږئ	p o h i ʐ ʔ
بوره	b u r a
کانټینر	k ɑ n ʈ i n r
خوامې	x w ɑ m e
خپروي	x p r o i
ممکن	m m k n
ور	w a r
ځغلول	d z ɣ ə l a w ə l
مخالفت	m x ɑ l ə f t
همتوانیدلي	h m t oː ɑː n iː d l iː
اچوو	ɑ t͡ʃ o w
لمن	l a m ə n
قرآن	q ɾ ɑ n
پايله	p ɑ i l a
کیفیت	k i f i t
بحر	b h r
مرستونی	m r a s t̪ u n a ɪ
ويل	w i l
روښانه	r o ʂ ɑ n a
توګه	t̪ o ɣ ə
ویښته	w iː x t ə
پلی	p l iː
پاڅیدم	p ɑ ʈ͡s i d ə m
پسې	p ə s e
کیښودل	k i x o d ə l
وکړئیا	w k ɽ ə i ɑ
غندل	ɤ a n d̪ ə l
ټوکو	ʈ oː k oː
وفا	w f ɑː
طر	ʈ r
نشئ	n ʂ ə i
ځنګل	d͡z ə ŋ ɡ ə l
بته	b ə t̪ a
جږګی	d͡ʒ ə ɡ ɡ a ɪ
بن	b ə n
سیمې	s i m e
ناروغۍ	n ɑ ɾ o ɣ ɛ
پلورونکي	p l o r o n k i
اورونه	ɑ w ɾ o n ə
ځواب	ʣ w ɑ b
کېهګۍ	k ə i̯ h ɡ ə i̯
کسانو	k s ɑ n u
اغږم	a ɣ a ʐ ə m
څښتن	ʈʂ x t n
اړتیا	ɑ ɻ t i ɑ
شوني	ʃ o w n i
لرګیو	l ə r ɡ i w
پت	p a t̪
شين	ʃ i n
شګو	ʃ ɡ o
موږ	m i ʒ
زنګونو	z ə ŋ w ə n ə w
ویښتهیی	w iː ʂ t ə h iː
هېواد	h e w ɑ d̪
سیمه	s ɪ m ə
هغو	h ə ɣ o
بدنروغ	b d n r o ɣ
بیاګلختمي	b i ɑ ɡ l x t m i
وينګ	w a j a ŋ ɡ
عمر	ʕ u m r
کړل	k ɽ l
نهغوالرم	n ə ɣ w ɑ l r ə m
مترو	m ə t r o
ټوپکی	ʈ u p a k a i
اېسټونيا	e s ʈ o n j ɑ
پښیمانه	p ə x i m ɑ n ə
مورې	m w r e
ړومبی	ɺ ˞ u m b a i
دد	d d
کلکوالى	k l a k w ɑ l a ɪ
پسه	p s ə
ترلاسه	t r l ɑː s ə
خدای	x u d ɑ j
حوضڅخه	ħ o ʈ͡s ə x a
ځوان	d͡z w ɑ n
وټاکي	w t ɑ k i
مټونګى	m ə ʈ u n ɡ a i
غله	ɣ l a
اړين	ə ɻ i n
مسله	m s l a
پښه	p x a
ګړندی	ɡ ə ɺ̢ a n ɖ a i
کرون	k ɾ o n
ولېږل	w o l e ʐ l
شرمیده	ʃ r m i d a
کرل	k ə r ə l
دادی	d ɑ d i
نولسمې	n o l s ə m e
پناه	p ə n ɑː h
درکول	d a r k a w ə l
زینو	z iː n o
خو	x o
مسلې	m ə s l e
نوکرانو	n uː k r ɑː n u
اثر	ɑ s ə r
تږییی	t̪ ʐ iː iː iː
شپې	ʃ p eː
بل	b ə l
تنور	t̪ ə n u r
نطفه	n ʊ t̪ f a
نجونې	n ə d͡ʒ uː n e
مطلب	m ə t̪ l ə b
عادت	ʕ ɑ d t
مرغۍ	m ɾ ɣ e
سړکونو	s ɾ k u n u
شينو	ʃ i n o
موږته	m w ʐ t h a
ماهر	m ɑː h ə r
اوښسپورچی	ɑ w x s ə p ə r t ʃ i
پیرودونکي	p i ɾ u d u n k i
څنګه	t͡s ə ŋ ə
مه	m ə h
نېښو	n e x o
ملګري	m ə l ɡ r i
ورسیده	w r s i d h
درملنه	d ə r m ə l ə n ə
خواږو	x w ɑ ʐ o
ګڼي	ɡ ə ɳ i
څارونکى	t͡s ɑ r u n k a ɪ ɪ
پخپله	p ə x p ə l ə
لپه	l a p a
خوړل	x w a ɽ ə l
یوسف	i o s f
دونو	d o n o
سپیننسواري	s p i n n s w ɑ r i
ښوویل	x o w i l
ضایع	z ɑ i ə ʕ
کلی	k ə l a ɪ
دنیالهشتو	d n i ɑ l ə ʃ t ʊ
اتله	a t̪ ə l a
سورخالو	s o r x ɑ l o
مسلمانو	m ə s l i m ɑ n w
پسرل	p ə s ə r l
اوسسطل	a w s s t̪ l
پوهیږي	p uː h iː ʒ iː
ساینسپوهانو	s ɑ i n s p o h ɑ n o
ایستلو	ɑ j s t̪ l o
موافقه	m o ɑ f ɪ q a
ټاپو	ʈ ɑ p u
مالګه	m ɑ l ɡ a
لیدو	l i d w
نظريه	n ə z ə r i j ə
راوړې	r ɑ w ɽ e
وړ	w ə ɻ
تۀ	t ə
دارو	d ɑ r u
بارکړې	b ɑː r k ɽ e
چلوله	t͡ʃ l ʊ l ə
رنډۍ	r ə n ɖ ə i̯
ډاډ	ɖ ɑ ɖ
نیشکیبی	n i ʃ k i b i
خړه	x ɹ ə
ماشی	m ɑ ʃ i
ساری	s a r i
مرغۀ	m ə r ɣ ə
والونه	w ɑ l o n ə
ژبکۍ	ʒ a b a k ə i
ریما	ɾ iː m ɑ
زیانمنوي	z i ɑ n m ə n o w i
رنګونه	r n ɡ w n ə
غپا	ɣ a p ɑ
ډریور	ɖ r iː w ə r
ژوند	ʒ w ə n d̪
سنډا	s a n ɖ ɑ
قوي	q w i
نجلۍ	n d ʒ ə l ə i
ښار	x ɑ r
پيشو	p i ʃ o
لوبې	l uː b e
دلیلونه	d l iː l uː n ə
مینه	m i n h a
اوربشې	ɑ w ɾ b ʃ ɛ
شوي	ʃ o w i
زلیخا	z ʊ l a i x a
نشي	n ʃ i
بوټپوهنه	b u ʈ p o h ə n a
وزير	w ə z i r
ماتيږي	m ɑː t̪ iː ʐ iː
هلکغمجنشو	h ə l k ɣ m d͡ʒ n ʃ o
اسپه	a s p a
لمریز	l ə m r iː z
غړومبل	ɣ ɺ̢ u m b ə l
پنځپوهنه	p ə ŋ d͡z p o h ə n a
لوړ	l w a ɻ
کونج	k uː n d͡ʒ
اواقع	o w ɑ q ɛ ʕ
پلم	p ɪ l m
دالتهاب	d a l t a h a b
غوږ	ɣ w a ɡ
مخه	m x a
محاسبې	m ħ ɑ s b ɛ
صنایعو	s n ɑ j ʕ o
ارزانه	a r z ɑ n a
ویښتانو	w i ʂ t a n o
کبانو	k ə b ɑː n o
راکول	r ɑ k a w ə l
زڼکی	z ɘ ɳ k ɑ i
مليکنه	m ə l i k n ə
دغه	d̪ ə ɣ a
اوښبار	ɑ w x b ɑː ɾ
ګرځیځکه	ɡ r ʐ i ʐ k ə
ونیوله	w o n i o l ə
درزو	d ə r z o
ښکاره	x k ɑ r a
هرڅه	h ə r ʂ ə
وړاندې	w ɻ ɑ n d e
دریم	d ə r i m
کېیخ	k eː j x
تردې	t r d e
کینم	k iː n ʊ m
درنکړم	d ɾ n k ɽ m
کبنیونکو	k b n i w o n k w o
څادر	t͡s ɑ d̪ a r
روبوټونه	r o b o ʈ o n a
رڼا	r u ɳ ɑ
تاسې	t ɑ s e
اورېدلو	o r ə i̯ d l o
نیوه	n i o h e
مختلف	m x t l f
چم	t͡ʃ m
کیند	k i n d
اوړم	a w ɺ ˞ ə m
راستنه	r a s t n a
خاص	x ɑː s
خوبي	x o b i
اوړي	oː ɽ iː
کوئ	k w ɑ i
فوټبال	f o ʈ b ɑ l
دشګو	d ʂ ɡ o
سيلۍ	s i l ə i
وغوښتل	w ɣ o x t ə l
لارښوونې	l ɑː r x uː n e
موندلو	m o n d̪ l o
واک	w ɑ k
ستا	s t̪ ɑ
زیرکۍ	z iː ɾ k e
انصاف	ɑ n ʂ ɑ f
یادیږی	j ɑ d i ʐ i
مې	m e
لوبغاړې	l o b ɣ ɑ ɽ ɛ
غاړې	ɣ ɑː r ə
ستنه	s t ə n ə
سورپوستکي	s w r p w s t k i
اصلي	a s l i
میږیان	m i ʐ i ɑ n
هيله	h i l a
سره	s ə r a
غن	ɣ n
میزکې	m i z k e
لمسی	l m a s a i
زهرجندی	z ə h r d͡ʒ n d i
فاطمې	f a t m e
پوهیږم	p o h iː ʐ m
لورته	l oː r t ə
ناروغ	n ɑ r o ɣ
غنمبه	ɣ n ə m b ə
بايلل	b ɑ i l ə l
مرګ	m a r ɡ
ډډه	ɖ ɖ ə h
پتنګ	p a t̪ a ŋ ɡ
ماهم	m ɑ h m
خوږ	x o ɡ
ګړندي	ɡ ɻ n d i
ټاکلي	ʈ ɑ k l i
لکه	l k a
سبب	s ə b b
دبولو	d b o l o
نبي	n a b i
لای	l ɑ j
ګټورې	ɡ ʈ o r e
ګډوډ	ɡ ə ɖ w ɖ
سترګې	s ə t ə r ɡ e
هیڅکله	h ɪ ʈ ʂ k ə l ə
اوباسم	u b ɑ s ə m
ښخو	x x o
غمونه	ɣ ə m u n ə
ُته	ʔ t̪ ə
څاروى	t͡s ɑ r w a ɪ
ګډوډۍ	ɡ ɖ w ə ɖ e
ککړونکي	k k ɚ o n k i
تللو	t ə l l o
کړکۍ	k ə r k ə j
لوین	l w iː n
ویښتان	w iː x t aː n
کو	k o
راولې	r ɑ w ə l e
استراحت	ɑ s t r ɑ h ə t
آرام	ɑ r ɑ m
وسپاري	w s p ɑ r i
بيه	b i j e
اوبه	o b ə
مونږ	m u n ɡ
پلاله	p a l ɑ l a
كوي	k o i
عاید	ʕ a j d
هوښيار	h u x j ɑ r
ویره	w iː r ə
الوتکه	a l w a t̪ ə k a
زنه	z ə n a
ښايي	x ɑ y i
بارکزی	b ɑ r ə k z a i
خرس	x r s
ټاکلې	ʈ ɑ k ə l e
ناسته	n ɑ s t ə
واټن	w ɑ t̪ n
مالک	m ɑ l ɪ k
شغال	ʃ a ɣ ɑ l
جنجالونه	d͡ʒ n d͡ʒ a l o n a
ګودر	ɡ u d̪ a r
آسولید	ɑ s o l i d
مصرتمدن	m ə s ɾ t ə m d ə n
يوولس	j a w o l a s
خپله	x p ə l ə
معلومه	m ɑ l u m ə
ناستو	n a s t o
هوښیاره	h o x j ɑ r ə
ولیده	w l i d h a
لس	l a s
چیت	t͡ʃ i t̪
مرغۍ	m r ɣ ə i̯
اتل	a t̪ ə l
موده	m o d a
جامو	d͡ʒ ɑ m o
تجارت	t d͡ʒ ɑ r ɑ t
وېښته	w e x t ə
دلته	d̪ ə l t̪ a
وصیت	w s i t
قانون	q ɑː n uː n
مطلب	m ə t̪ l ə b
نجونې	n ə d͡ʒ o n e
هسک	h a s k
رنګ	r a ŋ ɡ
دب	d ə b
اورېدل	a w r e d ə l
کورنه	k o r n a
ډا	ɖ ɑ
آسد	ɑ s d
سمد	s m d
وڅښي	w t͡s ʂ i
ننو	n n u
ګۍ	ɡ e
تېروتنه	t̪ e r w a t̪ ə n a
غله	ɣ l ə
وهي	w h i
مټ	m ə ʈ
آزاد	ɑ z ɑ d
راضي	r ɑ ʈ͡ʂ i
دقیق	d q i q
حل	h ə l
سو	s o
ګلابي	ɡ w ə l ɑ b i
تخریب	t x r iː b
لړم	l a ɻ a m
دوبي	d o b i
سپنج	s p ə ŋ d͡ʒ
طباوانجینرۍ	t ə b ɑ w ɑ n j i n ə r e
نیمه	n i m ə
کوشلرغونی	k o ʃ l ə r ɣ o n i
غواړم	ɣ w ɑ ɺ̢ ə m
آرام	ɑ r ɑ m
امريکا	a m r i k ɑ
تګنه	t ɡ ə n ə
ترمنځ	t ə r m ə n ʐ
وختي	w o x t i
شګو	ʃ ɡ o
پامیی	p ɑː m iː j
اوږ	o ʊ ʐ
مېرمنې	m e r m ə n e
څو	t͡s o
کېږيو	k e ʐ i o
هیڅوک	h iː ʈ͡s w ə k
ویلد	w i l d
آسولید	ɑ s o l i d
شوه	ʃ uː h
ډاډ	ɖ ɑː ɖ
طرف	t̪ ɾ ə f
غورځولې	ɣ o ɾ ʐ o l e
بازو	b ɑ z u
جوړې	j o ɻ ə i̯
نهو	n h o
جګړول	d ʒ a ɡ ɺ ˞ a w ə l
پوهیږم	p o h i ʐ m
ديار	d i ɑ r
تودوخې	t̪ o d̪ o x e
خوبڅخه	x o b ʦ x ə
درې	d̪ r e
سیوري	s iː j uː r iː
شاته	ʃ ɑ t ə
بيزو	b i z o
خرسد	x ɾ s d
سبزيجاتو	s ə b z i d͡ʒ ɑ t o
غواړو	ɣ o a r o
نمونځ	ⁿm u ŋ d͡z
خوبه	x o b a
ګولساتونکی	ɡ o l s ɑ t o n k i
ماشومان	m ɑ ʂ o m ɑ n
نېښ	n e ʂ
وړانګې	w r ɑ n ɡ e
ویلو	w i l o
نهییو	n ə h i j o
خواشينی	x w ɑ ʃ i n a i
غرونو	ɣ r uː n uː
مېلوه	m e l a w a
لومړی	l u m ɺ ˞ a i
بهېدل	b ə h e d ə l
ټو	ʈ o
هڅو	h ə ʂ o
ثانيه	θ ɑː n iː ə
ولېږ	w o l e ʒ
شک	ʃ ə k
خواړه	x w ɑ ɽ a
هیله	h i l ə
بوټان	b u ʈ ɑ n
ازادۍ	a z a d ə i
لوړې	l o ɻ e
اوښسپورو	ɑ w ə x s p ɔ ɾ w
آرامه	ɑː r ɑː m ə
هڅې	h ə t͡s e
بهرنی	b ə h r n i
اوسېدونکې	o s e d̪ u n k e
تنظیموي	t n z i m o i
مسموم	m ə s m o m
درملتون	d̪ ə r m ə l t̪ u n
شلو	ʃ l o
هلته	h a l t a
جکړ	d͡ʒ a k a ɽ
ناڅاپه	n ɑ ʂ ɑ p a
وګټو	w ɡ ʈ w ə w
ماشومانو	m ɑ ʂ o m ɑ n o
پېړۍ	p e ɻ ə i
مل	m ə l
جېبوتي	j e b u t̪ i
اشاره	ɑː ʃ ɑː r ə
کولای	k uː l ɑː j
مقدار	m q d ɑː r
ډز	ɖ a z
اف	ɑ f
ګروه	ɡ r o h
هوښیار	h ə w x i ɑ r
کولای	k ʊ l ɑ i
خوزه	x w o z ə
مړشو	m ɔ r ʃ ʊ
کېښودې	k e x o d e
ابی	ɑ b i
پاککړئ	p ɑ k k r ʔ
څرګنده	ʈʂ r ɡ n d ə
اخیست	ɑ x i s t
شور	ʃ o r
اسماني	a s m ɑ n i
حرارت	x ɾ ɑ ɾ ə t̪
زهرجندی	z ə h r ʤ ə n d i
څرخیدل	ʂ r x i d l
موټر	m o ʈ r
وموندلې	w ə m o n d l e
نښه	n x a
زیانهم	z i ɑ n ə h m
ساري	s ɑː r i
زمری	z m a r a ɪ
شیدې	ʃ i d e
صنعتونو	ʂ n ʕ t uː n uː
ولاړیم	w l ɑ r i m
اص	ɑ s
انګور	a ŋ ɡ u r
ذهني	ð ə h n iː
زموږګرانې	z ə m o ʒ ɡ r ɑ n e
پنجره	p ə n d͡ʒ r ə h
لږوو	l ə ʒ ə w
سطل	s ʈ l
مرګاويا	m ə ɾ ɣ ɑ w j ɑ
پټي	p ʈ i
لاريون	l ɑ r j u n
وږیوی	w ʊ ʒ iː w i
کبنیونکو	k b n i u n k u
فردوس	f ɪ r d̪ a w s
لویدیځ	l oː iː d iː ʒ
مصرف	m ʂ r f
وييپانګه	w ə j i p ɑ ŋ ɡ a
ناوخ	n ɑ w x
کیلوګرامه	k i l o ɡ r ɑ m a
رسولی	r ə s u l i
بند	b ə n d
نیشکیبی	n i ʃ k i b i
اوویې	ɑ w o w i e
وږی	w ə ɡ a i
ښوونکی	x o w u n k a ɪ
خوبۍ	x o b ə i
نن	n ə n
دروستل	d ə r w ə s t̪ ə l
بزګرې	b z ɡ r e
مېجی	m e ʒ a i
اتلس	a t̪ ə l a s
ګنده	s x ɑ
ځار	d͡z ɑ r
مخالفت	m x a l f t
پنځلس	p i n d z ə l a s
ویجاړونکی	w iː d͡ʒ ɑː ɻ o n k i
حل	h l
ټوکو	ʈ w k u
ویښتان	v iː ʂ t ɑː n
که	k ə
يې	j e
نوملړ	n u m l a ɻ
تخمونه	t ə x m u n ə
سوله	s u l h a
لوردر	l o r d ə r
البانيا	a l b ɑ n j ɑ
ګړدود	ɡ ə ɻ d̪ o d̪
دعوه	d̪ ɑ w a
غوښتنې	ɣ o x t ə n e
معمولاًاغوندي	m ʕ ə m u l ɑ ɣ o n d̪ i
غوا	ɣ w ɑ
تقریبا	t ə q r i b ɑ
سړو	s ʊ r o
کاروان	k a r w a n
وروسته	w ə r uː s t ə h
ژر	ʐ ɾ
نفرت	n ʊ f r ʊ t
عجبه	ʕ ə d͡ʒ b ə
سور	s u r
ماشییو	m ɑ ʃ i j o
پوهیږي	p oː h iː ʐ iː
تکیه	t̪ ə k i j ə
زوړ	z o ɻ
ډبلده	ɖ b ə l d ə h
عثمانیانو	ʕ o s m ɑ n i ɑ n o
منشي	m ə n ʃ i
املوک	a m l u k
نشي	n ʂ i
الوبالو	a l u b ɑ l u
بد	b ə d
پوهنتونو	p o h n ə t o n o
څوارلس	t s w ɑ r l a s
سودا	s o d̪ ɑ
وريجې	w r i d͡ʒ e
نفرت	n ə f r ə t
اخته	a x t̪ a
وئ	w ə i
کومی	k u m a i
یلد	j l d
مننې	m ə n ə n e
احمده	ɑː h m ə d ə
درجې	d ə r d͡ʒ e
خدمتګارانې	x ə d ə m t ɡ ɑ r ɑ n e
راټولیږي	r ɑː ʈ oː l iː ʐ iː
پسرل	p s r l
رایستل	r ɑ j s t ə l
اختلالات	ʔ x t l ɑ l ɑ t
سبب	s ə b ə b
درنه	d̪ r ə n a
هوښيارزیرک	h o ʈ͡ʂ j a r z i r k
حلدینود	ħ l d i n o d
پوليس	p o l i s
غوږونه	ɣ w ʐ w n ə
اخ	a x
اوسې	ɑ w s e
معمولاًاغوندي	m ʕ ə m uː l ɑ ɣ uː n d i
یلد	j ə l d̪
ايغلو	i ɣ l u
پوهې	p o h e
ځلانده	ʐ l ɑ n d ə
شی	ʃ i
بریالۍ	b r ɪ j ɑ l ə i
وزن	w z n
بیه	b iː h
اپارتمان	ɑ p ɑ ɾ t̪ m ɑ n
ايستل	i s t ə l
پرتوګ	p a r t̪ u ɡ
ډګه	ɖ a ɡ a
عقلۍ	ʕ q l ə i̯
ویج	uː iː d͡ʒ
اواز	o w ɑ z
څاوار	t͡s ɑ w ɑ r
ابادول	a b ɑ d̪ a w ə l
تياره	t̪ iː ɑ ɾ ə
شا	ʃ ɑː
بریا	b r iː ɑː
وویلدا	w o i l d̪ ɑ
خرسیو	x r s i w
وېرېږم	w e r e ʐ m
پوستکي	p o s t̪ k i
بوی	b oː iː
اې	ɑː eɪ
حللاره	ħ l l ɑː r ɛ
راتلونکی	r ɑ t̪ l o n k i
ماڼۍ	m ɑ ɳ ə i
تنو	t n o
ازادیم	a z aː d iː m
لیرې	l i ɻ e
پوستکي	p w s t̪ k iː
داتمو	d ɑ t m o
غویي	ɣ w ə j i
ساعته	s ɑː ʕ ə t ə
وشي	w o ʂ i
سلطنت	s l ʈ n t
اولس	u l ə s
ګهيځ	ɡ ə h i d͡z
اويا	a w j ɑ
ښځينه	x ə z i n a
یمزه	j ə m z a
زیاتکوی	z iː ɑ t k uː i
زمانېښد	z ə m ɑː n e x d
سبزیو	s b z i ʊ
جن	d͡ʒ ɑ n
باټیک	b ɑ ʈ i k
وخو	w o x o
واټن	w ɑ t n
لاړې	l ɑ r ə
دماغکې	d ə m ɑ ɣ k e
ورکړې	w o r k ɻ ə i̯
مرغړی	m a r ɣ a ɺ̢ a i
پاککیدی	p ɑ k k i d i
۷۳۰	s ɛ v ɛ n θ r i z ɛ r o
منډه	m ə n ɖ a
آسانۍ	ɑ s ɑ n ə i
لوڼو	l o ɳ o
پلازمېنه	p l ɑ z m e n a
امرونوان	a m r o n o ɑ n
ګڼل	ɡ a ɳ ə l
ورزشته	w ə r ʒ ʃ t ə
اوروبوټو	ɑ ʊ r ʊ b ʊ t ʊ
زیانهم	z j ɑ n ɛ h m
ډاډ	ɖ ɑ ɖ
خوټه	x w ə ʈ a
وباسي	w b ɑ s i
لمونځ	l m u n d͡z
ننه	n ə n ə
مساح	m s ɑː ħ
ځمکه	t͡s m k e
وموند	w m u n d
پنځه	p i n d z ə
غاښ	ɣ ɑ x
اواز	ɑ w ɑ z
باران	b ɑ r o m
وکړم	w k ɖ m
کنګال	k a n ɡ ɑ l
لهشکه	l h ʂ k ə
مېله	m e l a
اوسېدل	o s e d ə l
ډبرو	ɖ b ə r o
قوماند	q o m ɑː n d
غور	ɣ o r
ددې	d ə d e
غنم	ɣ a n ə m
بده	b ə d a
ننګ	n ə ŋ ɡ
وده	w ə d̪ ə
وساتی	w s ɑ t i
نيمبو	n i m b u
خورا	x oː r ɑː
شتون	ʃ t̪ w n
خورن	x ɔ ɾ n
مېخ	m e x
اف	ɑː f
اوږه	e ʒ a
زیرمه	z i ɾ m h a
ځړول	ʐ ɻ o l
اوشه	o ʃ a
څنګه	ʈ͡s n ɡ ə
اغیزمنه	ɑ ɣ i z m ʊ n ə
ژره	ʐ r ə
سورپوستکي	s o r p o s t k i
درلودلو	d r l uː d l u
خوله	x w l ə
موټرد	m oː ʈ r d
سل	s ə l
خاندي	x ɑ n d i
ډکه	ɖ k a
یمزه	y m z h
یاد	j ɑː d
کندهار	k a n d̪ a h ɑ r
لامبل	l ɑ m b ə l
هالنډیانو	h ɑ l n ɖ i ɑ n o
مارکیټ	m ɑ r k i ʈ
جالڅخه	d͡ʒ a l t͡s x a
اوبوته	ɑ w b w t̪ ə
شوملې	ʃ o m l e
زیان	z i ɑ n
سلطنت	s ə l t ə n ə t
ختيځ	x a t̪ i d͡z
مسؤل	m ə s ʔ ə l
لوبېدل	l o b e d ə l
قیمتيملغلرې	q i m t̪ i m l ɣ l ə r e
واورې	w ɑ o r e
توازن	t o ɑ z n
پوهیدم	p o h i d ə m
کړئیا	k ɻ ə i ɑ
څرګند	t͡s ə r ɡ ə ŋ d̪
څکه	t͡s ə k a
وه	w h
سبزي	s b z i
سرچینو	s ə r tʃ i n o
شرمښ	ʃ ə r m ə x
کوونکی	k o w o n k i
هډوکو	h ʈ w k w
دادېوالو	d̪ ɑ d̪ e w ɑ l o
اپارتمان	ɑː p ɑː r t m ɑː n
وشي	w ʂ i
پوهیږي	p o h i ʐ i
بښنه	p o x t̪ ə n a
باغته	b ɑ ɣ t ə
ولېږل	w l e ʐ l
دوسته	d o s t ə
انا	a n ɑ
غلوله	ɣ l uː l ə
مياشت	m j ɑ ʃ t̪
درد	d ɾ d
څارویو	t͡s ɑ r o v i o
کمزوری	k m z uː r i
مرغه	m a r ɣ a
ستورڅک	s t o r t͡s a k
دیمن	d iː m n
بی	b i
یخپوښول	j x p o ʂ o l
وګړواکي	w ə ɡ ə ɻ w ɑ k i
ولاړیم	w ə l ɑ r i m
لاندیښمن	l ɑː n d i x m ə n
تخریب	t̪ ə x r iː b
هلک	h a l ə k
وخندل	w x n d l
ځای	d͡z i
داړل	d ɑ ɺ ˞ ə l
دکار	d k ɑ r
والي	w ɑ l i
روسيه	r u s j a
اوږده	ɑ w ʒ d ə
کمولو	k m w l w
اندیښنه	a n d i x n h
ځړول	t͡s ɽ u l
غوښه	ɣ w a x a
مواد	m o ɑ d
غړی	ɣ ə ɽ a ɪ
پراته	p r ɑ t ə
څومره	t͡s u m r a
خل	x ə l
شمسي	ʃ m ʂ i
داسطل	d ɑː s t ə l
اوښسپورچی	ɑ w x s p o r t͡ʃ i
چاکلیټ	t͡ʃ ɑː k l iː ʈ
حکیم	h k i m
لېونۍ	l e w ə n ə i
ارمان	a r m ɑ n
نوی	n ə w a i
زوړ	z o ɻ
نېښو	n e ʂ o
دروازې	d r uː ɑ z e
حیواناتو	x i j w ɑ n ɑ t̪ o
چاقور	t͡ʃ aː q u r
بدپوری	b ə d̪ p o r a ɪ
راټولولو	r ɑ ʈ ʊ l ʊ l ʊ
طبقه	t ɑ b q ə
خېل	x e l
زیانونو	z i ɑ n o n o
ناروغۍ	n ɑ r o ɣ ə i
به	b a
ساري	s ɑː ɾ i
آرام	ɑː r ɑː m
مذهب	m a z a b
يم	j ə m
څونوټ	t͡s o n o ʈ
دویده	d o i d h
مخوېينه	m ə x w e j ə n a
سړي	s ɻ i
در	d a r
مېشت	m e ʃ t̪
واخیستلاړل	w ɑ x i s t l ɑ r ə l
الوتل	a l w ə t ə l
کس	k ə s
اوږد	u ɡ d̪
اوښلرم	a w ʈ͡ʂ l r m
بدبختي	b ə d b x t i
موروه	m o r o w ə h
ولسوالي	w ə l ə s w ɑ l i
حجم	ħ ə d͡ʒ m
خاورې	x ɑ w ə ɾ i
لوستل	l w ə s t̪ ə l
یوروباټ	j o r o b ɑ ʈ
خوښۍ	x o ʂ e
اوساتونکو	ɑ w s ɑ t u n k u
نویمنځ	n w i m n ʒ
تودوخې	t o d o x e
زیانونه	z i ɑ n o n a
منو	m a n o
وغواړی	w ɣ w ɑ ɽ i
سيند	s i n̪ d̪
زده	z d̪ a
اوښانه	ɑ w x ɑ n ə
معدن	m ɑ d̪ ə n
راوړل	r ɑ w ɽ ə l
کول	k a w ə l
تیرید	t iː r iː d
پاي	p ɑ j
کیله	k i l ə
ښامار	x ɑ m ɑ r
برې	b ɾ e
انسانانو	ɑ n s ɑ n ɑ n o
مرغان	m r ɣ ɑ n
رسیږي	r s iː ʒ i
غږونو	ɣ ʐ w n w
ننوست	n n oː s t
معلومه	m a l o m h
غورځولې	ɣ o r ʒ o l e
لېوۀ	l e w ə
غاړی	ɣ ɑ ɻ a i
اوتا	ɑ w t ɑ
ټینګار	t̪ i ŋ ɡ ɑ ɾ
تاو	t ɑ w
موافقه	m w ɑ f ɪ q ə
مشهور	m ʃ h o ɾ
ماشی	m ɑ ʃ i
مفکوره	m f k oː r ə
پلورونکې	p l w r u n k e
اسطل	ɑ s t l
وروڼو	w ə r uː n uː
مېلمه	m e l m a
قانعکړي	q ɑː n ʕ k ə ɻ i
ډیرو	ɖ i r o
ورڅخه	w o r t͡s x ə
آسد	ɑː s d
ورکړحمي	w ɾ k ɾ ʔ h m i
ویښتانو	w i ʂ t ɑ n o
بابا	b ɑ b ɑ
اثر	ʔ ə θ r
بوتله	b oː t l ə
چاکلیټ	t͡ʃ a k l i t
سپیننسواري	s p iː n n s w ɑ r i
تږی	t ʂ i
خبر	x b ə r
ژګاګ	ʒ ɪ ɡ ɑ ɡ
فرانس	f r ɑ ŋ s
تڼۍ	t̪ a ɳ ə i
سو	s o
ښخو	x x o
وکتل	w k t ə l
وګړی	w ə ɡ ə ɻ a i
مېښه	m e x a
نوکرانو	n w k r ɑ n o
بوتله	b u t ə l ə
لوی	l o i
شدت	ʃ ə d ə t
بحر	b ħ r
وييونه	w i j u n a
كوي	k o w i
راتلل	r ɑ t̪ l ə l
ډبلده	ɖ b ə l d ə h
شدی	ʃ d i
خورن	x w r n
کوشلرغونی	k o ʂ l r ɣ o n i
پرواۍ	p r w ɑ e
ووهي	w w ə h i
کوې	k o e
بربنډ	b ə r b ə ŋ ɖ
شونیه	ʃ uː n iː ə
لرئ	l ə r ʔ
تولیدیدل	t o l i d i d ə l
ووړی	w o ɺ ˞ a i
چیو	tʃ iː oː
تر	t r
جن	d͡ʒ n
ښودل	x ʊ d l
مېړۀ	m e ɻ ə
نیول	n i j o l
ملګريه	m l ɡ r iː ə
تماله	t̪ a m ɑ l a
هورې	h u r e
ساینسپوهان	s ɑː j n s p w h ɑː n
شکل	ʃ k ə l
مخ	m ə x
صنعتونو	s n ʕ ə t̪ o n o
کوئ	k w ʔ
مستعمری	m ə s t ʕ m ə r i
زمونږ	z ə m u n ɡ
مو	m u
راوتلی	r aː w t ə l iː
زرګونو	z ə r ɡ uː n o
ګڼ	ɡ a ɳ
مزد	m z d
سبزيجاتو	s b z i d͡ʒ a t u
ځې	d͡z e
کوڅې	k o t͡s e
ړنګې	ɽ n ɡ e
رحم	r a h ə m
ژغورلې	ʐ ɣ o r l ə i̯
سوډان	s o ɖ ɑ n
کور	k o r
بحر	b h r
کوبا	k u b ɑ
رامين	r ɑ m i n
وظیفې	w z i f ɛ
بندید	b n d i d
ماشین	m ɑ ʃ i n
راښکته	r ɑ x k ə t ə
تادې	t ɑː d ə
اوربشې	ɑ w r b ʂ e
څرخیدو	ʈ͡s r x i d w
آفریند	ɑː f r iː n d
اسانۍ	ɑː s ɑː n ə iː
شیانو	ʃ i ɑ n o
انسان	ɑː n s ɑː n
راوړې	r ɑ w r ə
ټینګار	ʈ i n ɡ ɑ r
وي	w i
دروغویل	d ə r o ɣ o w i l
موادو	m w ɑ d w o
آر	ɑ r
تولید	t̪ o l i d̪
دونه	d̪ o n a
خانو	x ɑː n w
جنګول	d ʒ a ŋ ɡ a w ə l
تود	t̪ o d̪
رنګونه	r ə ŋ ɡ u n ə
وویلنه	w w i l n a
ونيو	w n i u
دور	d o r
اندېښمن	ɑ n d̪ e x m n
لاړې	l ɑː ɾ e
ګنډل	ɡ a n ɖ ə l
ډاکو	ɖ ɑ k u
خوري	x ə w r i
صنعت	ʂ n ʕ t
سویلي	s o w i l i
وایي	w ɑ j i
ژبه	ʒ ə b ə
پراخې	p ɾ ɑː x e
کاره	k ɑː r ə
ماهم	m ɑː h ə m
کمې	k m eː
لږوو	l ʐ w ə w
کښت	k x t
واده	w ɑ d ə
تیریدو	t̪ iː ɾ i d w
المانی	a l m ɑ n a i
ومومئ	w ə m o m ə
وتښتېدل	w t x t eː d l
اوښاوخره	ɑ w ə x ɑ w x r a
کلمګ	k l m ɡ
دوسته	d ʊ s t ə
غوښتنه	ɣ w ɔ x t ə n ə
کېو	k eː o
دقیق	d ə q i q
اوښاو	ɑ w x ɑ w
پلورونکو	p l ɔ r ʊ n k ʊ
شور	ʃ uː r
پړانګ	p ɽ ɑ ŋ ɡ
سی	s i
سندرې	s n d r e
ګډوډۍ	g ɖ w ɖ ə i
ناڅاپه	n ɑː ʈʂ ɑː p ə
خور	x o r
المانيا	a l m ɑ n j ɑ
دوام	d o ɑ m
ځمکپوهنه	d͡z m ə k p o h ə n a
بیلګه	b i l ɡ a
ملیون	m l iː uː n
څښتن	ʦ ɑː t n
وينم	w i n ə m
ژو	ʐ o
بېلولو	b e l o l o
پوهان	p o h ɑ n
وويل	w o i l
برج	b r a d͡ʒ
شاته	ʃ ɑː t ə h
کړ	k ə ɻ
مګردا	m ɡ r ə d ɑ
باغوان	b ɑ ɣ w ɑ n
تاسورښتونیوی	t a s w r x t w n i w i
میاشتې	m iː ɑː ʂ t e
نږدې	n i ɡ d e
پوله	p u l a
شک	ʃ k
اوښسپورچی	ɑ w x s p o r t͡ʃ i
تیز	t̪ i z
پوهې	p o h e
پیروي	p i r o i
ځکمی	ʈʂ k ə m i
لاس	l ɑ s
واخیستلاړل	w ɑ x i s t l ɑ ɽ l
اغوستل	a ɣ o s t ə l
ولاړ	w l a ɽ
ورځې	w ə r ʒ e
ايسلنډ	a i s l æ ŋ ɖ
اوسسطل	a w s s t l
شوې	ʃ o w e
انسان	ɑ n s ɑː n
لارې	l ɑ r e
آسانۍ	ɑ s ɑ n ə i
منل	m a n ə l
بادول	b ɑ d a w ə l
بلله	b ə l l ə
کریم	k r iː m
تیریدو	t i ɾ i d u
آیاښوونځي	ɑ j ɑ x w w n ʣ i
ودانۍ	w ɔ d ɑː n ə i
کمزوریتوب	k m z o r i t o b
موندلو	m u n d ə l ə w
وله	w a l a
ساعتونو	s ɑ ʕ t u n u
هرحال	h ə ɾ h ɑ l
وروسته	w o r o s t ə
اوساتونکو	a w s a t u n k u
اپيم	a p i m
ټول	t̪ o l
شمېرپوهنه	ʃ m e r p o h ə n a
ساري	s ɑː r i
ډاډ	ɖ ɑ ɖ
غرمې	ɣ r m e
ځایونو	ʐ ɑː j w n w
ډیرو	ɖ i r o
استول	a s t a w ə l
بلکانټینر	b l k ɑː n t iː n r
باکتریاوې	b ɑ k t r i ɑ w e
غونډیو	ɣ o n d i o
وایم	w ɑ i m
کالي	k ɑ l i
موندل	m u n d̪ ə l
ګاونډیو	ɡ ɑ w n ɖ i w o
عدني	ʕ d̪ n i
لاسه	l ɑ s ə
هرکله	h ə r k ə l ə
حبشې	h ə b ʃ e
مطلب	m t l b
هلکغمجنشو	h ə l k ɣ ə m d͡ʒ n ə ʃ o
یاد	j ɑː d
نیول	n iː u l
آیاسطل	ɑ i ɑ s t̪ l
پاچاهۍ	p ɑ t͡ʃ ɑ h ə i
کېدای	k e d ɑ j
کوچني	k o t͡ʃ n i
پرانستله	p r ɑ n s t l ə
کسوویلزه	k s u w i l z a
ویرهیی	w iː r ə h iː
نولسمې	n o l s ə m e
نسواري	n a s w ɑ r i
غورځول	ɣ o r d͡z a w ə l
مختلفو	m x t l f o
مایو	m ɑ j o
کلک	k l a k
راسې	r ɑ s e
ثابته	θ ɑː b ə t ə
غپول	ɣ a p a w ə l
اخلم	a x l ə m
ډکیو	ɖ k iː oː
ژوندپوهنه	ʒ w a n d p o h ə n a
کړئیا	k ɹ ə iː ɑː
ډکتاج	ɖ k t a ʒ
زرګونو	z ə r ɡ u n o
نظر	n ʕ ə r
ال	ɑ l
پړسوب	p a ɻ s o b
لرګی	l ə r ɡ a i
ټينګ	ʈ i ŋ ɡ
کتلرامين	k t l r a m i n
سفیر	s ə f i ɾ
رول	r o l
مطالعه	m ʊ t ɑː l ʕ ə
اوریدلو	ɑ w r i d l o
وران	w o r ɑː n
خوښبوی	x o ʈ͡ʂ b o i
ډنګر	ɖ a ŋ ɡ ə r
ډکتاج	ɖ k t ɑ ʤ
زیرمه	z i r m ə
مهربانه	m ə h r ə b ɑ n ə
زاګرېب	z ɑ ɡ r e b
ټپاکی	ʈ u p ɑ k a i
زیور	z i j o r
وکاروي	w o k ɑ r o i
لیدلې	l i d ə l e
نڅا	n ə t͡s a
باغ	b o ɣ
ساعتونو	s ɑː ʕ t o n o
کڅوړو	k ʈʂ oː ɖʐ oː
مطالعه	m ə t̪ ɑ l ɛ h ə
غرڅنی	ɣ a r t͡s ə n a i
خوا	x w ɑ
وهي	w ə h i
دانه	d ɑ n a
دروغ	d̪ r o ɣ
سترطبیب	s t r ʈ b iː b
وروورو	w ə r o w ə r o
تیریدو	t̪ iː r iː d w
ورولم	w a r w a l ə m
خونې	x uː n e
وړلی	w r l i
بې	b e
مرغان	m ə r ɣ ɑː n
رنګونه	r n ɡ w n ə
اخلي	ɑ x l i
وویل	w w i l
زهرجنو	z h r ʒ n o
قهر	q ə h r
دلیلونه	d ə l iː l oː n ə
نړیوالو	n ə ɻ iː w ɑː l o
اووه	u w ə
شرمیده	ʃ ə r m i d ə
زوئلا	z w ə l ɑ
حللاره	ħ ə l l ɑ r ə
سطحه	s t̪ x ə
نرکاشه	n ə r k ɑ ʃ a
میږیان	m i ʐ i a n
ګډېدل	ɡ a ɖ e d ə l
وضاحت	w ə z ɑ h ə t
سمیر	s ə m iː ɾ
ځله	ʈʂ l ə
ماښامندا	m ɑ ʂ ɑ m n d ɑ
هګۍ	h ə ɡ ə i
زامبه	z ɑ m b a
نن	n ə n
نېغه	n e ɣ a
