корабел	k ɔ r ɛ b ɛ ɫ
абсурдно	ɛ b s u r d n ɔ
демократично	d ɪ m ɔ k r ɛ t ɪ t͡ʃ n ɔ
вишня	ʋ ɪ ʃ nʲ ɛ
самобутній	s ɛ m ɔ b u tʲ nʲ i i
сатана	s ɛ t ɛ n ɑ
гонор	ɦ ɔ n ɔ r
чудій	t͡ʃ u dʲ i i
задоволення	z ɛ d ɔ ʋ ɔ ɫ ɪ nʲ ɛ
афганський	ɛ f ɦ ɑ nʲ sʲ k ɪ i
обурення	ɔ b u r ɪ nʲ ɛ
господинею	ɦ ɔ s p ɔ d ɪ n ɪ j u
горище	ɦ ɔ r ɪ ʃ t͡ʃ ɪ
шпиталь	ʃ p ɪ t ɑ lʲ
літ	lʲ i t
кіберпростір	k i b ɪ r p r ɔ sʲ tʲ i r
ведмідь	ʋ ɪ dʲ m i dʲ
елефант	ɪ ɫ ɪ f ɑ n t
повільно	p ɔ ʋ i lʲ n ɔ
автобусна	ɛ u t ɔ b u s n ɛ
зустрічатися	z u s tʲ rʲ i t͡ʃ ɑ t ɪ sʲ ɛ
щокою	ʃ t͡ʃ ɔ k ɔ j u
оленина	ɔ ɫ ɪ n ɪ n ɛ
космодром	k ɔ s m ɔ d r ɔ m
поступку	p ɔ s t u p k u
ознайомлення	ɔ z n ɛ j ɔ m ɫ ɪ nʲ ɛ
великодушність	ʋ ɪ ɫ ɪ k ɔ d u ʃ nʲ i sʲ tʲ
другий	d r u ɦ ɪ i
свіча	sʲ ʋ i t͡ʃ ɛ
капітал	k ɛ p i t ɑ ɫ
сьомий	sʲ ɔ m ɪ i
весь	ʋ ɛ sʲ
ім'я	i m j ɛ
погода	p ɔ ɦ ɔ d ɛ
тис	t ɪ s
насолодитися	n ɛ s ɔ ɫ ɔ d ɪ t ɪ sʲ ɛ
чорт	t͡ʃ ɔ r t
магній	m ɑ ɦ nʲ i i
каплиці	k ɛ p ɫ ɪ t͡sʲ i
спостерегти	s p ɔ s t ɪ r ɪ ɦ t ɪ
справами	s p r ɑ ʋ ɛ m ɪ
празник	p r ɑ z n ɪ k
перевиховати	p ɪ r ɪ ʋ ɪ x ɔ ʋ ɛ t ɪ
свояк	s ʋ ɔ j ɑ k
хрін	x rʲ i n
полк	p ɔ ɫ k
жлуктити	ʒ ɫ u k t ɪ t ɪ
громико	ɦ r ɔ m ɪ k ɔ
безсторонність	b ɪ z s t ɔ r ɔ nʲ i sʲ tʲ
незалежности	n ɪ z ɛ ɫ ɛ ʒ n ɔ s t ɪ
систематизувати	s ɪ s t ɪ m ɛ t ɪ z u ʋ ɑ t ɪ
дровця	d r ɔ u t͡sʲ ɑ
діагностувати	dʲ i ɛ ɦ n ɔ s t u ʋ ɑ t ɪ
досягнення	d ɔ sʲ ɑ ɦ n ɪ nʲ ɛ
авіарозвідка	ɛ ʋ i ɛ r ɔ zʲ ʋ i d k ɛ
ідеальний	i d ɪ ɑ lʲ n ɪ i
завдяки	z ɛ u dʲ ɛ k ɪ
страйк	s t r ɑ i k
нерішучість	n ɪ rʲ i ʃ u t͡ʃʲ i sʲ tʲ
трохи	t r ɔ x ɪ
лов	ɫ ɔ u
тунелях	t u n ɛ lʲ ɛ x
пастка	p ɑ s t k ɛ
з'їсти	z j i s t ɪ
лекцією	ɫ ɛ k t͡sʲ i j ɪ j u
обговорювати	ɔ b ɦ ɔ ʋ ɔ rʲ u ʋ ɛ t ɪ
сімсот	sʲ i m s ɔ t
педагог	p ɪ d ɛ ɦ ɔ ɦ
багатокутник	b ɛ ɦ ɛ t ɔ k u t n ɪ k
артерію	ɛ r t ɛ rʲ i j u
сахар	s ɑ x ɛ r
щоразу	ʃ t͡ʃ ɔ r ɑ z u
лакрос	ɫ ɛ k r ɔ s
гординя	ɦ ɔ r d ɪ nʲ ɛ
жінка	ʒʲ i n k ɛ
спідницею	sʲ p i d n ɪ t͡s ɪ j u
родина	r ɔ d ɪ n ɛ
підсумок	p i d͡z s u m ɔ k
гончар	ɦ ɔ n t͡ʃ ɑ r
три	t r ɪ
багатолюдний	b ɛ ɦ ɛ t ɔ lʲ u d n ɪ i
піддержати	p i d ɛ r ʒ ɛ t ɪ
навичка	n ɑ ʋ ɪ t͡ʃ k ɛ
пивний	p ɪ u n ɪ i
мінімальний	m i nʲ i m ɑ lʲ n ɪ i
священик	sʲ ʋ ɛ ʃ t͡ʃ ɛ n ɪ k
занотувати	z ɛ n ɔ t u ʋ ɑ t ɪ
маршрутка	m ɛ r ʃ r u t k ɛ
епохи	ɪ p ɔ x ɪ
неприйнятний	n ɪ p r ɪ i nʲ ɛ t n ɪ i
федорович	f ɪ d ɔ r ɔ ʋ ɪ t͡ʃ
причинний	p r ɪ t͡ʃ ɪ n ɪ i
підозра	p i d ɔ z r ɛ
ховати	x ɔ ʋ ɑ t ɪ
іспанія	i s p ɑ nʲ i j ɛ
забруднення	z ɛ b r u d n ɪ nʲ ɛ
рішення	rʲ i ʃ ɪ nʲ ɛ
сьодні	sʲ ɔ dʲ nʲ i
оберігати	ɔ b ɪ rʲ i ɦ ɑ t ɪ
авізування	ɛ ʋ i z u ʋ ɑ nʲ ɛ
втратити	ʋ t r ɑ t ɪ t ɪ
приїжджати	p r ɪ j i ʒ d͡ʒ ɑ t ɪ
обдаровувати	ɔ b d ɛ r ɔ ʋ u ʋ ɛ t ɪ
туман	t u m ɑ n
коштувати	k ɔ ʃ t u ʋ ɛ t ɪ
щотижневий	ʃ t͡ʃ ɔ t ɪ ʒ n ɛ ʋ ɪ i
курбико	k u r b ɪ k ɔ
незалежності	n ɪ z ɛ ɫ ɛ ʒ n ɔ sʲ tʲ i
гостювати	ɦ ɔ sʲ tʲ u ʋ ɑ t ɪ
прабабуся	p r ɛ b ɛ b u sʲ ɛ
капітулювати	k ɛ p i t u lʲ u ʋ ɑ t ɪ
пестицид	p ɪ s t ɪ t͡s ɪ d
стільниковий	sʲ tʲ i lʲ n ɪ k ɔ ʋ ɪ i
доросла	d ɔ r ɔ s ɫ ɛ
протитанковий	p r ɔ t ɪ t ɑ n k ɔ ʋ ɪ i
королівство	k ɔ r ɔ lʲ i u s t ʋ ɔ
вус	ʋ u s
трактор	t r ɑ k t ɔ r
кубанський	k u b ɑ nʲ sʲ k ɪ i
кар'єра	k ɛ r j ɛ r ɛ
піч	p i t͡ʃ
фінляндія	f i nʲ lʲ ɑ nʲ dʲ i j ɛ
конфлікт	k ɔ n f lʲ i k t
руанда	r u ɑ n d ɛ
мандрувати	m ɛ n d r u ʋ ɑ t ɪ
пекарні	p ɪ k ɑ r nʲ i
непомірний	n ɪ p ɔ m i r n ɪ i
конкретний	k ɔ n k r ɛ t n ɪ i
представниця	p r ɪ d͡z s t ɛ u n ɪ t͡sʲ ɛ
лебединий	ɫ ɪ b ɪ d ɪ n ɪ i
ложа	ɫ ɔ ʒ ɛ
посередник	p ɔ s ɪ r ɛ d n ɪ k
користь	k ɔ r ɪ sʲ tʲ
груша	ɦ r u ʃ ɛ
металевий	m ɪ t ɛ ɫ ɛ ʋ ɪ i
розібрати	r ɔ zʲ i b r ɑ t ɪ
кожух	k ɔ ʒ u x
пшениця	p ʃ ɪ n ɪ t͡sʲ ɛ
авіадивізія	ɛ ʋ i ɛ d ɪ ʋ i zʲ i j ɛ
станцією	s t ɑ nʲ t͡sʲ i j ɪ j u
баба	b ɑ b ɛ
тесть	t ɛ sʲ tʲ
краб	k r ɑ b
найдружелюбніший	n ɛ i d r u ʒ ɪ lʲ u b nʲ i ʃ ɪ i
календарів	k ɛ ɫ ɪ n d ɛ rʲ i u
недоступний	n ɪ d ɔ s t u p n ɪ i
втрачати	ʋ t r ɛ t͡ʃ ɑ t ɪ
роззброювати	r ɔ z b r ɔ j u ʋ ɛ t ɪ
безпрецедентний	b ɪ z p r ɪ t͡s ɪ d ɛ n t n ɪ i
відлічити	ʋ i dʲ lʲ i t͡ʃ ɪ t ɪ
десерт	d ɪ s ɛ r t
клавіатур	k ɫ ɛ ʋ i ɛ t u r
вмикати	ʋ m ɪ k ɑ t ɪ
зрадниця	z r ɑ d n ɪ t͡sʲ ɛ
комедією	k ɔ m ɛ dʲ i j ɪ j u
зворотний	z ʋ ɔ r ɔ t n ɪ i
тротуари	t r ɔ t u ɑ r ɪ
ізраїльтянин	i z r ɛ j i lʲ tʲ ɑ n ɪ n
чудовисько	t͡ʃ u d ɔ ʋ ɪ sʲ k ɔ
тацях	t ɑ t͡sʲ ɛ x
уста	u s t ɑ
розпочати	r ɔ z p ɔ t͡ʃ ɑ t ɪ
перевірити	p ɪ r ɪ ʋ i r ɪ t ɪ
сир	s ɪ r
динаміка	d ɪ n ɑ m i k ɛ
абортувати	ɛ b ɔ r t u ʋ ɑ t ɪ
оподаткувати	ɔ p ɔ d ɛ t k u ʋ ɑ t ɪ
госпіталізація	ɦ ɔ sʲ p i t ɛ lʲ i z ɑ t͡sʲ i j ɛ
африканець	ɛ f r ɪ k ɑ n ɪ t͡sʲ
цистерна	t͡s ɪ s t ɛ r n ɛ
повість	p ɔ ʋ i sʲ tʲ
гірський	ɦ i r sʲ k ɪ i
дратувати	d r ɛ t u ʋ ɑ t ɪ
остаточний	ɔ s t ɛ t ɔ t͡ʃ n ɪ i
погнати	p ɔ ɦ n ɑ t ɪ
самодержавство	s ɛ m ɔ d ɪ r ʒ ɑ u s t ʋ ɔ
застрахувати	z ɛ s t r ɛ x u ʋ ɑ t ɪ
тематичний	t ɪ m ɛ t ɪ t͡ʃ n ɪ i
сірий	sʲ i r ɪ i
покарань	p ɔ k ɛ r ɑ nʲ
трансформацій	t r ɛ n s f ɔ r m ɑ t͡sʲ i i
ласка	ɫ ɑ s k ɛ
гривням	ɦ r ɪ u nʲ ɛ m
половина	p ɔ ɫ ɔ ʋ ɪ n ɛ
євгенія	j ɪ u ɦ ɛ nʲ i j ɛ
поширити	p ɔ ʃ ɪ r ɪ t ɪ
плівка	p lʲ i u k ɛ
їжа	j i ʒ ɛ
поліціях	p ɔ lʲ i t͡sʲ i j ɛ x
віру	ʋ i r u
внучка	ʋ n u t͡ʃ k ɛ
потворний	p ɔ t ʋ ɔ r n ɪ i
литвин	ɫ ɪ t ʋ ɪ n
східний	sʲ x i d n ɪ i
мотоцикл	m ɔ t ɔ t͡s ɪ k ɫ
культурний	k u lʲ t u r n ɪ i
поступки	p ɔ s t u p k ɪ
наркотичний	n ɛ r k ɔ t ɪ t͡ʃ n ɪ i
сукнях	s u k nʲ ɛ x
погоди	p ɔ ɦ ɔ d ɪ
рилу	r ɪ ɫ u
продуктивність	p r ɔ d u k t ɪ u nʲ i sʲ tʲ
двомовність	d ʋ ɔ m ɔ u nʲ i sʲ tʲ
піднебіння	p i d n ɪ b i nʲ ɛ
позбавляти	p ɔ z b ɛ u lʲ ɑ t ɪ
виснажувати	ʋ ɪ s n ɑ ʒ u ʋ ɛ t ɪ
крихітний	k r ɪ x i t n ɪ i
чорних	t͡ʃ ɔ r n ɪ x
смертоносний	s m ɪ r t ɔ n ɔ s n ɪ i
чомусь	t͡ʃ ɔ m u sʲ
глава	ɦ ɫ ɛ ʋ ɑ
розділ	r ɔ zʲ dʲ i ɫ
поздоровляти	p ɔ z d ɔ r ɔ u lʲ ɑ t ɪ
дорога	d ɔ r ɔ ɦ ɛ
неня	n ɛ nʲ ɛ
сповіщення	s p ɔ ʋ i ʃ t͡ʃ ɪ nʲ ɛ
аналізувати	ɛ n ɛ lʲ i z u ʋ ɑ t ɪ
ілюзія	i lʲ u zʲ i j ɛ
в'єтнамський	ʋ j ɪ t n ɑ m sʲ k ɪ i
обґрунтовувати	ɔ b ɡ r u n t ɔ ʋ u ʋ ɛ t ɪ
шестигранний	ʃ ɪ s t ɪ ɦ r ɑ n ɪ i
бувай	b u ʋ ɑ i
українською	u k r ɛ j i nʲ sʲ k ɔ j u
патина	p ɛ t ɪ n ɛ
результат	r ɪ z u lʲ t ɑ t
персональний	p ɪ r s ɔ n ɑ lʲ n ɪ i
стремено	s t r ɪ m ɪ n ɔ
коронавірус	k ɔ r ɔ n ɛ ʋ i r u s
сечогінний	s ɪ t͡ʃ ɔ ɦ i n ɪ i
обшук	ɔ b ʃ u k
заспокійливий	z ɛ s p ɔ k i i ɫ ɪ ʋ ɪ i
дев'яностий	d ɪ ʋ j ɛ n ɔ s t ɪ i
сингапур	s ɪ n ɦ ɛ p u r
тристоронній	t r ɪ s t ɔ r ɔ nʲ i i
вероніка	ʋ ɪ r ɔ nʲ i k ɛ
вступати	ʋ s t u p ɑ t ɪ
доречний	d ɔ r ɛ t͡ʃ n ɪ i
вибирати	ʋ ɪ b ɪ r ɑ t ɪ
друзів	d r u zʲ i u
відокремлювати	ʋ i d ɔ k r ɛ m lʲ u ʋ ɛ t ɪ
заручати	z ɛ r u t͡ʃ ɑ t ɪ
дефект	d ɪ f ɛ k t
помирати	p ɔ m ɪ r ɑ t ɪ
аболіціоніст	ɛ b ɔ lʲ i t͡sʲ i ɔ nʲ i s t
одношлюбність	ɔ d n ɔ ʃ lʲ u b nʲ i sʲ tʲ
мід	m i d
найманець	n ɑ i m ɛ n ɪ t͡sʲ
розгляд	r ɔ z ɦ lʲ ɛ d
загальновідомий	z ɛ ɦ ɛ lʲ n ɔ ʋ i d ɔ m ɪ i
промовляти	p r ɔ m ɔ u lʲ ɑ t ɪ
міністр	m i nʲ i s t r
мікроскоп	m i k r ɔ s k ɔ p
співробітник	sʲ p i u r ɔ b i t n ɪ k
кажучи	k ɑ ʒ u t͡ʃ ɪ
фінляндський	f i nʲ lʲ ɑ n d͡zʲ sʲ k ɪ i
лапша	ɫ ɛ p ʃ ɑ
номінальний	n ɔ m i n ɑ lʲ n ɪ i
кохати	k ɔ x ɑ t ɪ
розчарування	r ɔ ʒ t͡ʃ ɛ r u ʋ ɑ nʲ ɛ
познань	p ɔ z n ɛ nʲ
долоні	d ɔ ɫ ɔ nʲ i
прибічниця	p r ɪ b i t͡ʃ n ɪ t͡sʲ ɛ
пустиня	p u s t ɪ nʲ ɛ
імунологічний	i m u n ɔ ɫ ɔ ɦ i t͡ʃ n ɪ i
розгромити	r ɔ z ɦ r ɔ m ɪ t ɪ
хома	x ɔ m ɑ
вираження	ʋ ɪ r ɛ ʒ ɪ nʲ ɛ
критичний	k r ɪ t ɪ t͡ʃ n ɪ i
афаліна	ɛ f ɛ lʲ i n ɛ
сам	s ɑ m
день	d ɛ nʲ
верес	ʋ ɛ r ɪ s
японія	j ɛ p ɔ nʲ i j ɛ
з'ясувати	z j ɛ s u ʋ ɑ t ɪ
німець	nʲ i m ɪ t͡sʲ
короп	k ɔ r ɔ p
іграшка	i ɦ r ɛ ʃ k ɛ
віртуальний	ʋ i r t u ɑ lʲ n ɪ i
сотий	s ɔ t ɪ i
найменше	n ɛ i m ɛ n ʃ ɪ
орбіти	ɔ r b i t ɪ
пересічний	p ɪ r ɪ sʲ i t͡ʃ n ɪ i
співіснування	sʲ p i ʋ i s n u ʋ ɑ nʲ ɛ
мелодіям	m ɪ ɫ ɔ dʲ i j ɛ m
світогляд	sʲ ʋ i t ɔ ɦ lʲ ɛ d
відокремити	ʋ i d ɔ k r ɛ m ɪ t ɪ
процедурний	p r ɔ t͡s ɪ d u r n ɪ i
сільськогосподарський	sʲ i lʲ sʲ k ɔ ɦ ɔ s p ɔ d ɑ r sʲ k ɪ i
киплячий	k ɪ p lʲ ɑ t͡ʃ ɪ i
алло	ɛ ɫ ɔ
гіпотеза	ɦ i p ɔ t ɪ z ɛ
відновити	ʋ i d n ɔ ʋ ɪ t ɪ
розв'язувати	r ɔ z ʋ j ɑ z u ʋ ɛ t ɪ
ті	tʲ i
живий	ʒ ɪ ʋ ɪ i
антидот	ɛ n t ɪ d ɔ t
мовознавець	m ɔ ʋ ɔ z n ɑ ʋ ɪ t͡sʲ
вікісловник	ʋ i k i s ɫ ɔ u n ɪ k
ексгібіціоністський	ɪ ɡ zʲ ɦ i b i t͡sʲ i ɔ nʲ i sʲ k ɪ i
так	t ɑ k
забобон	z ɛ b ɔ b ɔ n
оренда	ɔ r ɛ n d ɛ
етап	ɪ t ɑ p
повіки	p ɔ ʋ i k ɪ
австромарксист	ɛ u s t r ɔ m ɛ r k s ɪ s t
валютний	ʋ ɛ lʲ u t n ɪ i
етика	ɛ t ɪ k ɛ
болгарин	b ɔ ɫ ɦ ɑ r ɪ n
спроможність	s p r ɔ m ɔ ʒ nʲ i sʲ tʲ
постать	p ɔ s t ɛ tʲ
слухати	s ɫ u x ɛ t ɪ
конотіп	k ɔ n ɔ tʲ i p
авіатранспорт	ɛ ʋ i ɛ t r ɑ n s p ɔ r t
генерувати	ɦ ɪ n ɪ r u ʋ ɑ t ɪ
мільйон	m i lʲ j ɔ n
жук	ʒ u k
щі	ʃ t͡ʃʲ i
словниками	s ɫ ɔ u n ɪ k ɑ m ɪ
лавандовий	ɫ ɛ ʋ ɑ n d ɔ ʋ ɪ i
шведський	ʃ ʋ ɛ d͡zʲ sʲ k ɪ i
замовник	z ɛ m ɔ u n ɪ k
оцими	ɔ t͡s ɪ m ɪ
паузами	p ɑ u z ɛ m ɪ
вчитель	ʋ t͡ʃ ɪ t ɪ lʲ
м'яч	m j ɑ t͡ʃ
безжурний	b ɪ ʒ u r n ɪ i
боліти	b ɔ lʲ i t ɪ
вимерти	ʋ ɪ m ɪ r t ɪ
хотітися	x ɔ tʲ i t ɪ sʲ ɛ
повторювати	p ɔ u t ɔ rʲ u ʋ ɛ t ɪ
землевласник	z ɪ m ɫ ɪ u ɫ ɑ s n ɪ k
звіря	zʲ ʋ i rʲ ɑ
самозакоханий	s ɛ m ɔ z ɛ k ɔ x ɛ n ɪ i
слина	s ɫ ɪ n ɛ
варіантами	ʋ ɛ rʲ i ɑ n t ɛ m ɪ
рекомендувати	r ɪ k ɔ m ɪ n d u ʋ ɑ t ɪ
юриспруденція	j u r ɪ s p r u d ɛ nʲ t͡sʲ i j ɛ
гратися	ɦ r ɑ t ɪ sʲ ɛ
відчути	ʋ i d͡ʒ t͡ʃ u t ɪ
версія	ʋ ɛ r sʲ i j ɛ
чемпіон	t͡ʃ ɪ m p i ɔ n
кіно	k i n ɔ
рибка	r ɪ b k ɛ
огляд	ɔ ɦ lʲ ɛ d
бісексуал	b i s ɪ k s u ɑ ɫ
перекладачка	p ɪ r ɪ k ɫ ɛ d ɑ t͡ʃ k ɛ
перлина	p ɪ r ɫ ɪ n ɛ
релігійний	r ɪ lʲ i ɦ i i n ɪ i
мотиваційний	m ɔ t ɪ ʋ ɛ t͡sʲ i i n ɪ i
виживати	ʋ ɪ ʒ ɪ ʋ ɑ t ɪ
ісус	i s u s
бенін	b ɪ nʲ i n
крига	k r ɪ ɦ ɛ
мрія	m rʲ i j ɛ
невідкладний	n ɪ ʋ i d k ɫ ɑ d n ɪ i
стать	s t ɑ tʲ
стримати	s t r ɪ m ɛ t ɪ
випроменити	ʋ ɪ p r ɔ m ɪ n ɪ t ɪ
отець	ɔ t ɛ t͡sʲ
нетерплячий	n ɪ t ɪ r p lʲ ɑ t͡ʃ ɪ i
нагромаджувати	n ɛ ɦ r ɔ m ɑ d͡ʒ u ʋ ɛ t ɪ
корінь	k ɔ rʲ i nʲ
прекрасний	p r ɪ k r ɑ s n ɪ i
класовий	k ɫ ɑ s ɔ ʋ ɪ i
ворота	ʋ ɔ r ɔ t ɛ
бібліотекарка	b i b lʲ i ɔ t ɛ k ɛ r k ɛ
максимальний	m ɛ k s ɪ m ɑ lʲ n ɪ i
емблематичний	ɪ m b ɫ ɪ m ɛ t ɪ t͡ʃ n ɪ i
мовчати	m ɔ u t͡ʃ ɑ t ɪ
й	j
винокур	ʋ ɪ n ɔ k u r
дивний	d ɪ u n ɪ i
відпочивати	ʋ i d p ɔ t͡ʃ ɪ ʋ ɑ t ɪ
жодний	ʒ ɔ d n ɪ i
проголошувати	p r ɔ ɦ ɔ ɫ ɔ ʃ u ʋ ɛ t ɪ
демонстрація	d ɪ m ɔ n s t r ɑ t͡sʲ i j ɛ
змова	z m ɔ ʋ ɛ
шершень	ʃ ɛ r ʃ ɪ nʲ
відданий	ʋ i d ɛ n ɪ i
розбіжний	r ɔ zʲ b i ʒ n ɪ i
палка	p ɑ ɫ k ɛ
законодавиця	z ɛ k ɔ n ɔ d ɑ ʋ ɪ t͡sʲ ɛ
ємен	j ɛ m ɪ n
теплота	t ɪ p ɫ ɔ t ɑ
хрест	x r ɛ s t
великодній	ʋ ɪ ɫ ɪ k ɔ dʲ nʲ i i
овід	ɔ ʋ i d
сором	s ɔ r ɔ m
периферія	p ɪ r ɪ f ɪ rʲ i j ɛ
мостовий	m ɔ s t ɔ ʋ ɪ i
баклан	b ɛ k ɫ ɑ n
гребти	ɦ r ɪ b t ɪ
аґрусовий	ɑ ɡ r u s ɔ ʋ ɪ i
кінці	k i nʲ t͡sʲ i
звуковий	z ʋ u k ɔ ʋ ɪ i
відповідь	ʋ i d p ɔ ʋ i dʲ
козел	k ɔ z ɛ ɫ
крива	k r ɪ ʋ ɑ
піхва	p i x ʋ ɛ
зоологія	z ɔ ɔ ɫ ɔ ɦ i j ɛ
лопух	ɫ ɔ p u x
дія	dʲ i j ɛ
більш	b i lʲ ʃ
авантура	ɛ ʋ ɛ n t u r ɛ
борщ	b ɔ r ʃ t͡ʃ
роділля	r ɔ dʲ i lʲ ɛ
відстоювати	ʋ i d͡z s t ɔ j u ʋ ɛ t ɪ
привселюдний	p r ɪ u s ɪ lʲ u d n ɪ i
психіатрія	p s ɪ x i ɛ tʲ rʲ i j ɛ
фундаментальний	f u n d ɛ m ɪ n t ɑ lʲ n ɪ i
інфекцію	i n f ɛ k t͡sʲ i j u
похвала	p ɔ x ʋ ɛ ɫ ɑ
періодизаціям	p ɪ rʲ i ɔ d ɪ z ɑ t͡sʲ i j ɛ m
сторож	s t ɔ r ɔ ʒ
органічна	ɔ r ɦ ɛ nʲ i t͡ʃ n ɛ
вирізнятися	ʋ ɪ rʲ i zʲ nʲ ɑ t ɪ sʲ ɛ
дріжджі	dʲ rʲ i ʒ d͡ʒ i
крикливий	k r ɪ k ɫ ɪ ʋ ɪ i
трава	t r ɛ ʋ ɑ
тобою	t ɔ b ɔ j u
евтаназія	ɪ u t ɛ n ɑ zʲ i j ɛ
евакуювати	ɪ ʋ ɛ k u j u ʋ ɑ t ɪ
вимикати	ʋ ɪ m ɪ k ɑ t ɪ
наявність	n ɛ j ɑ u nʲ i sʲ tʲ
обладнати	ɔ b ɫ ɛ d n ɑ t ɪ
подвоювати	p ɔ d ʋ ɔ j u ʋ ɛ t ɪ
умовах	u m ɔ ʋ ɛ x
віросповідання	ʋ i r ɔ s p ɔ ʋ i d ɑ nʲ ɛ
погруддя	p ɔ ɦ r u dʲ ɛ
виглядати	ʋ ɪ ɦ lʲ ɛ d ɑ t ɪ
уособити	u ɔ s ɔ b ɪ t ɪ
видатний	ʋ ɪ d ɛ t n ɪ i
написати	n ɛ p ɪ s ɑ t ɪ
інтенсивність	i n t ɪ n s ɪ u nʲ i sʲ tʲ
софія	s ɔ f i j ɛ
тощо	t ɔ ʃ t͡ʃ ɔ
осмислювати	ɔ s m ɪ sʲ lʲ u ʋ ɛ t ɪ
бездоганний	b ɪ z d ɔ ɦ ɑ n ɪ i
повсюдний	p ɔ u sʲ u d n ɪ i
гуляти	ɦ u lʲ ɑ t ɪ
гранатомет	ɦ r ɛ n ɛ t ɔ m ɛ t
перезаписати	p ɪ r ɪ z ɛ p ɪ s ɑ t ɪ
лауреат	ɫ ɛ u r ɪ ɑ t
фабрика	f ɑ b r ɪ k ɛ
ступити	s t u p ɪ t ɪ
феє	f ɛ j ɪ
влаштовуватися	ʋ ɫ ɛ ʃ t u ʋ ɑ t ɪ sʲ ɛ
тілесний	tʲ i ɫ ɛ s n ɪ i
менше	m ɛ n ʃ ɪ
чарівник	t͡ʃ ɛ rʲ i u n ɪ k
зимовий	z ɪ m ɔ ʋ ɪ i
ламати	ɫ ɛ m ɑ t ɪ
стандарт	s t ɛ n d ɑ r t
зара	z ɑ r ɛ
ірландець	i r ɫ ɑ n d ɪ t͡sʲ
інтерес	i n t ɪ r ɛ s
науковий	n ɛ u k ɔ ʋ ɪ i
мир	m ɪ r
моїй	m ɔ j i i
авіапідживлення	ɛ ʋ i ɛ p i d͡ʒ ɪ u ɫ ɪ nʲ ɛ
важливість	ʋ ɛ ʒ ɫ ɪ ʋ i sʲ tʲ
готовність	ɦ ɔ t ɔ u nʲ i sʲ tʲ
принизити	p r ɪ n ɪ z ɪ t ɪ
брест	b r ɛ s t
японіє	j ɛ p ɔ nʲ i j ɪ
диктатор	d ɪ k t ɑ t ɔ r
момент	m ɔ m ɛ n t
брати	b r ɛ t ɪ
шланг	ʃ ɫ ɑ n ɦ
толерантний	t ɔ ɫ ɪ r ɑ n t n ɪ i
близький	b ɫ ɪ zʲ k ɪ i
шестигранник	ʃ ɪ s t ɪ ɦ r ɑ n ɪ k
онтологія	ɔ n t ɔ ɫ ɔ ɦ i j ɛ
металург	m ɪ t ɛ ɫ u r ɦ
авіапасажир	ɛ ʋ i ɛ p ɛ s ɛ ʒ ɪ r
рецесія	r ɪ t͡s ɛ sʲ i j ɛ
питання	p ɪ t ɑ nʲ ɛ
монгольський	m ɔ n ɦ ɔ lʲ sʲ k ɪ i
колір	k ɔ lʲ i r
повезти	p ɔ ʋ ɪ z t ɪ
бельгійський	b ɪ lʲ ɦ i i sʲ k ɪ i
легеня	ɫ ɪ ɦ ɛ nʲ ɛ
сюди	sʲ u d ɪ
аквамариновий	ɛ k ʋ ɛ m ɛ r ɪ n ɔ ʋ ɪ i
карт	k ɑ r t
пропозиція	p r ɔ p ɔ z ɪ t͡sʲ i j ɛ
охопити	ɔ x ɔ p ɪ t ɪ
шинок	ʃ ɪ n ɔ k
декларацій	d ɪ k ɫ ɛ r ɑ t͡sʲ i i
неподільний	n ɪ p ɔ dʲ i lʲ n ɪ i
освіжати	ɔ sʲ ʋ i ʒ ɑ t ɪ
слухняний	s ɫ u x nʲ ɑ n ɪ i
трагічний	t r ɛ ɦ i t͡ʃ n ɪ i
вкус	ʋ k u s
ацтекський	ɛ t͡s t ɛ k sʲ k ɪ i
паломництво	p ɛ ɫ ɔ m n ɪ t͡s t ʋ ɔ
брехнями	b r ɛ x nʲ ɛ m ɪ
термометр	t ɪ r m ɔ m ɪ t r
оптика	ɔ p t ɪ k ɛ
високосний	ʋ ɪ s ɔ k ɔ s n ɪ i
область	ɔ b ɫ ɛ sʲ tʲ
блокадою	b ɫ ɔ k ɑ d ɔ j u
трав'яний	t r ɛ ʋ j ɛ n ɪ i
заявити	z ɛ j ɛ ʋ ɪ t ɪ
абрикосник	ɛ b r ɪ k ɔ s n ɪ k
будапештський	b u d ɛ p ɛ sʲ t͡sʲ k ɪ i
абстрагування	ɛ b s t r ɛ ɦ u ʋ ɑ nʲ ɛ
біржа	b i r ʒ ɛ
пінистий	p i n ɪ s t ɪ i
щоку	ʃ t͡ʃ ɔ k u
відважний	ʋ i d ʋ ɑ ʒ n ɪ i
дощок	d ɔ ʃ t͡ʃ ɔ k
постачати	p ɔ s t ɛ t͡ʃ ɑ t ɪ
м'язові	m j ɑ z ɔ ʋ i
картографічний	k ɛ r t ɔ ɦ r ɛ f i t͡ʃ n ɪ i
перетинка	p ɪ r ɛ t ɪ n k ɛ
бойко	b ɔ i k ɔ
технократичний	t ɪ x n ɔ k r ɛ t ɪ t͡ʃ n ɪ i
змінити	zʲ m i n ɪ t ɪ
містобудування	m i s t ɔ b u d u ʋ ɑ nʲ ɛ
україномовний	u k r ɛ j i n ɔ m ɔ u n ɪ i
михайло	m ɪ x ɑ i ɫ ɔ
упасти	u p ɑ s t ɪ
таємницями	t ɛ j ɪ m n ɪ t͡sʲ ɛ m ɪ
компактний	k ɔ m p ɑ k t n ɪ i
бірюзовий	b i rʲ u z ɔ ʋ ɪ i
ключовий	k lʲ u t͡ʃ ɔ ʋ ɪ i
епідеміологія	ɪ p i d ɪ m i ɔ ɫ ɔ ɦ i j ɛ
страх	s t r ɑ x
безглуздість	b ɪ z ɦ ɫ u zʲ dʲ i sʲ tʲ
виростати	ʋ ɪ r ɔ s t ɑ t ɪ
рило	r ɪ ɫ ɔ
гаджет	ɦ ɑ d͡ʒ ɪ t
речі	r ɛ t͡ʃʲ i
споживчий	s p ɔ ʒ ɪ u t͡ʃ ɪ i
щиколоток	ʃ t͡ʃ ɪ k ɔ ɫ ɔ t ɔ k
дев'ятеро	d ɛ ʋ j ɛ t ɪ r ɔ
становище	s t ɛ n ɔ ʋ ɪ ʃ t͡ʃ ɪ
скаржитися	s k ɑ r ʒ ɪ t ɪ sʲ ɛ
постатям	p ɔ s t ɛ tʲ ɛ m
біологія	b i ɔ ɫ ɔ ɦ i j ɛ
коханий	k ɔ x ɛ n ɪ i
бруднити	b r u d n ɪ t ɪ
водосховище	ʋ ɔ d ɔ s x ɔ ʋ ɪ ʃ t͡ʃ ɪ
атеїстичний	ɛ t ɪ j i s t ɪ t͡ʃ n ɪ i
одночасно	ɔ d n ɔ t͡ʃ ɑ s n ɔ
звідкись	zʲ ʋ i d k ɪ sʲ
липа	ɫ ɪ p ɛ
стіна	sʲ tʲ i n ɑ
тетяна	t ɪ tʲ ɑ n ɛ
класти	k ɫ ɑ s t ɪ
королеві	k ɔ r ɔ ɫ ɛ ʋ i
важчий	ʋ ɑ ʒ t͡ʃ ɪ i
місіонер	m i sʲ i ɔ n ɛ r
урожай	u r ɔ ʒ ɑ i
мислити	m ɪ s ɫ ɪ t ɪ
аброгація	ɛ b r ɔ ɦ ɑ t͡sʲ i j ɛ
автаркізм	ɛ u t ɛ r k i z m
джгут	d͡ʒ ɦ u t
енциклопедист	ɪ n t͡s ɪ k ɫ ɔ p ɪ d ɪ s t
електронний	ɪ ɫ ɪ k t r ɔ n ɪ i
каплиць	k ɛ p ɫ ɪ t͡sʲ
костел	k ɔ s t ɛ ɫ
вільна	ʋ i lʲ n ɛ
гель	ɦ ɛ lʲ
амбітний	ɛ m b i t n ɪ i
винахідливість	ʋ ɪ n ɛ x i d ɫ ɪ ʋ i sʲ tʲ
шоколадник	ʃ ɔ k ɔ ɫ ɑ d n ɪ k
центральний	t͡s ɪ n t r ɑ lʲ n ɪ i
сорго	s ɔ r ɦ ɔ
глек	ɦ ɫ ɛ k
сани	s ɑ n ɪ
досьє	d ɔ sʲ j ɛ
знайомий	z n ɛ j ɔ m ɪ i
були	b u ɫ ɪ
тоді	t ɔ dʲ i
доброзичливий	d ɔ b r ɔ z ɪ t͡ʃ ɫ ɪ ʋ ɪ i
вулиця	ʋ u ɫ ɪ t͡sʲ ɛ
ідея	i d ɛ j ɛ
тимчасовий	t ɪ m t͡ʃ ɛ s ɔ ʋ ɪ i
писар	p ɪ s ɛ r
докторат	d ɔ k t ɔ r ɑ t
доброта	d ɔ b r ɔ t ɑ
вирости	ʋ ɪ r ɔ s t ɪ
еволюціонувати	ɪ ʋ ɔ lʲ u t͡sʲ i ɔ n u ʋ ɑ t ɪ
потягнути	p ɔ tʲ ɛ ɦ n u t ɪ
надії	n ɛ dʲ i j i
цнотливий	t͡s n ɔ t ɫ ɪ ʋ ɪ i
зозуля	z ɔ z u lʲ ɛ
перед	p ɪ r ɛ d
абеткування	ɛ b ɪ t k u ʋ ɑ nʲ ɛ
документувати	d ɔ k u m ɪ n t u ʋ ɑ t ɪ
ставлення	s t ɑ u ɫ ɪ nʲ ɛ
програма	p r ɔ ɦ r ɑ m ɛ
зоомагазин	z ɔ ɔ m ɛ ɦ ɛ z ɪ n
капітан	k ɛ p i t ɑ n
анамнії	ɛ n ɑ m nʲ i j i
сфер	s f ɛ r
організаціє	ɔ r ɦ ɛ nʲ i z ɑ t͡sʲ i j ɪ
шумливий	ʃ u m ɫ ɪ ʋ ɪ i
аваліст	ɛ ʋ ɛ lʲ i s t
марний	m ɑ r n ɪ i
майя	m ɑ i j ɛ
добувати	d ɔ b u ʋ ɑ t ɪ
женитися	ʒ ɪ n ɪ t ɪ sʲ ɛ
соловей	s ɔ ɫ ɔ ʋ ɛ i
перемир'я	p ɪ r ɪ m ɪ r j ɛ
сплачувати	s p ɫ ɑ t͡ʃ u ʋ ɛ t ɪ
школи	ʃ k ɔ ɫ ɪ
ресторан	r ɪ s t ɔ r ɑ n
кохання	k ɔ x ɑ nʲ ɛ
когнітивний	k ɔ ɦ nʲ i t ɪ u n ɪ i
приземлюватися	p r ɪ z ɛ m lʲ u ʋ ɛ t ɪ sʲ ɛ
мріями	m rʲ i j ɛ m ɪ
ленін	ɫ ɛ nʲ i n
беззастережний	b ɪ z ɛ s t ɪ r ɛ ʒ n ɪ i
свердловина	s ʋ ɪ r d ɫ ɔ ʋ ɪ n ɛ
паузу	p ɑ u z u
журналістка	ʒ u r n ɛ lʲ i s t k ɛ
розглянути	r ɔ z ɦ lʲ ɑ n u t ɪ
соціальний	s ɔ t͡sʲ i ɑ lʲ n ɪ i
вибрати	ʋ ɪ b r ɛ t ɪ
життєздатний	ʒ ɪ tʲ ɪ z d ɑ t n ɪ i
висіти	ʋ ɪ sʲ i t ɪ
емігрувати	ɪ m i ɦ r u ʋ ɑ t ɪ
вигідний	ʋ ɪ ɦ i d n ɪ i
наймати	n ɛ i m ɑ t ɪ
безготівковий	b ɪ z ɦ ɔ tʲ i u k ɔ ʋ ɪ i
дисертація	d ɪ s ɪ r t ɑ t͡sʲ i j ɛ
почати	p ɔ t͡ʃ ɑ t ɪ
молюск	m ɔ lʲ u s k
збір	zʲ b i r
ї	j i
ви	ʋ ɪ
віковічний	ʋ i k ɔ ʋ i t͡ʃ n ɪ i
мікрофон	m i k r ɔ f ɔ n
границя	ɦ r ɛ n ɪ t͡sʲ ɛ
бидло	b ɪ d ɫ ɔ
пригодницький	p r ɪ ɦ ɔ d n ɪ t͡sʲ k ɪ i
намет	n ɛ m ɛ t
замовити	z ɛ m ɔ ʋ ɪ t ɪ
прискорити	p r ɪ s k ɔ r ɪ t ɪ
перебільшити	p ɪ r ɪ b i lʲ ʃ ɪ t ɪ
переривати	p ɪ r ɪ r ɪ ʋ ɑ t ɪ
словника	s ɫ ɔ u n ɪ k ɑ
кілограм	k i ɫ ɔ ɦ r ɑ m
промова	p r ɔ m ɔ ʋ ɛ
токсикологічний	t ɔ k s ɪ k ɔ ɫ ɔ ɦ i t͡ʃ n ɪ i
втілювати	ʋ tʲ i lʲ u ʋ ɛ t ɪ
відображати	ʋ i d ɔ b r ɛ ʒ ɑ t ɪ
мріях	m rʲ i j ɛ x
пов'язати	p ɔ ʋ j ɛ z ɑ t ɪ
потенціал	p ɔ t ɪ nʲ t͡sʲ i ɑ ɫ
піраміда	p i r ɛ m i d ɛ
словак	s ɫ ɔ ʋ ɑ k
бере	b ɪ r ɛ
херсон	x ɪ r s ɔ n
лом	ɫ ɔ m
забрало	z ɛ b r ɑ ɫ ɔ
цивілізаційний	t͡s ɪ ʋ i lʲ i z ɛ t͡sʲ i i n ɪ i
істеричний	i s t ɪ r ɪ t͡ʃ n ɪ i
легітимація	ɫ ɪ ɦ i t ɪ m ɑ t͡sʲ i j ɛ
рукою	r u k ɔ j u
брехень	b r ɛ x ɪ nʲ
благий	b ɫ ɛ ɦ ɪ i
притомність	p r ɪ t ɔ m nʲ i sʲ tʲ
вугор	ʋ u ɦ ɔ r
рівне	rʲ i u n ɪ
вади	ʋ ɑ d ɪ
равлик	r ɑ u ɫ ɪ k
ломака	ɫ ɔ m ɑ k ɛ
акваріум	ɛ k ʋ ɑ rʲ i u m
кипіти	k ɪ p i t ɪ
дитята	d ɪ tʲ ɑ t ɛ
залізо	z ɛ lʲ i z ɔ
вишити	ʋ ɪ ʃ ɪ t ɪ
позаземний	p ɔ z ɛ z ɛ m n ɪ i
бувати	b u ʋ ɑ t ɪ
біднота	b i d n ɔ t ɛ
рослина	r ɔ s ɫ ɪ n ɛ
суть	s u tʲ
печив	p ɛ t͡ʃ ɪ u
дитсадків	d ɪ t͡s ɛ dʲ k i u
революція	r ɪ ʋ ɔ lʲ u t͡sʲ i j ɛ
теоріями	t ɪ ɔ rʲ i j ɛ m ɪ
фірма	f i r m ɛ
врятовувати	ʋ rʲ ɛ t ɔ ʋ u ʋ ɛ t ɪ
карликовий	k ɑ r ɫ ɪ k ɔ ʋ ɪ i
дискусія	d ɪ s k u sʲ i j ɛ
делегат	d ɪ ɫ ɪ ɦ ɑ t
рейтузи	r ɪ i t u z ɪ
щоби	ʃ t͡ʃ ɔ b ɪ
людина	lʲ u d ɪ n ɛ
легеневий	ɫ ɪ ɦ ɪ n ɛ ʋ ɪ i
парасолька	p ɛ r ɛ s ɔ lʲ k ɛ
абрикоса	ɛ b r ɪ k ɔ s ɛ
словацький	s ɫ ɔ ʋ ɑ t͡sʲ k ɪ i
спорт	s p ɔ r t
каштан	k ɛ ʃ t ɑ n
підвищувати	p i d ʋ ɪ ʃ t͡ʃ u ʋ ɛ t ɪ
спланувати	s p ɫ ɛ n u ʋ ɑ t ɪ
абзац	ɛ b z ɑ t͡s
суперник	s u p ɛ r n ɪ k
авіста	ɛ ʋ i s t ɛ
операція	ɔ p ɪ r ɑ t͡sʲ i j ɛ
авгіїв	ɛ u ɦ i j i u
імітація	i m i t ɑ t͡sʲ i j ɛ
смертний	s m ɛ r t n ɪ i
ватрушка	ʋ ɛ t r u ʃ k ɛ
абияк	ɛ b ɪ j ɛ k
прислухування	p r ɪ s ɫ u x u ʋ ɛ nʲ ɛ
мовити	m ɔ ʋ ɪ t ɪ
славити	s ɫ ɑ ʋ ɪ t ɪ
турнір	t u r nʲ i r
барвник	b ɛ r ʋ n ɪ k
песимістичний	p ɪ s ɪ m i s t ɪ t͡ʃ n ɪ i
церковний	t͡s ɪ r k ɔ u n ɪ i
маланка	m ɛ ɫ ɑ n k ɛ
недавно	n ɪ d ɑ u n ɔ
галюцинація	ɦ ɛ lʲ u t͡s ɪ n ɑ t͡sʲ i j ɛ
гербата	ɦ ɪ r b ɑ t ɛ
справи	s p r ɑ ʋ ɪ
шаповал	ʃ ɛ p ɔ ʋ ɑ ɫ
підхожий	p i d x ɔ ʒ ɪ i
марта	m ɑ r t ɛ
пришви	p r ɪ ʃ ʋ ɪ
холодно	x ɔ ɫ ɔ d n ɔ
спортсменка	s p ɔ r t͡s m ɛ n k ɛ
переорієнтувати	p ɪ r ɪ ɔ rʲ i j ɪ n t u ʋ ɑ t ɪ
григоріанський	ɦ r ɪ ɦ ɔ rʲ i ɑ nʲ sʲ k ɪ i
автобусний	ɛ u t ɔ b u s n ɪ i
відсвяткувати	ʋ i d͡z sʲ ʋ ɛ t k u ʋ ɑ t ɪ
вітальне	ʋ i t ɑ lʲ n ɪ
лівія	lʲ i ʋ i j ɛ
вечері	ʋ ɪ t͡ʃ ɛ rʲ i
анонімність	ɛ n ɔ nʲ i m nʲ i sʲ tʲ
уникнути	u n ɪ k n u t ɪ
українським	u k r ɛ j i nʲ sʲ k ɪ m
тригліцерид	t r ɪ ɦ lʲ i t͡s ɪ r ɪ d
безперебійний	b ɪ z p ɪ r ɪ b i i n ɪ i
пісня	p i sʲ nʲ ɛ
аномалія	ɛ n ɔ m ɑ lʲ i j ɛ
портфелях	p ɔ r t f ɛ lʲ ɛ x
доїхати	d ɔ j i x ɛ t ɪ
велосипед	ʋ ɪ ɫ ɔ s ɪ p ɛ d
варіантові	ʋ ɛ rʲ i ɑ n t ɔ ʋ i
кончина	k ɔ n t͡ʃ ɪ n ɛ
ґандж	ɡ ɑ n d͡ʒ
міфологія	m i f ɔ ɫ ɔ ɦ i j ɛ
домашнє	d ɔ m ɑ ʃ nʲ ɪ
стопа	s t ɔ p ɑ
кримінальний	k r ɪ m i n ɑ lʲ n ɪ i
дешевший	d ɪ ʃ ɛ u ʃ ɪ i
роман	r ɔ m ɑ n
патріотизмі	p ɛ tʲ rʲ i ɔ t ɪ zʲ m i
авіатраса	ɛ ʋ i ɛ t r ɑ s ɛ
опубліковувати	ɔ p u b lʲ i k ɔ ʋ u ʋ ɛ t ɪ
порівняння	p ɔ rʲ i u nʲ ɑ nʲ ɛ
включати	ʋ k lʲ u t͡ʃ ɑ t ɪ
природнича	p r ɪ r ɔ d n ɪ t͡ʃ ɛ
технічний	t ɪ x nʲ i t͡ʃ n ɪ i
стабільний	s t ɛ b i lʲ n ɪ i
прибічник	p r ɪ b i t͡ʃ n ɪ k
зад	z ɑ d
вівсами	ʋ i u s ɛ m ɪ
відвага	ʋ i d ʋ ɑ ɦ ɛ
однина	ɔ d n ɪ n ɑ
телескоп	t ɪ ɫ ɪ s k ɔ p
коливання	k ɔ ɫ ɪ ʋ ɑ nʲ ɛ
відповідати	ʋ i d p ɔ ʋ i d ɑ t ɪ
синочок	s ɪ n ɔ t͡ʃ ɔ k
письменниці	p ɪ sʲ m ɛ n ɪ t͡sʲ i
згодний	z ɦ ɔ d n ɪ i
герцогиня	ɦ ɪ r t͡s ɔ ɦ ɪ nʲ ɛ
твар	t ʋ ɑ r
догма	d ɔ ɦ m ɛ
акул	ɛ k u ɫ
примусити	p r ɪ m u s ɪ t ɪ
гони	ɦ ɔ n ɪ
риба	r ɪ b ɛ
відрізнятися	ʋ i dʲ rʲ i zʲ nʲ ɑ t ɪ sʲ ɛ
вибратися	ʋ ɪ b r ɛ t ɪ sʲ ɛ
навігаційний	n ɛ ʋ i ɦ ɛ t͡sʲ i i n ɪ i
незалежносте	n ɪ z ɛ ɫ ɛ ʒ n ɔ s t ɪ
рушниця	r u ʃ n ɪ t͡sʲ ɛ
афганістан	ɛ f ɦ ɛ nʲ i s t ɑ n
освіжити	ɔ sʲ ʋ i ʒ ɪ t ɪ
перевага	p ɪ r ɪ ʋ ɑ ɦ ɛ
арістотель	ɛ rʲ i s t ɔ t ɪ lʲ
квадратний	k ʋ ɛ d r ɑ t n ɪ i
вибиратися	ʋ ɪ b ɪ r ɑ t ɪ sʲ ɛ
інтернаціональний	i n t ɪ r n ɛ t͡sʲ i ɔ n ɑ lʲ n ɪ i
кукурудза	k u k u r u d͡z ɛ
сформулювати	s f ɔ r m u lʲ u ʋ ɑ t ɪ
абатиса	ɛ b ɛ t ɪ s ɛ
вікторія	ʋ i k t ɔ rʲ i j ɛ
стандарту	s t ɛ n d ɑ r t u
абсолютист	ɛ b s ɔ lʲ u t ɪ s t
геополітика	ɦ ɪ ɔ p ɔ lʲ i t ɪ k ɛ
змагатися	z m ɛ ɦ ɑ t ɪ sʲ ɛ
тирана	t ɪ r ɑ n ɛ
таліях	t ɑ lʲ i j ɛ x
абляція	ɛ b lʲ ɑ t͡sʲ i j ɛ
абсолютно	ɛ b s ɔ lʲ u t n ɔ
співбесідниця	sʲ p i u b ɪ sʲ i d n ɪ t͡sʲ ɛ
сентиментальний	s ɪ n t ɪ m ɪ n t ɑ lʲ n ɪ i
присутність	p r ɪ s u tʲ nʲ i sʲ tʲ
довоєнний	d ɔ ʋ ɔ j ɛ n ɪ i
складний	s k ɫ ɛ d n ɪ i
різноманітний	rʲ i z n ɔ m ɛ nʲ i t n ɪ i
невідповідний	n ɪ ʋ i d p ɔ ʋ i d n ɪ i
злочинець	z ɫ ɔ t͡ʃ ɪ n ɪ t͡sʲ
веретено	ʋ ɪ r ɪ t ɛ n ɔ
анжеліка	ɛ n ʒ ɪ lʲ i k ɛ
дисиміляція	d ɪ s ɪ m i lʲ ɑ t͡sʲ i j ɛ
постійно	p ɔ sʲ tʲ i i n ɔ
інструкціях	i n s t r u k t͡sʲ i j ɛ x
брухт	b r u x t
пропозицією	p r ɔ p ɔ z ɪ t͡sʲ i j ɪ j u
когут	k ɔ ɦ u t
звернення	z ʋ ɛ r n ɪ nʲ ɛ
авантюрниця	ɛ ʋ ɛ nʲ tʲ u r n ɪ t͡sʲ ɛ
диплома	d ɪ p ɫ ɔ m ɛ
ірина	i r ɪ n ɛ
мева	m ɛ ʋ ɛ
подивитися	p ɔ d ɪ ʋ ɪ t ɪ sʲ ɛ
абстрагованість	ɛ b s t r ɛ ɦ ɔ ʋ ɛ nʲ i sʲ tʲ
внаслідок	ʋ n ɑ sʲ lʲ i d ɔ k
ситий	s ɪ t ɪ i
маслина	m ɛ s ɫ ɪ n ɛ
харизматичний	x ɛ r ɪ z m ɛ t ɪ t͡ʃ n ɪ i
орбіт	ɔ r b i t
ложе	ɫ ɔ ʒ ɪ
бюро	b u r ɔ
шестірня	ʃ ɪ sʲ tʲ i r nʲ ɑ
інвестиція	i n ʋ ɪ s t ɪ t͡sʲ i j ɛ
другові	d r u ɦ ɔ ʋ i
еякулювати	ɪ j ɛ k u lʲ u ʋ ɑ t ɪ
сприймати	s p r ɪ i m ɑ t ɪ
нарвал	n ɛ r ʋ ɑ ɫ
основний	ɔ s n ɔ u n ɪ i
печивами	p ɛ t͡ʃ ɪ ʋ ɛ m ɪ
феях	f ɛ j ɛ x
навчити	n ɛ u t͡ʃ ɪ t ɪ
бобер	b ɔ b ɛ r
окупація	ɔ k u p ɑ t͡sʲ i j ɛ
модернізувати	m ɔ d ɪ r nʲ i z u ʋ ɑ t ɪ
чверті	t͡ʃ ʋ ɛ r tʲ i
жила	ʒ ɪ ɫ ɑ
зазначати	z ɛ z n ɛ t͡ʃ ɑ t ɪ
кишенькові	k ɪ ʃ ɪ nʲ k ɔ ʋ i
гвінея	ɦ ʋ i n ɛ j ɛ
дивізіях	d ɪ ʋ i zʲ i j ɛ x
фрагменти	f r ɛ ɦ m ɛ n t ɪ
беззубий	b ɪ z u b ɪ i
польща	p ɔ lʲ ʃ t͡ʃ ɛ
декларативний	d ɪ k ɫ ɛ r ɛ t ɪ u n ɪ i
цікавий	t͡sʲ i k ɑ ʋ ɪ i
шумний	ʃ u m n ɪ i
восьмисот	ʋ ɔ sʲ m ɪ s ɔ t
критеріям	k r ɪ t ɛ rʲ i j ɛ m
луна	ɫ u n ɑ
аероскопія	ɛ ɪ r ɔ s k ɔ p i j ɛ
завершення	z ɛ ʋ ɛ r ʃ ɪ nʲ ɛ
електромагнетизм	ɪ ɫ ɪ k t r ɔ m ɛ ɦ n ɪ t ɪ z m
автовагон	ɛ u t ɔ ʋ ɛ ɦ ɔ n
весільна	ʋ ɪ sʲ i lʲ n ɛ
вільнодумець	ʋ i lʲ n ɔ d u m ɪ t͡sʲ
скловидний	s k ɫ ɔ ʋ ɪ d n ɪ i
довічний	d ɔ ʋ i t͡ʃ n ɪ i
нирка	n ɪ r k ɛ
віл	ʋ i ɫ
ковзкий	k ɔ u z k ɪ i
доброчесний	d ɔ b r ɔ t͡ʃ ɛ s n ɪ i
обстежувати	ɔ b s t ɛ ʒ u ʋ ɛ t ɪ
танцювати	t ɛ nʲ t͡sʲ u ʋ ɑ t ɪ
дисертацій	d ɪ s ɪ r t ɑ t͡sʲ i i
опитати	ɔ p ɪ t ɑ t ɪ
авіз	ɛ ʋ i z
догадуватися	d ɔ ɦ ɑ d u ʋ ɛ t ɪ sʲ ɛ
решта	r ɛ ʃ t ɛ
коала	k ɔ ɑ ɫ ɛ
дисципліна	d ɪ s t͡s ɪ p lʲ i n ɛ
мілина	m i ɫ ɪ n ɑ
сюрприз	sʲ u r p r ɪ z
сповільнювати	s p ɔ ʋ i lʲ nʲ u ʋ ɛ t ɪ
спис	s p ɪ s
неподалік	n ɪ p ɔ d ɛ lʲ i k
ради	r ɑ d ɪ
шкірі	ʃ k i rʲ i
слимак	s ɫ ɪ m ɑ k
повікам	p ɔ ʋ i k ɛ m
зелен	z ɛ ɫ ɪ n
повстанець	p ɔ u s t ɑ n ɪ t͡sʲ
тисячоліть	t ɪ sʲ ɛ t͡ʃ ɔ lʲ i tʲ
прямокутний	p rʲ ɛ m ɔ k u t n ɪ i
погодитися	p ɔ ɦ ɔ d ɪ t ɪ sʲ ɛ
переосмислювати	p ɪ r ɪ ɔ s m ɪ sʲ lʲ u ʋ ɛ t ɪ
погуляти	p ɔ ɦ u lʲ ɑ t ɪ
відзвітувати	zʲ ʋ i t u ʋ ɑ t ɪ
стратегія	s t r ɛ t ɛ ɦ i j ɛ
парадоксальний	p ɛ r ɛ d ɔ k s ɑ lʲ n ɪ i
епох	ɪ p ɔ x
справах	s p r ɑ ʋ ɛ x
льотчик	lʲ ɔ tʃ ɪ k
румунський	r u m u nʲ sʲ k ɪ i
віяти	ʋ i j ɛ t ɪ
зарубіжжя	z ɛ r u b i ʒʲ ɛ
грізний	ɦ rʲ i z n ɪ i
ситуаціях	s ɪ t u ɑ t͡sʲ i j ɛ x
кришка	k r ɪ ʃ k ɛ
зображати	z ɔ b r ɛ ʒ ɑ t ɪ
організацією	ɔ r ɦ ɛ nʲ i z ɑ t͡sʲ i j ɪ j u
безжальний	b ɪ ʒ ɑ lʲ n ɪ i
така	t ɛ k ɑ
інерційний	i n ɪ r t͡sʲ i i n ɪ i
занурювати	z ɛ n u rʲ u ʋ ɛ t ɪ
драматургічний	d r ɛ m ɛ t u r ɦ i t͡ʃ n ɪ i
започатковувати	z ɛ p ɔ t͡ʃ ɛ t k ɔ ʋ u ʋ ɛ t ɪ
спадкоємиця	s p ɛ d k ɔ j ɛ m ɪ t͡sʲ ɛ
трансплантації	t r ɛ n s p ɫ ɛ n t ɑ t͡sʲ i j i
автовласник	ɛ u t ɔ u ɫ ɑ s n ɪ k
комар	k ɔ m ɑ r
кубань	k u b ɑ nʲ
уявити	u j ɛ ʋ ɪ t ɪ
федерацією	f ɪ d ɪ r ɑ t͡sʲ i j ɪ j u
українськими	u k r ɛ j i nʲ sʲ k ɪ m ɪ
ураження	u r ɑ ʒ ɪ nʲ ɛ
дата	d ɑ t ɛ
всесвітньовідомий	ʋ s ɪ sʲ ʋ i tʲ nʲ ɔ ʋ i d ɔ m ɪ i
город	ɦ ɔ r ɔ d
унікальний	u nʲ i k ɑ lʲ n ɪ i
лісова	lʲ i s ɔ ʋ ɑ
чорниця	t͡ʃ ɔ r n ɪ t͡sʲ ɛ
лінійний	lʲ i nʲ i i n ɪ i
типовий	t ɪ p ɔ ʋ ɪ i
пухлина	p u x ɫ ɪ n ɛ
споживання	s p ɔ ʒ ɪ ʋ ɑ nʲ ɛ
вимираючий	ʋ ɪ m ɪ r ɑ j u t͡ʃ ɪ i
посуд	p ɔ s u d
нас	n ɑ s
мінімум	m i nʲ i m u m
діафрагмами	dʲ i ɛ f r ɑ ɦ m ɛ m ɪ
однокласник	ɔ d n ɔ k ɫ ɑ s n ɪ k
вужчий	ʋ u ʒ t͡ʃ ɪ i
енциклопедистка	ɪ n t͡s ɪ k ɫ ɔ p ɪ d ɪ s t k ɛ
інвестиційний	i n ʋ ɪ s t ɪ t͡sʲ i i n ɪ i
критикувати	k r ɪ t ɪ k u ʋ ɑ t ɪ
ґринджоли	ɡ r ɪ n d͡ʒ ɔ ɫ ɪ
прислухуватися	p r ɪ s ɫ u x u ʋ ɛ t ɪ sʲ ɛ
справо	s p r ɑ ʋ ɔ
пилосос	p ɪ ɫ ɔ s ɔ s
опис	ɔ p ɪ s
озимий	ɔ z ɪ m ɪ i
негативний	n ɪ ɦ ɛ t ɪ u n ɪ i
галасливий	ɦ ɛ ɫ ɛ s ɫ ɪ ʋ ɪ i
ти	t ɪ
природному	p r ɪ r ɔ d n ɔ m u
королівський	k ɔ r ɔ lʲ i u sʲ k ɪ i
недостатньо	n ɪ d ɔ s t ɑ tʲ nʲ ɔ
важливий	ʋ ɛ ʒ ɫ ɪ ʋ ɪ i
стайня	s t ɑ i nʲ ɛ
болниця	b ɔ ɫ n ɪ t͡sʲ ɛ
поліпшити	p ɔ lʲ i p ʃ ɪ t ɪ
кода	k ɔ d ɛ
демократизувати	d ɪ m ɔ k r ɛ t ɪ z u ʋ ɑ t ɪ
комунізм	k ɔ m u nʲ i z m
гідравлічний	ɦ i d r ɛ u lʲ i t͡ʃ n ɪ i
привітати	p r ɪ ʋ i t ɑ t ɪ
вільнодумка	ʋ i lʲ n ɔ d u m k ɛ
ворожнеча	ʋ ɔ r ɔ ʒ n ɛ t͡ʃ ɛ
незнання	n ɪ z n ɛ nʲ ɑ
паровоз	p ɛ r ɔ ʋ ɔ z
лошак	ɫ ɔ ʃ ɑ k
ігор	i ɦ ɔ r
недооцінювати	n ɪ d ɔ ɔ t͡sʲ i nʲ u ʋ ɛ t ɪ
стілець	sʲ tʲ i ɫ ɛ t͡sʲ
письменниця	p ɪ sʲ m ɛ n ɪ t͡sʲ ɛ
виграш	ʋ ɪ ɦ r ɛ ʃ
туризм	t u r ɪ z m
албанія	ɛ ɫ b ɑ nʲ i j ɛ
глід	ɦ lʲ i d
співчутливий	sʲ p i u t͡ʃ u t ɫ ɪ ʋ ɪ i
медитація	m ɪ d ɪ t ɑ t͡sʲ i j ɛ
міжурядовий	m i ʒ u rʲ ɛ d ɔ ʋ ɪ i
діафрагмі	dʲ i ɛ f r ɑ ɦ m i
завантажити	z ɛ ʋ ɛ n t ɑ ʒ ɪ t ɪ
вакцинація	ʋ ɛ k t͡s ɪ n ɑ t͡sʲ i j ɛ
панпсихізм	p ɛ n p s ɪ x i z m
елегантний	ɪ ɫ ɪ ɦ ɑ n t n ɪ i
республіка	r ɪ s p u b lʲ i k ɛ
хижак	x ɪ ʒ ɑ k
тротуарі	t r ɔ t u ɑ rʲ i
аберація	ɛ b ɪ r ɑ t͡sʲ i j ɛ
щастя	ʃ t͡ʃ ɑ sʲ tʲ ɛ
ніс	nʲ i s
булава	b u ɫ ɛ ʋ ɑ
асимптота	ɛ s ɪ m p t ɔ t ɛ
метри	m ɛ t r ɪ
трагедіє	t r ɛ ɦ ɛ dʲ i j ɪ
засновник	z ɛ s n ɔ u n ɪ k
радіоактивний	r ɑ dʲ i ɔ ɛ k t ɪ u n ɪ i
гіперактивний	ɦ i p ɪ r ɛ k t ɪ u n ɪ i
телеведуча	t ɪ ɫ ɪ ʋ ɪ d u t͡ʃ ɛ
скло	s k ɫ ɔ
фактично	f ɛ k t ɪ t͡ʃ n ɔ
законодавство	z ɛ k ɔ n ɔ d ɑ u s t ʋ ɔ
дошках	d ɔ ʃ k ɛ x
кільце	k i lʲ t͡s ɛ
батіг	b ɛ tʲ i ɦ
каплицю	k ɛ p ɫ ɪ t͡sʲ u
ізумрудний	i z u m r u d n ɪ i
келих	k ɛ ɫ ɪ x
антибіотики	ɛ n t ɪ b i ɔ t ɪ k ɪ
сукня	s u k nʲ ɛ
кишенях	k ɪ ʃ ɛ nʲ ɛ x
португальський	p ɔ r t u ɦ ɑ lʲ sʲ k ɪ i
цвіт	t͡sʲ ʋ i t
радість	r ɑ dʲ i sʲ tʲ
космологія	k ɔ s m ɔ ɫ ɔ ɦ i j ɛ
портфеля	p ɔ r t f ɛ lʲ ɛ
можна	m ɔ ʒ n ɛ
різноманіття	rʲ i z n ɔ m ɛ nʲ i tʲ ɛ
амбіція	ɛ m b i t͡sʲ i j ɛ
родзинка	r ɔ d͡z ɪ n k ɛ
зручний	z r u t͡ʃ n ɪ i
мітотичний	m i t ɔ t ɪ t͡ʃ n ɪ i
ненароджений	n ɪ n ɛ r ɔ d͡ʒ ɪ n ɪ i
десертах	d ɪ s ɛ r t ɛ x
слов'янині	s ɫ ɔ ʋ j ɛ n ɪ nʲ i
щоко	ʃ t͡ʃ ɔ k ɔ
безжалісний	b ɪ ʒ ɑ lʲ i s n ɪ i
клуатр	k ɫ u ɑ t r
карась	k ɛ r ɑ sʲ
суспільство	s u sʲ p i lʲ s t ʋ ɔ
шкатулка	ʃ k ɛ t u ɫ k ɛ
хімічний	x i m i t͡ʃ n ɪ i
бутан	b u t ɑ n
трикутник	t r ɪ k u t n ɪ k
ангольський	ɛ n ɦ ɔ lʲ sʲ k ɪ i
трьохсотий	tʲ rʲ ɔ x s ɔ t ɪ i
імперіям	i m p ɛ rʲ i j ɛ m
метрів	m ɛ tʲ rʲ i u
таць	t ɑ t͡sʲ
автогемотерапія	ɛ u t ɔ ɦ ɪ m ɔ t ɪ r ɛ p i j ɛ
ампер	ɛ m p ɛ r
підготовляти	p i d ɦ ɔ t ɔ u lʲ ɑ t ɪ
прати	p r ɑ t ɪ
небажання	n ɪ b ɛ ʒ ɑ nʲ ɛ
дивізіям	d ɪ ʋ i zʲ i j ɛ m
рідна	rʲ i d n ɛ
танцюристки	t ɛ nʲ t͡sʲ u r ɪ s t k ɪ
зайнятий	z ɑ i nʲ ɛ t ɪ i
теоріям	t ɪ ɔ rʲ i j ɛ m
інвестувати	i n ʋ ɪ s t u ʋ ɑ t ɪ
виріб	ʋ ɪ rʲ i b
скайдайвінг	s k ɛ i d ɑ j ʋ i n ɦ
христина	x r ɪ s t ɪ n ɛ
мелодію	m ɪ ɫ ɔ dʲ i j u
копати	k ɔ p ɑ t ɪ
серцевий	s ɪ r t͡s ɛ ʋ ɪ i
щавель	ʃ t͡ʃ ɛ ʋ ɛ lʲ
загреб	z ɑ ɦ r ɪ b
ковдра	k ɔ u d r ɛ
кисень	k ɪ s ɪ nʲ
співрозмовник	sʲ p i u r ɔ z m ɔ u n ɪ k
дути	d u t ɪ
латиський	ɫ ɛ t ɪ sʲ k ɪ i
термометричний	t ɪ r m ɔ m ɪ t r ɪ t͡ʃ n ɪ i
аналогічний	ɛ n ɛ ɫ ɔ ɦ i t͡ʃ n ɪ i
коаліційний	k ɔ ɛ lʲ i t͡sʲ i i n ɪ i
вперше	ʋ p ɛ r ʃ ɪ
олег	ɔ ɫ ɛ ɦ
використання	ʋ ɪ k ɔ r ɪ s t ɑ nʲ ɛ
специфічний	s p ɪ t͡s ɪ f i t͡ʃ n ɪ i
делегатка	d ɪ ɫ ɪ ɦ ɑ t k ɛ
неправду	n ɪ p r ɑ u d u
шовковиця	ʃ ɔ u k ɔ ʋ ɪ t͡sʲ ɛ
для	dʲ lʲ ɑ
шовковий	ʃ ɔ u k ɔ ʋ ɪ i
склянка	s k lʲ ɑ n k ɛ
гілля	ɦ i lʲ ɛ
ікло	i k ɫ ɔ
знадобитися	z n ɛ d ɔ b ɪ t ɪ sʲ ɛ
волейболістка	ʋ ɔ ɫ ɪ i b ɔ lʲ i s t k ɛ
зображувати	z ɔ b r ɑ ʒ u ʋ ɛ t ɪ
зима	z ɪ m ɑ
еякуляція	ɪ j ɛ k u lʲ ɑ t͡sʲ i j ɛ
змі	zʲ m i
японію	j ɛ p ɔ nʲ i j u
помста	p ɔ m s t ɛ
авіабаза	ɛ ʋ i ɛ b ɑ z ɛ
австрійський	ɛ u s tʲ rʲ i i sʲ k ɪ i
кара	k ɑ r ɛ
пархоменко	p ɛ r x ɔ m ɪ n k ɔ
енергій	ɪ n ɛ r ɦ i i
аптека	ɛ p t ɛ k ɛ
лише	ɫ ɪ ʃ ɛ
терпеливість	t ɪ r p ɪ ɫ ɪ ʋ i sʲ tʲ
здогадуватися	z d ɔ ɦ ɑ d u ʋ ɛ t ɪ sʲ ɛ
яловичину	j ɑ ɫ ɔ ʋ ɪ t͡ʃ ɪ n u
морський	m ɔ r sʲ k ɪ i
динамічно	d ɪ n ɛ m i t͡ʃ n ɔ
ягода	j ɑ ɦ ɔ d ɛ
аврора	ɛ u r ɔ r ɛ
безчесний	b ɪ ʒ t͡ʃ ɛ s n ɪ i
ґніт	ɡ nʲ i t
дієвий	dʲ i j ɛ ʋ ɪ i
характерний	x ɛ r ɛ k t ɛ r n ɪ i
смерека	s m ɪ r ɛ k ɛ
вижлоктати	ʋ ɪ ʒ ɫ ɔ k t ɛ t ɪ
швидкістю	ʃ ʋ ɪ dʲ k i sʲ tʲ u
трагедія	t r ɛ ɦ ɛ dʲ i j ɛ
підприємство	p i d p r ɪ j ɛ m s t ʋ ɔ
муха	m u x ɛ
теща	t ɛ ʃ t͡ʃ ɛ
незамінність	n ɪ z ɛ m i nʲ i sʲ tʲ
людці	lʲ u d͡zʲ t͡sʲ i
тополям	t ɔ p ɔ lʲ ɛ m
вайло	ʋ ɛ i ɫ ɔ
надій	n ɛ dʲ i i
дебютувати	d ɪ b u t u ʋ ɑ t ɪ
відчиняти	ʋ i d͡ʒ t͡ʃ ɪ nʲ ɑ t ɪ
юшка	j u ʃ k ɛ
упевненість	u p ɛ u n ɪ nʲ i sʲ tʲ
наявний	n ɛ j ɑ u n ɪ i
найбільший	n ɛ i b i lʲ ʃ ɪ i
ситуаціями	s ɪ t u ɑ t͡sʲ i j ɛ m ɪ
комора	k ɔ m ɔ r ɛ
подібність	p ɔ dʲ i b nʲ i sʲ tʲ
суб'єкт	s u b j ɛ k t
уживати	u ʒ ɪ ʋ ɑ t ɪ
дебіл	d ɪ b i ɫ
любов	lʲ u b ɔ u
звідси	zʲ ʋ i d͡z s ɪ
завантажувати	z ɛ ʋ ɛ n t ɑ ʒ u ʋ ɛ t ɪ
давати	d ɛ ʋ ɑ t ɪ
неврологія	n ɪ u r ɔ ɫ ɔ ɦ i j ɛ
відстояти	ʋ i d͡z s t ɔ j ɑ t ɪ
розчаровувати	r ɔ ʒ t͡ʃ ɛ r ɔ ʋ u ʋ ɛ t ɪ
катастрофами	k ɛ t ɛ s t r ɔ f ɛ m ɪ
клясти	k lʲ ɛ s t ɪ
тому	t ɔ m u
долонях	d ɔ ɫ ɔ nʲ ɛ x
всередині	ʋ s ɪ r ɛ d ɪ nʲ i
мексиканка	m ɪ k s ɪ k ɑ n k ɛ
живець	ʒ ɪ ʋ ɛ t͡sʲ
побачення	p ɔ b ɑ t͡ʃ ɪ nʲ ɛ
шкідливий	ʃ k i d ɫ ɪ ʋ ɪ i
маскат	m ɛ s k ɑ t
оцією	ɔ t͡sʲ i j ɛ j u
обідати	ɔ b i d ɛ t ɪ
цегла	t͡s ɛ ɦ ɫ ɛ
слівцях	sʲ lʲ i u t͡sʲ ɛ x
старик	s t ɛ r ɪ k
трансформаціях	t r ɛ n s f ɔ r m ɑ t͡sʲ i j ɛ x
вітряний	ʋ i tʲ rʲ ɛ n ɪ i
смола	s m ɔ ɫ ɑ
салдат	s ɛ ɫ d ɑ t
народитися	n ɛ r ɔ d ɪ t ɪ sʲ ɛ
реванш	r ɪ ʋ ɑ n ʃ
перевалювати	p ɪ r ɪ ʋ ɑ lʲ u ʋ ɛ t ɪ
допустити	d ɔ p u s t ɪ t ɪ
бактеріальний	b ɛ k t ɪ rʲ i ɑ lʲ n ɪ i
жовтень	ʒ ɔ u t ɪ nʲ
двадцятиоднокутник	d ʋ ɛ d͡zʲ t͡sʲ ɛ t ɪ ɔ d n ɔ k u t n ɪ k
підняти	p i dʲ nʲ ɑ t ɪ
гарантія	ɦ ɛ r ɑ nʲ tʲ i j ɛ
постатях	p ɔ s t ɛ tʲ ɛ x
кілометр	k i ɫ ɔ m ɛ t r
білий	b i ɫ ɪ i
підвіконня	p i dʲ ʋ i k ɔ nʲ ɛ
дослідниця	d ɔ sʲ lʲ i d n ɪ t͡sʲ ɛ
авіарейд	ɛ ʋ i ɛ r ɛ i d
візовий	ʋ i z ɔ ʋ ɪ i
тім	tʲ i m
промисловість	p r ɔ m ɪ s ɫ ɔ ʋ i sʲ tʲ
сонце	s ɔ n t͡s ɪ
печера	p ɪ t͡ʃ ɛ r ɛ
дешевий	d ɪ ʃ ɛ ʋ ɪ i
вербальний	ʋ ɪ r b ɑ lʲ n ɪ i
перевезення	p ɪ r ɪ ʋ ɛ z ɪ nʲ ɛ
таємницях	t ɛ j ɪ m n ɪ t͡sʲ ɛ x
антагонізм	ɛ n t ɛ ɦ ɔ nʲ i z m
сполучник	s p ɔ ɫ u t͡ʃ n ɪ k
синтезувати	s ɪ n t ɪ z u ʋ ɑ t ɪ
зоровий	z ɔ r ɔ ʋ ɪ i
пояснювальний	p ɔ j ɑ sʲ nʲ u ʋ ɛ lʲ n ɪ i
сприйняття	s p r ɪ i nʲ ɛ tʲ ɑ
концепт	k ɔ n t͡s ɛ p t
крісло	k rʲ i s ɫ ɔ
шанувальник	ʃ ɛ n u ʋ ɑ lʲ n ɪ k
страхіття	s t r ɛ x i tʲ ɛ
дому	d ɔ m u
положення	p ɔ ɫ ɔ ʒ ɪ nʲ ɛ
забороняти	z ɛ b ɔ r ɔ nʲ ɑ t ɪ
слівцем	sʲ lʲ i u t͡s ɛ m
шестикутний	ʃ ɪ s t ɪ k u t n ɪ i
абсурдність	ɛ b s u r dʲ nʲ i sʲ tʲ
недільний	n ɪ dʲ i lʲ n ɪ i
щітка	ʃ t͡ʃʲ i t k ɛ
смоктати	s m ɔ k t ɑ t ɪ
помідор	p ɔ m i d ɔ r
дізнатися	dʲ i z n ɑ t ɪ sʲ ɛ
напередодні	n ɛ p ɪ r ɪ d ɔ dʲ nʲ i
хтивий	x t ɪ ʋ ɪ i
авіаметеостанція	ɛ ʋ i ɛ m ɪ t ɪ ɔ s t ɑ nʲ t͡sʲ i j ɛ
кросівка	k r ɔ sʲ i u k ɛ
знижувати	z n ɪ ʒ u ʋ ɛ t ɪ
чось	t͡ʃ ɔ sʲ
мережа	m ɪ r ɛ ʒ ɛ
арфіст	ɛ r f i s t
утратам	u t r ɑ t ɛ m
аборт	ɛ b ɔ r t
підтримувати	p i d t r ɪ m u ʋ ɛ t ɪ
взірець	ʋ zʲ i r ɛ t͡sʲ
обчислювати	ɔ b t͡ʃ ɪ sʲ lʲ u ʋ ɛ t ɪ
референдумах	r ɪ f ɪ r ɛ n d u m ɛ x
слати	s ɫ ɑ t ɪ
воротар	ʋ ɔ r ɔ t ɑ r
нумограй	n u m ɔ ɦ r ɑ i
вдовець	ʋ d ɔ ʋ ɛ t͡sʲ
галстук	ɦ ɑ ɫ s t u k
друзям	d r u zʲ ɛ m
зупинка	z u p ɪ n k ɛ
друг	d r u ɦ
туркменістан	t u r k m ɪ nʲ i s t ɑ n
завойовувати	z ɛ ʋ ɔ j ɔ ʋ u ʋ ɛ t ɪ
скоро	s k ɔ r ɔ
конкурентоспроможність	k ɔ n k u r ɪ n t ɔ s p r ɔ m ɔ ʒ nʲ i sʲ tʲ
вечірка	ʋ ɪ t͡ʃʲ i r k ɛ
ризик	r ɪ z ɪ k
акцентувати	ɛ k t͡s ɪ n t u ʋ ɑ t ɪ
спитати	s p ɪ t ɑ t ɪ
частка	t͡ʃ ɑ s t k ɛ
скроні	s k r ɔ nʲ i
повставати	p ɔ u s t ɛ ʋ ɑ t ɪ
комедія	k ɔ m ɛ dʲ i j ɛ
позиція	p ɔ z ɪ t͡sʲ i j ɛ
міф	m i f
гривні	ɦ r ɪ u nʲ i
восьмисотий	ʋ ɔ sʲ m ɪ s ɔ t ɪ i
ліцензія	lʲ i t͡s ɛ nʲ zʲ i j ɛ
порядковий	p ɔ rʲ ɛ d k ɔ ʋ ɪ i
команда	k ɔ m ɑ n d ɛ
поїти	p ɔ j i t ɪ
арка	ɑ r k ɛ
видра	ʋ ɪ d r ɛ
аероліт	ɛ ɪ r ɔ lʲ i t
пам'ятник	p ɑ m j ɛ t n ɪ k
приймати	p r ɪ i m ɑ t ɪ
добривечір	d ɔ b r ɪ ʋ ɛ t͡ʃʲ i r
схематизувати	s x ɪ m ɛ t ɪ z u ʋ ɑ t ɪ
бурштин	b u r ʃ t ɪ n
мексиканський	m ɪ k s ɪ k ɑ nʲ sʲ k ɪ i
колись	k ɔ ɫ ɪ sʲ
яструб	j ɑ s t r u b
спірний	sʲ p i r n ɪ i
ранній	r ɑ nʲ i i
календаря	k ɛ ɫ ɪ n d ɛ rʲ ɑ
жасмин	ʒ ɛ s m ɪ n
литка	ɫ ɪ t k ɛ
грішний	ɦ rʲ i ʃ n ɪ i
переконати	p ɪ r ɪ k ɔ n ɑ t ɪ
папір	p ɛ p i r
подія	p ɔ dʲ i j ɛ
зібратися	zʲ i b r ɑ t ɪ sʲ ɛ
авіаметеослужба	ɛ ʋ i ɛ m ɪ t ɪ ɔ s ɫ u ʒ b ɛ
медуза	m ɪ d u z ɛ
героїчний	ɦ ɪ r ɔ j i t͡ʃ n ɪ i
кіт	k i t
сідницям	sʲ i d n ɪ t͡sʲ ɛ m
спідницями	sʲ p i d n ɪ t͡sʲ ɛ m ɪ
шептати	ʃ ɪ p t ɑ t ɪ
охра	ɔ x r ɛ
лексикографічний	ɫ ɪ k s ɪ k ɔ ɦ r ɛ f i t͡ʃ n ɪ i
визначення	ʋ ɪ z n ɛ t͡ʃ ɪ nʲ ɛ
раніший	r ɛ nʲ i ʃ ɪ i
в'язень	ʋ j ɑ z ɪ nʲ
категоричний	k ɛ t ɪ ɦ ɔ r ɪ t͡ʃ n ɪ i
гуцульщина	ɦ u t͡s u lʲ ʃ t͡ʃ ɪ n ɛ
масть	m ɑ sʲ tʲ
портативний	p ɔ r t ɛ t ɪ u n ɪ i
англійка	ɛ n ɦ lʲ i i k ɛ
репресивний	r ɪ p r ɪ s ɪ u n ɪ i
просьба	p r ɔ zʲ b ɛ
особистий	ɔ s ɔ b ɪ s t ɪ i
обдарувати	ɔ b d ɛ r u ʋ ɑ t ɪ
рицар	r ɪ t͡s ɛ r
убогий	u b ɔ ɦ ɪ i
морфологія	m ɔ r f ɔ ɫ ɔ ɦ i j ɛ
вісь	ʋ i sʲ
заступник	z ɛ s t u p n ɪ k
козакові	k ɔ z ɛ k ɔ ʋ i
авієтка	ɛ ʋ i j ɛ t k ɛ
безпілотний	b ɪ zʲ p i ɫ ɔ t n ɪ i
формулювати	f ɔ r m u lʲ u ʋ ɑ t ɪ
прав	p r ɑ u
лотерея	ɫ ɔ t ɪ r ɛ j ɛ
лисиця	ɫ ɪ s ɪ t͡sʲ ɛ
ющенко	j u ʃ t͡ʃ ɪ n k ɔ
четвер	t͡ʃ ɪ t ʋ ɛ r
гладіатор	ɦ ɫ ɛ dʲ i ɑ t ɔ r
гуманістка	ɦ u m ɛ nʲ i s t k ɛ
дзьоб	d͡zʲ ɔ b
діаметрально	dʲ i ɛ m ɪ t r ɑ lʲ n ɔ
хвіст	x ʋ i s t
інтелектуальний	i n t ɪ ɫ ɪ k t u ɑ lʲ n ɪ i
тестування	t ɪ s t u ʋ ɑ nʲ ɛ
грабіж	ɦ r ɛ b i ʒ
пласт	p ɫ ɑ s t
здібний	zʲ dʲ i b n ɪ i
обдурювати	ɔ b d u rʲ u ʋ ɛ t ɪ
психологія	p s ɪ x ɔ ɫ ɔ ɦ i j ɛ
незадоволення	n ɪ z ɛ d ɔ ʋ ɔ ɫ ɪ nʲ ɛ
єврейський	j ɪ u r ɛ i sʲ k ɪ i
срібний	sʲ rʲ i b n ɪ i
волокти	ʋ ɔ ɫ ɔ k t ɪ
абстракціоніст	ɛ b s t r ɛ k t͡sʲ i ɔ nʲ i s t
нідерланди	nʲ i d ɪ r ɫ ɑ n d ɪ
органи	ɔ r ɦ ɛ n ɪ
щитоподібна	ʃ t͡ʃ ɪ t ɔ p ɔ dʲ i b n ɛ
олігархія	ɔ lʲ i ɦ ɑ r x i j ɛ
безособовий	b ɪ z ɔ s ɔ b ɔ ʋ ɪ i
божественне	b ɔ ʒ ɛ s t ʋ ɪ n ɪ
ліберальний	lʲ i b ɪ r ɑ lʲ n ɪ i
руку	r u k u
важко	ʋ ɑ ʒ k ɔ
тісний	tʲ i s n ɪ i
намібія	n ɛ m i b i j ɛ
журнал	ʒ u r n ɑ ɫ
бездомний	b ɪ z d ɔ m n ɪ i
активістка	ɛ k t ɪ ʋ i s t k ɛ
аблактування	ɛ b ɫ ɛ k t u ʋ ɑ nʲ ɛ
удосвіта	u d ɔ sʲ ʋ i t ɛ
вівсу	ʋ i u s u
комедій	k ɔ m ɛ dʲ i i
контрастувати	k ɔ n t r ɛ s t u ʋ ɑ t ɪ
принаймні	p r ɪ n ɑ i m nʲ i
ліс	lʲ i s
поглинути	p ɔ ɦ ɫ ɪ n u t ɪ
конотоп	k ɔ n ɔ t ɔ p
наблизити	n ɛ b ɫ ɪ z ɪ t ɪ
квантова	k ʋ ɑ n t ɔ ʋ ɛ
самотній	s ɛ m ɔ tʲ nʲ i i
нестерпний	n ɪ s t ɛ r p n ɪ i
плавець	p ɫ ɛ ʋ ɛ t͡sʲ
богослів'я	b ɔ ɦ ɔ sʲ lʲ i ʋ j ɛ
разі	r ɑ zʲ i
квітень	k ʋ i t ɪ nʲ
здріти	z dʲ rʲ i t ɪ
смітник	sʲ m i t n ɪ k
млин	m ɫ ɪ n
абвер	ɑ b ʋ ɪ r
лякатися	lʲ ɛ k ɑ t ɪ sʲ ɛ
виборами	ʋ ɪ b ɔ r ɛ m ɪ
неперервний	n ɪ p ɪ r ɛ r ʋ n ɪ i
тяжкий	tʲ ɛ ʒ k ɪ i
фоб	f ɔ b
авіаполк	ɛ ʋ i ɛ p ɔ ɫ k
арифметичний	ɛ r ɪ f m ɪ t ɪ t͡ʃ n ɪ i
концентрація	k ɔ n t͡s ɪ n t r ɑ t͡sʲ i j ɛ
варіантів	ʋ ɛ rʲ i ɑ nʲ tʲ i u
виборі	ʋ ɪ b ɔ rʲ i
диван	d ɪ ʋ ɑ n
інколи	i n k ɔ ɫ ɪ
експонат	ɪ k s p ɔ n ɑ t
ворожий	ʋ ɔ r ɔ ʒ ɪ i
випадок	ʋ ɪ p ɑ d ɔ k
артеріям	ɛ r t ɛ rʲ i j ɛ m
сервіс	s ɛ r ʋ i s
традиційно	t r ɛ d ɪ t͡sʲ i i n ɔ
стиль	s t ɪ lʲ
їй	j i i
рилам	r ɪ ɫ ɛ m
сусідство	s u sʲ i d͡z s t ʋ ɔ
богослов'я	b ɔ ɦ ɔ s ɫ ɔ ʋ j ɛ
підтримати	p i d t r ɪ m ɛ t ɪ
допитливий	d ɔ p ɪ t ɫ ɪ ʋ ɪ i
уявіть	u j ɛ ʋ i tʲ
астрономія	ɛ s t r ɔ n ɔ m i j ɛ
чотирьохсот	t͡ʃ ɔ t ɪ rʲ ɔ x s ɔ t
кухонний	k u x ɔ n ɪ i
галиця	ɦ ɑ ɫ ɪ t͡sʲ ɛ
парашутизм	p ɛ r ɛ ʃ u t ɪ z m
звук	z ʋ u k
долоням	d ɔ ɫ ɔ nʲ ɛ m
спричинювати	s p r ɪ t͡ʃ ɪ nʲ u ʋ ɛ t ɪ
громадянство	ɦ r ɔ m ɛ dʲ ɑ n s t ʋ ɔ
п'ятнадцятий	p j ɛ t n ɑ d͡zʲ t͡sʲ ɛ t ɪ i
сонечко	s ɔ n ɪ t͡ʃ k ɔ
родитися	r ɔ d ɪ t ɪ sʲ ɛ
молекулярна	m ɔ ɫ ɪ k u lʲ ɑ r n ɛ
латвія	ɫ ɑ tʲ ʋ i j ɛ
рук	r u k
молодиця	m ɔ ɫ ɔ d ɪ t͡sʲ ɛ
ознака	ɔ z n ɑ k ɛ
дня	dʲ nʲ ɑ
файний	f ɑ i n ɪ i
аріка	ɛ rʲ i k ɛ
хобі	x ɔ b i
авторизувати	ɛ u t ɔ r ɪ z u ʋ ɑ t ɪ
мандрівник	m ɛ n dʲ rʲ i u n ɪ k
громадянка	ɦ r ɔ m ɛ dʲ ɑ n k ɛ
поєднання	p ɔ j ɪ d n ɑ nʲ ɛ
перевищити	p ɪ r ɪ ʋ ɪ ʃ t͡ʃ ɪ t ɪ
листопад	ɫ ɪ s t ɔ p ɑ d
ікра	i k r ɑ
психолог	p s ɪ x ɔ ɫ ɔ ɦ
працівниці	p r ɛ t͡sʲ i u n ɪ t͡sʲ i
бета	b ɛ t ɛ
аварійний	ɛ ʋ ɛ rʲ i i n ɪ i
страта	s t r ɑ t ɛ
самоціль	s ɛ m ɔ t͡sʲ i lʲ
осердя	ɔ s ɛ r dʲ ɛ
передчасний	p ɪ r ɪ d͡ʒ t͡ʃ ɑ s n ɪ i
егоїстичний	ɪ ɦ ɔ j i s t ɪ t͡ʃ n ɪ i
тренер	t r ɛ n ɪ r
калій	k ɑ lʲ i i
велиґдень	ʋ ɪ ɫ ɪ ɡ d ɪ nʲ
болото	b ɔ ɫ ɔ t ɔ
зобов'язання	z ɔ b ɔ ʋ j ɑ z ɛ nʲ ɛ
існуючий	i s n u j u t͡ʃ ɪ i
сприятливий	s p r ɪ j ɑ t ɫ ɪ ʋ ɪ i
можливість	m ɔ ʒ ɫ ɪ ʋ i sʲ tʲ
родовий	r ɔ d ɔ ʋ ɪ i
посадка	p ɔ s ɑ d k ɛ
з'їдати	z j i d ɑ t ɪ
обмежувати	ɔ b m ɛ ʒ u ʋ ɛ t ɪ
апарат	ɛ p ɛ r ɑ t
стимул	s t ɪ m u ɫ
сімейний	sʲ i m ɛ i n ɪ i
населити	n ɛ s ɪ ɫ ɪ t ɪ
є	j ɛ
принести	p r ɪ n ɪ s t ɪ
капуста	k ɛ p u s t ɛ
терем	t ɛ r ɪ m
крим	k r ɪ m
орієнтувати	ɔ rʲ i j ɪ n t u ʋ ɑ t ɪ
аркуш	ɑ r k u ʃ
інтерактивний	i n t ɪ r ɛ k t ɪ u n ɪ i
гнати	ɦ n ɑ t ɪ
тарас	t ɛ r ɑ s
оповідання	ɔ p ɔ ʋ i d ɑ nʲ ɛ
вівсів	ʋ i u sʲ i u
петицій	p ɪ t ɪ t͡sʲ i i
німий	nʲ i m ɪ i
прислівниковий	p r ɪ sʲ lʲ i u n ɪ k ɔ ʋ ɪ i
безвідсотковий	b ɪ zʲ ʋ i d͡z s ɔ t k ɔ ʋ ɪ i
навруз	n ɛ u r u z
зрозумілість	z r ɔ z u m i lʲ i sʲ tʲ
вся	ʋ sʲ ɑ
пень	p ɛ nʲ
настати	n ɛ s t ɑ t ɪ
нещирий	n ɪ ʃ t͡ʃ ɪ r ɪ i
пропорція	p r ɔ p ɔ r t͡sʲ i j ɛ
дзиґа	d͡z ɪ ɡ ɛ
блокадами	b ɫ ɔ k ɑ d ɛ m ɪ
авіабензин	ɛ ʋ i ɛ b ɪ n z ɪ n
бик	b ɪ k
заглядати	z ɛ ɦ lʲ ɛ d ɑ t ɪ
вечора	ʋ ɛ t͡ʃ ɔ r ɛ
судинний	s u d ɪ n ɪ i
цегляний	t͡s ɪ ɦ lʲ ɛ n ɪ i
гаманець	ɦ ɛ m ɛ n ɛ t͡sʲ
сцена	s t͡s ɛ n ɛ
освітній	ɔ sʲ ʋ i tʲ nʲ i i
моногамний	m ɔ n ɔ ɦ ɑ m n ɪ i
змагання	z m ɛ ɦ ɑ nʲ ɛ
райдуга	r ɑ i d u ɦ ɛ
ваді	ʋ ɑ dʲ i
шведка	ʃ ʋ ɛ d k ɛ
розвідування	r ɔ zʲ ʋ i d u ʋ ɛ nʲ ɛ
спорожняти	s p ɔ r ɔ ʒ nʲ ɑ t ɪ
перевищувати	p ɪ r ɪ ʋ ɪ ʃ t͡ʃ u ʋ ɛ t ɪ
пристрій	p r ɪ s tʲ rʲ i i
поема	p ɔ ɛ m ɛ
чайна	t͡ʃ ɛ i n ɑ
коровай	k ɔ r ɔ ʋ ɑ i
календарем	k ɛ ɫ ɪ n d ɛ r ɛ m
орнітологія	ɔ r nʲ i t ɔ ɫ ɔ ɦ i j ɛ
спадщина	s p ɑ d ʃ t͡ʃ ɪ n ɛ
попередній	p ɔ p ɪ r ɛ dʲ nʲ i i
різновид	rʲ i z n ɔ ʋ ɪ d
хронологія	x r ɔ n ɔ ɫ ɔ ɦ i j ɛ
опитувати	ɔ p ɪ t u ʋ ɛ t ɪ
абіогенез	ɛ b i ɔ ɦ ɪ n ɛ z
бонусом	b ɔ n u s ɔ m
досвідчений	d ɔ sʲ ʋ i d͡ʒ t͡ʃ ɪ n ɪ i
геймплей	ɦ ɪ i m p ɫ ɛ i
гріб	ɦ rʲ i b
застраховувати	z ɛ s t r ɛ x ɔ ʋ u ʋ ɛ t ɪ
гривень	ɦ r ɪ ʋ ɪ nʲ
вжити	ʋ ʒ ɪ t ɪ
корчма	k ɔ r t͡ʃ m ɛ
оцінювати	ɔ t͡sʲ i nʲ u ʋ ɛ t ɪ
ензим	ɪ n z ɪ m
власна	ʋ ɫ ɑ s n ɛ
мотоциклах	m ɔ t ɔ t͡s ɪ k ɫ ɛ x
поступці	p ɔ s t u p t͡sʲ i
дівчина	dʲ i u t͡ʃ ɪ n ɛ
морозиво	m ɔ r ɔ z ɪ ʋ ɔ
ультиматум	u lʲ t ɪ m ɑ t u m
батяри	b ɛ tʲ ɑ r ɪ
вторгатися	ʋ t ɔ r ɦ ɑ t ɪ sʲ ɛ
підрости	p i d r ɔ s t ɪ
функціональний	f u n k t͡sʲ i ɔ n ɑ lʲ n ɪ i
благо	b ɫ ɑ ɦ ɔ
намагатися	n ɛ m ɛ ɦ ɑ t ɪ sʲ ɛ
личинка	ɫ ɪ t͡ʃ ɪ n k ɛ
отруйний	ɔ t r u i n ɪ i
безплатний	b ɪ z p ɫ ɑ t n ɪ i
можливий	m ɔ ʒ ɫ ɪ ʋ ɪ i
установити	u s t ɛ n ɔ ʋ ɪ t ɪ
ставати	s t ɛ ʋ ɑ t ɪ
прийти	p r ɪ i t ɪ
уособлювати	u ɔ s ɔ b lʲ u ʋ ɛ t ɪ
слов'янко	s ɫ ɔ ʋ j ɑ n k ɔ
наступниця	n ɛ s t u p n ɪ t͡sʲ ɛ
коротше	k ɔ r ɔ t͡ʃ ʃ ɪ
картопля	k ɛ r t ɔ p lʲ ɛ
ідеалістичний	i d ɪ ɛ lʲ i s t ɪ t͡ʃ n ɪ i
пропорції	p r ɔ p ɔ r t͡sʲ i j i
ігнорувати	i ɦ n ɔ r u ʋ ɑ t ɪ
кишеню	k ɪ ʃ ɛ nʲ u
ми	m ɪ
вольний	ʋ ɔ lʲ n ɪ i
промокнути	p r ɔ m ɔ k n u t ɪ
монополіст	m ɔ n ɔ p ɔ lʲ i s t
собівартість	s ɔ b i ʋ ɑ r tʲ i sʲ tʲ
простота	p r ɔ s t ɔ t ɑ
етимологія	ɪ t ɪ m ɔ ɫ ɔ ɦ i j ɛ
швидкість	ʃ ʋ ɪ dʲ k i sʲ tʲ
слухач	s ɫ u x ɑ t͡ʃ
законах	z ɛ k ɔ n ɛ x
найбільше	n ɛ i b i lʲ ʃ ɪ
позбутися	p ɔ z b u t ɪ sʲ ɛ
гірший	ɦ i r ʃ ɪ i
тістечко	tʲ i s t ɪ t͡ʃ k ɔ
білка	b i ɫ k ɛ
молекулярний	m ɔ ɫ ɪ k u lʲ ɑ r n ɪ i
соня	s ɔ nʲ ɛ
старання	s t ɛ r ɑ nʲ ɛ
налаштовувати	n ɛ ɫ ɛ ʃ t ɔ ʋ u ʋ ɛ t ɪ
формування	f ɔ r m u ʋ ɑ nʲ ɛ
щука	ʃ t͡ʃ u k ɛ
агресивність	ɛ ɦ r ɪ s ɪ u nʲ i sʲ tʲ
деталь	d ɪ t ɑ lʲ
біженка	b i ʒ ɪ n k ɛ
блокаді	b ɫ ɔ k ɑ dʲ i
емпіричний	ɪ m p i r ɪ t͡ʃ n ɪ i
нейтралітет	n ɪ i t r ɛ lʲ i t ɛ t
кіш	k i ʃ
трибунал	t r ɪ b u n ɑ ɫ
стефанія	s t ɪ f ɑ nʲ i j ɛ
фільтр	f i lʲ t r
природничий	p r ɪ r ɔ d n ɪ t͡ʃ ɪ i
текстовий	t ɪ k s t ɔ ʋ ɪ i
пуголовок	p u ɦ ɔ ɫ ɔ ʋ ɔ k
олівець	ɔ lʲ i ʋ ɛ t͡sʲ
угорець	u ɦ ɔ r ɪ t͡sʲ
родзинки	r ɔ d͡z ɪ n k ɪ
видовище	ʋ ɪ d ɔ ʋ ɪ ʃ t͡ʃ ɪ
імперія	i m p ɛ rʲ i j ɛ
притулок	p r ɪ t u ɫ ɔ k
коефіцієнт	k ɔ ɪ f i t͡sʲ i j ɛ n t
чебрець	t͡ʃ ɪ b r ɛ t͡sʲ
хмельницький	x m ɪ lʲ n ɪ t͡sʲ k ɪ i
націоналістичний	n ɛ t͡sʲ i ɔ n ɛ lʲ i s t ɪ t͡ʃ n ɪ i
косити	k ɔ s ɪ t ɪ
багатий	b ɛ ɦ ɑ t ɪ i
фактичний	f ɛ k t ɪ t͡ʃ n ɪ i
покарання	p ɔ k ɛ r ɑ nʲ ɛ
тисяч	t ɪ sʲ ɛ t͡ʃ
поглядові	p ɔ ɦ lʲ ɛ d ɔ ʋ i
розвальні	r ɔ z ʋ ɛ lʲ nʲ i
шкірах	ʃ k i r ɛ x
відданість	ʋ i d ɛ nʲ i sʲ tʲ
пороховий	p ɔ r ɔ x ɔ ʋ ɪ i
авіадесантник	ɛ ʋ i ɛ d ɪ s ɑ n t n ɪ k
двічі	dʲ ʋ i t͡ʃʲ i
приємність	p r ɪ j ɛ m nʲ i sʲ tʲ
танцюристок	t ɛ nʲ t͡sʲ u r ɪ s t ɔ k
пандус	p ɑ n d u s
лунь	ɫ u nʲ
меморандум	m ɪ m ɔ r ɑ n d u m
абхазець	ɛ b x ɑ z ɪ t͡sʲ
охороняти	ɔ x ɔ r ɔ nʲ ɑ t ɪ
археологів	ɛ r x ɪ ɔ ɫ ɔ ɦ i u
декларацією	d ɪ k ɫ ɛ r ɑ t͡sʲ i j ɪ j u
пріоритет	p rʲ i ɔ r ɪ t ɛ t
меншість	m ɛ nʲ ʃ i sʲ tʲ
маніпулювати	m ɛ nʲ i p u lʲ u ʋ ɑ t ɪ
академічний	ɛ k ɛ d ɪ m i t͡ʃ n ɪ i
гриб	ɦ r ɪ b
україною	u k r ɛ j i n ɔ j u
ув'язнення	u ʋ j ɑ z n ɪ nʲ ɛ
безвідповідальність	b ɪ zʲ ʋ i d p ɔ ʋ i d ɑ lʲ nʲ i sʲ tʲ
аґрусівка	ɛ ɡ r u sʲ i u k ɛ
голландія	ɦ ɔ ɫ ɑ nʲ dʲ i j ɛ
супругою	s u p r u ɦ ɔ j u
вбивати	ʋ b ɪ ʋ ɑ t ɪ
бібліофіл	b i b lʲ i ɔ f i ɫ
скидати	s k ɪ d ɑ t ɪ
впевнений	ʋ p ɛ u n ɪ n ɪ i
боягузливий	b ɔ j ɛ ɦ u z ɫ ɪ ʋ ɪ i
винайти	ʋ ɪ n ɛ i t ɪ
особа	ɔ s ɔ b ɛ
аб'юрація	ɛ b j u r ɑ t͡sʲ i j ɛ
молдавія	m ɔ ɫ d ɑ ʋ i j ɛ
очолити	ɔ t͡ʃ ɔ ɫ ɪ t ɪ
ментовка	m ɪ n t ɔ u k ɛ
дисбаланс	d ɪ z b ɛ ɫ ɑ n s
кравченко	k r ɑ u t͡ʃ ɪ n k ɔ
стар	s t ɑ r
переоцінювати	p ɪ r ɪ ɔ t͡sʲ i nʲ u ʋ ɛ t ɪ
позбавити	p ɔ z b ɑ ʋ ɪ t ɪ
персоніфікація	p ɪ r s ɔ nʲ i f i k ɑ t͡sʲ i j ɛ
найнижчий	n ɛ i n ɪ ʒ t͡ʃ ɪ i
гібридний	ɦ i b r ɪ d n ɪ i
греція	ɦ r ɛ t͡sʲ i j ɛ
душ	d u ʃ
філософія	f i ɫ ɔ s ɔ f i j ɛ
безсмертя	b ɪ z s m ɛ r tʲ ɛ
безперервний	b ɪ z p ɪ r ɛ r ʋ n ɪ i
сусідка	s u sʲ i d k ɛ
скляний	s k lʲ ɛ n ɪ i
мимоволі	m ɪ m ɔ ʋ ɔ lʲ i
першість	p ɛ r ʃ i sʲ tʲ
інтенсифікувати	i n t ɪ n s ɪ f i k u ʋ ɑ t ɪ
ріпами	rʲ i p ɛ m ɪ
феміністичний	f ɪ m i nʲ i s t ɪ t͡ʃ n ɪ i
женевський	ʒ ɪ n ɛ u sʲ k ɪ i
голодомор	ɦ ɔ ɫ ɔ d ɔ m ɔ r
безболісність	b ɪ z b ɔ lʲ i sʲ nʲ i sʲ tʲ
дати	d ɑ t ɪ
погоджуватися	p ɔ ɦ ɔ d͡ʒ u ʋ ɛ t ɪ sʲ ɛ
підмет	p i d m ɪ t
ворожість	ʋ ɔ r ɔ ʒʲ i sʲ tʲ
від'їбатися	ʋ i d j i b ɑ t ɪ sʲ ɛ
золота	z ɔ ɫ ɔ t ɛ
прамова	p r ɛ m ɔ ʋ ɛ
каплицею	k ɛ p ɫ ɪ t͡s ɪ j u
систематичний	s ɪ s t ɪ m ɛ t ɪ t͡ʃ n ɪ i
смердіти	s m ɪ r dʲ i t ɪ
змій	zʲ m i i
росіянин	r ɔ sʲ i j ɑ n ɪ n
зупинятися	z u p ɪ nʲ ɑ t ɪ sʲ ɛ
наймичка	n ɑ i m ɪ t͡ʃ k ɛ
тополі	t ɔ p ɔ lʲ i
датувати	d ɛ t u ʋ ɑ t ɪ
вечер	ʋ ɪ t͡ʃ ɛ r
виклик	ʋ ɪ k ɫ ɪ k
поляки	p ɔ lʲ ɑ k ɪ
активність	ɛ k t ɪ u nʲ i sʲ tʲ
занотовувати	z ɛ n ɔ t ɔ ʋ u ʋ ɛ t ɪ
безтурботний	b ɪ z t u r b ɔ t n ɪ i
вата	ʋ ɑ t ɛ
авіасалон	ɛ ʋ i ɛ s ɛ ɫ ɔ n
допустимий	d ɔ p u s t ɪ m ɪ i
даремність	d ɛ r ɛ m nʲ i sʲ tʲ
головний	ɦ ɔ ɫ ɔ u n ɪ i
хутро	x u t r ɔ
забезпечувати	z ɛ b ɪ z p ɛ t͡ʃ u ʋ ɛ t ɪ
раціями	r ɑ t͡sʲ i j ɛ m ɪ
спортивний	s p ɔ r t ɪ u n ɪ i
перекладати	p ɪ r ɪ k ɫ ɛ d ɑ t ɪ
започаткувати	z ɛ p ɔ t͡ʃ ɛ t k u ʋ ɑ t ɪ
кліматичний	k lʲ i m ɛ t ɪ t͡ʃ n ɪ i
мітоз	m i t ɔ z
вищий	ʋ ɪ ʃ t͡ʃ ɪ i
відпочилий	ʋ i d p ɔ t͡ʃ ɪ ɫ ɪ i
чабер	t͡ʃ ɛ b ɛ r
чий	t͡ʃ ɪ i
психологічний	p s ɪ x ɔ ɫ ɔ ɦ i t͡ʃ n ɪ i
мізерний	m i z ɪ r n ɪ i
албанка	ɛ ɫ b ɑ n k ɛ
токар	t ɔ k ɛ r
мікроскопія	m i k r ɔ s k ɔ p i j ɛ
саундтрек	s ɛ u n d t r ɛ k
ціна	t͡sʲ i n ɑ
стовбур	s t ɔ u b u r
угорськомовний	u ɦ ɔ r sʲ k ɔ m ɔ u n ɪ i
щиколотки	ʃ t͡ʃ ɪ k ɔ ɫ ɔ t k ɪ
хвилина	x ʋ ɪ ɫ ɪ n ɛ
шоколад	ʃ ɔ k ɔ ɫ ɑ d
яма	j ɑ m ɛ
дані	d ɑ nʲ i
політик	p ɔ lʲ i t ɪ k
зовні	z ɔ u nʲ i
прапір	p r ɑ p i r
репутація	r ɪ p u t ɑ t͡sʲ i j ɛ
сумніватися	s u m nʲ i ʋ ɑ t ɪ sʲ ɛ
вітебськ	ʋ i t ɪ b sʲ k
баритися	b ɛ r ɪ t ɪ sʲ ɛ
друже	d r u ʒ ɪ
сироватка	s ɪ r ɔ ʋ ɛ t k ɛ
купа	k u p ɛ
самостійність	s ɛ m ɔ sʲ tʲ i i nʲ i sʲ tʲ
слухачка	s ɫ u x ɑ t͡ʃ k ɛ
називати	n ɛ z ɪ ʋ ɑ t ɪ
сусідів	s u sʲ i dʲ i u
рейк'явік	r ɪ i k j ɑ ʋ i k
очиці	ɔ t͡ʃ ɪ t͡sʲ i
музика	m u z ɪ k ɛ
періодично	p ɪ rʲ i ɔ d ɪ t͡ʃ n ɔ
мотоциклам	m ɔ t ɔ t͡s ɪ k ɫ ɛ m
скарб	s k ɑ r b
концепція	k ɔ n t͡s ɛ p t͡sʲ i j ɛ
більшості	b i lʲ ʃ ɔ sʲ tʲ i
бурмило	b u r m ɪ ɫ ɔ
пауз	p ɑ u z
конлі	k ɔ nʲ lʲ i
рости	r ɔ s t ɪ
прикро	p r ɪ k r ɔ
морква	m ɔ r k ʋ ɛ
будда	b u d ɛ
партнер	p ɛ r t n ɛ r
заборонити	z ɛ b ɔ r ɔ n ɪ t ɪ
семисотий	s ɪ m ɪ s ɔ t ɪ i
термін	t ɛ r m i n
прагнення	p r ɑ ɦ n ɪ nʲ ɛ
активувати	ɛ k t ɪ ʋ u ʋ ɑ t ɪ
пандемічний	p ɛ n d ɪ m i t͡ʃ n ɪ i
візантійський	ʋ i z ɛ nʲ tʲ i i sʲ k ɪ i
контроль	k ɔ n t r ɔ lʲ
завіса	z ɛ ʋ i s ɛ
півстоліття	p i u s t ɔ lʲ i tʲ ɛ
асистент	ɛ s ɪ s t ɛ n t
погляд	p ɔ ɦ lʲ ɛ d
туреччина	t u r ɛ tʃ ɪ n ɛ
судно	s u d n ɔ
гордитися	ɦ ɔ r d ɪ t ɪ sʲ ɛ
монархіє	m ɔ n ɑ r x i j ɪ
сантиметр	s ɛ n t ɪ m ɛ t r
підприємниця	p i d p r ɪ j ɛ m n ɪ t͡sʲ ɛ
фразеологічний	f r ɛ z ɪ ɔ ɫ ɔ ɦ i t͡ʃ n ɪ i
сонячний	s ɔ nʲ ɛ t͡ʃ n ɪ i
другу	d r u ɦ u
мошонка	m ɔ ʃ ɔ n k ɛ
артеріє	ɛ r t ɛ rʲ i j ɪ
джаз	d͡ʒ ɑ z
раптом	r ɑ p t ɔ m
інфекція	i n f ɛ k t͡sʲ i j ɛ
кат	k ɑ t
міжвоєнний	m i ʒ ʋ ɔ j ɛ n ɪ i
зекономити	z ɪ k ɔ n ɔ m ɪ t ɪ
макові	m ɑ k ɔ ʋ i
індивід	i n d ɪ ʋ i d
апатичний	ɛ p ɛ t ɪ t͡ʃ n ɪ i
гомосексуальний	ɦ ɔ m ɔ s ɪ k s u ɑ lʲ n ɪ i
парламент	p ɛ r ɫ ɑ m ɪ n t
дислокація	d ɪ s ɫ ɔ k ɑ t͡sʲ i j ɛ
щонайменше	ʃ t͡ʃ ɔ n ɛ i m ɛ n ʃ ɪ
куток	k u t ɔ k
превентивний	p r ɪ ʋ ɪ n t ɪ u n ɪ i
несподіваний	n ɪ s p ɔ dʲ i ʋ ɛ n ɪ i
матеріальний	m ɛ t ɪ rʲ i ɑ lʲ n ɪ i
трагедіям	t r ɛ ɦ ɛ dʲ i j ɛ m
хворіти	x ʋ ɔ rʲ i t ɪ
кішка	k i ʃ k ɛ
намисто	n ɛ m ɪ s t ɔ
бутерброд	b u t ɪ r b r ɔ d
дорослий	d ɔ r ɔ s ɫ ɪ i
кошуля	k ɔ ʃ u lʲ ɛ
гребля	ɦ r ɛ b lʲ ɛ
продавати	p r ɔ d ɛ ʋ ɑ t ɪ
м'ясо	m j ɑ s ɔ
пінний	p i n ɪ i
петиція	p ɪ t ɪ t͡sʲ i j ɛ
автобальзам	ɛ u t ɔ b ɛ lʲ z ɑ m
полуниця	p ɔ ɫ u n ɪ t͡sʲ ɛ
дисертацію	d ɪ s ɪ r t ɑ t͡sʲ i j u
совок	s ɔ ʋ ɔ k
когось	k ɔ ɦ ɔ sʲ
давньогрецький	d ɛ u nʲ ɔ ɦ r ɛ t͡sʲ k ɪ i
воно	ʋ ɔ n ɔ
абластика	ɛ b ɫ ɑ s t ɪ k ɛ
вовна	ʋ ɔ u n ɛ
авіаучилище	ɛ ʋ i ɛ u t͡ʃ ɪ ɫ ɪ ʃ t͡ʃ ɪ
громадянський	ɦ r ɔ m ɛ dʲ ɑ nʲ sʲ k ɪ i
довг	d ɔ u ɦ
породілля	p ɔ r ɔ dʲ i lʲ ɛ
лялька	lʲ ɑ lʲ k ɛ
бездумний	b ɪ z d u m n ɪ i
метелик	m ɪ t ɛ ɫ ɪ k
обмеження	ɔ b m ɛ ʒ ɪ nʲ ɛ
привабити	p r ɪ ʋ ɑ b ɪ t ɪ
жолудь	ʒ ɔ ɫ u dʲ
таємниця	t ɛ j ɪ m n ɪ t͡sʲ ɛ
плювати	p lʲ u ʋ ɑ t ɪ
тренінг	t r ɛ nʲ i n ɦ
салон	s ɛ ɫ ɔ n
розуміння	r ɔ z u m i nʲ ɛ
підпорядковувати	p i d p ɔ rʲ ɛ d k ɔ ʋ u ʋ ɛ t ɪ
акція	ɑ k t͡sʲ i j ɛ
світанок	sʲ ʋ i t ɑ n ɔ k
неформальний	n ɪ f ɔ r m ɑ lʲ n ɪ i
шістнадцятий	ʃ i s t n ɑ d͡zʲ t͡sʲ ɛ t ɪ i
продавщиця	p r ɔ d ɛ u ʃ t͡ʃ ɪ t͡sʲ ɛ
трок	t r ɔ k
ґанок	ɡ ɑ n ɔ k
порошенко	p ɔ r ɔ ʃ ɛ n k ɔ
вірменія	ʋ i r m ɛ nʲ i j ɛ
пізніший	p i zʲ nʲ i ʃ ɪ i
інтеграція	i n t ɪ ɦ r ɑ t͡sʲ i j ɛ
міжзоряний	m i ʒ z ɔ rʲ ɛ n ɪ i
сталевий	s t ɛ ɫ ɛ ʋ ɪ i
аналітичний	ɛ n ɛ lʲ i t ɪ t͡ʃ n ɪ i
змусити	z m u s ɪ t ɪ
декларацію	d ɪ k ɫ ɛ r ɑ t͡sʲ i j u
ночви	n ɔ t͡ʃ ʋ ɪ
лихоманка	ɫ ɪ x ɔ m ɑ n k ɛ
відлякувати	ʋ i dʲ lʲ ɑ k u ʋ ɛ t ɪ
істотний	i s t ɔ t n ɪ i
матрьошка	m ɛ tʲ rʲ ɔ ʃ k ɛ
дерев'яний	d ɪ r ɪ ʋ j ɑ n ɪ i
фрагменту	f r ɛ ɦ m ɛ n t u
виключати	ʋ ɪ k lʲ u t͡ʃ ɑ t ɪ
інструмент	i n s t r u m ɛ n t
гідрологія	ɦ i d r ɔ ɫ ɔ ɦ i j ɛ
емоцію	ɪ m ɔ t͡sʲ i j u
довіряти	d ɔ ʋ i rʲ ɑ t ɪ
дитсадок	d ɪ t͡s ɛ d ɔ k
безлюддя	b ɪ zʲ lʲ u dʲ ɛ
симпатичний	s ɪ m p ɛ t ɪ t͡ʃ n ɪ i
таїландець	t ɛ j i ɫ ɑ n d ɪ t͡sʲ
повідомлення	p ɔ ʋ i d ɔ m ɫ ɪ nʲ ɛ
довгий	d ɔ u ɦ ɪ i
лев	ɫ ɛ u
британія	b r ɪ t ɑ nʲ i j ɛ
виключний	ʋ ɪ k lʲ u t͡ʃ n ɪ i
битва	b ɪ t ʋ ɛ
репродуктивний	r ɪ p r ɔ d u k t ɪ u n ɪ i
геофізичний	ɦ ɪ ɔ f i z ɪ t͡ʃ n ɪ i
вже	ʋ ʒ ɛ
погрожувати	p ɔ ɦ r ɔ ʒ u ʋ ɛ t ɪ
батальйон	b ɛ t ɛ lʲ j ɔ n
травень	t r ɑ ʋ ɪ nʲ
напружити	n ɛ p r u ʒ ɪ t ɪ
третій	t r ɛ tʲ i i
страшний	s t r ɛ ʃ n ɪ i
панікерство	p ɛ nʲ i k ɛ r s t ʋ ɔ
клієнт	k lʲ i j ɛ n t
екваторіальний	ɪ k ʋ ɛ t ɔ rʲ i ɑ lʲ n ɪ i
теоретичний	t ɪ ɔ r ɪ t ɪ t͡ʃ n ɪ i
передній	p ɪ r ɛ dʲ nʲ i i
стрічки	s tʲ rʲ i t͡ʃ k ɪ
працівниками	p r ɛ t͡sʲ i u n ɪ k ɑ m ɪ
ножовий	n ɔ ʒ ɔ ʋ ɪ i
центавр	t͡s ɪ n t ɑ u r
виконувати	ʋ ɪ k ɔ n u ʋ ɛ t ɪ
візантій	ʋ i z ɑ nʲ tʲ i i
суми	s u m ɪ
книжкова	k n ɪ ʒ k ɔ ʋ ɛ
прогнозів	p r ɔ ɦ n ɔ zʲ i u
замощувати	z ɛ m ɔ ʃ t͡ʃ u ʋ ɛ t ɪ
перукарня	p ɪ r u k ɑ r nʲ ɛ
розмова	r ɔ z m ɔ ʋ ɛ
мегаліт	m ɪ ɦ ɛ lʲ i t
кочерга	k ɔ t͡ʃ ɪ r ɦ ɑ
офіра	ɔ f i r ɛ
реанімація	r ɪ ɛ nʲ i m ɑ t͡sʲ i j ɛ
кредитний	k r ɪ d ɪ t n ɪ i
фотосинтез	f ɔ t ɔ s ɪ n t ɪ z
литва	ɫ ɪ t ʋ ɑ
безпідставний	b ɪ zʲ p i d͡z s t ɑ u n ɪ i
начиння	n ɛ t͡ʃ ɪ nʲ ɛ
слух	s ɫ u x
павутина	p ɛ ʋ u t ɪ n ɛ
недоконаний	n ɪ d ɔ k ɔ n ɛ n ɪ i
канадієць	k ɛ n ɛ dʲ i j ɪ t͡sʲ
авіатика	ɛ ʋ i ɑ t ɪ k ɛ
забудькуватий	z ɛ b u dʲ k u ʋ ɛ t ɪ i
акціонер	ɛ k t͡sʲ i ɔ n ɛ r
південь	p i u d ɪ nʲ
абразія	ɛ b r ɑ zʲ i j ɛ
цвях	t͡sʲ ʋ ɑ x
секунда	s ɪ k u n d ɛ
підготовка	p i d ɦ ɔ t ɔ u k ɛ
авіаль	ɛ ʋ i ɑ lʲ
реконструкція	r ɪ k ɔ n s t r u k t͡sʲ i j ɛ
ідеологічний	i d ɪ ɔ ɫ ɔ ɦ i t͡ʃ n ɪ i
діафрагма	dʲ i ɛ f r ɑ ɦ m ɛ
пердіти	p ɪ r dʲ i t ɪ
хороший	x ɔ r ɔ ʃ ɪ i
привчати	p r ɪ u t͡ʃ ɑ t ɪ
призначення	p r ɪ z n ɑ t͡ʃ ɪ nʲ ɛ
гурченко	ɦ u r t͡ʃ ɪ n k ɔ
молодята	m ɔ ɫ ɔ dʲ ɑ t ɛ
зовнішній	z ɔ u nʲ i ʃ nʲ i i
вільнодумство	ʋ i lʲ n ɔ d u m s t ʋ ɔ
бомба	b ɔ m b ɛ
протест	p r ɔ t ɛ s t
установа	u s t ɛ n ɔ ʋ ɛ
присвійний	p r ɪ sʲ ʋ i i n ɪ i
власті	ʋ ɫ ɑ sʲ tʲ i
двері	d ʋ ɛ rʲ i
радо	r ɑ d ɔ
законослухняний	z ɛ k ɔ n ɔ s ɫ u x nʲ ɑ n ɪ i
пропозиціями	p r ɔ p ɔ z ɪ t͡sʲ i j ɛ m ɪ
персонально	p ɪ r s ɔ n ɑ lʲ n ɔ
телевізійний	t ɪ ɫ ɪ ʋ i zʲ i i n ɪ i
маска	m ɑ s k ɛ
оточити	ɔ t ɔ t͡ʃ ɪ t ɪ
раса	r ɑ s ɛ
підміняти	p i dʲ m i nʲ ɑ t ɪ
пришвидшити	p r ɪ ʃ ʋ ɪ d͡ʒ ʃ ɪ t ɪ
вагітна	ʋ ɛ ɦ i t n ɛ
слівця	sʲ lʲ i u t͡sʲ ɛ
попіл	p ɔ p i ɫ
телеканал	t ɪ ɫ ɪ k ɛ n ɑ ɫ
житній	ʒ ɪ tʲ nʲ i i
обмежень	ɔ b m ɛ ʒ ɪ nʲ
жнець	ʒ n ɛ t͡sʲ
юрисдикція	j u r ɪ z d ɪ k t͡sʲ i j ɛ
захаренко	z ɛ x ɑ r ɪ n k ɔ
електрифікувати	ɪ ɫ ɪ k t r ɪ f i k u ʋ ɑ t ɪ
оточувати	ɔ t ɔ t͡ʃ u ʋ ɛ t ɪ
здатен	z d ɑ t ɪ n
фразеологія	f r ɛ z ɪ ɔ ɫ ɔ ɦ i j ɛ
двоногий	d ʋ ɔ n ɔ ɦ ɪ i
працьовитий	p r ɛ t͡sʲ ɔ ʋ ɪ t ɪ i
негативно	n ɪ ɦ ɛ t ɪ u n ɔ
шкіра	ʃ k i r ɛ
азербайджанський	ɛ z ɪ r b ɛ i d͡ʒ ɑ nʲ sʲ k ɪ i
лихо	ɫ ɪ x ɔ
інфікування	i nʲ f i k u ʋ ɑ nʲ ɛ
кшталт	k ʃ t ɑ ɫ t
постати	p ɔ s t ɑ t ɪ
теорію	t ɪ ɔ rʲ i j u
еротика	ɪ r ɔ t ɪ k ɛ
голота	ɦ ɔ ɫ ɔ t ɛ
федерації	f ɪ d ɪ r ɑ t͡sʲ i j i
проблема	p r ɔ b ɫ ɛ m ɛ
звичайний	z ʋ ɪ t͡ʃ ɑ i n ɪ i
брехню	b r ɪ x nʲ u
граніт	ɦ r ɛ nʲ i t
психіка	p s ɪ x i k ɛ
слов'янам	s ɫ ɔ ʋ j ɑ n ɛ m
коса	k ɔ s ɑ
білок	b i ɫ ɔ k
лист	ɫ ɪ s t
абхаз	ɛ b x ɑ z
штандарт	ʃ t ɛ n d ɑ r t
заяць	z ɑ j ɛ t͡sʲ
бактерія	b ɛ k t ɛ rʲ i j ɛ
бесіда	b ɛ sʲ i d ɛ
хазяїн	x ɛ zʲ ɑ j i n
костянтин	k ɔ sʲ tʲ ɛ n t ɪ n
варіанту	ʋ ɛ rʲ i ɑ n t u
вигук	ʋ ɪ ɦ u k
австралопітек	ɛ u s t r ɛ ɫ ɔ p i t ɛ k
кайман	k ɛ i m ɑ n
рівність	rʲ i u nʲ i sʲ tʲ
ніготь	nʲ i ɦ ɔ tʲ
городянин	ɦ ɔ r ɔ dʲ ɑ n ɪ n
громило	ɦ r ɔ m ɪ ɫ ɔ
звідти	zʲ ʋ i d t ɪ
бронза	b r ɔ n z ɛ
філіжанка	f i lʲ i ʒ ɑ n k ɛ
подовження	p ɔ d ɔ u ʒ ɪ nʲ ɛ
марія	m ɛ rʲ i j ɛ
звикнути	z ʋ ɪ k n u t ɪ
бонусами	b ɔ n u s ɛ m ɪ
процвітаючий	p r ɔ t͡sʲ ʋ i t ɑ j u t͡ʃ ɪ i
конкурс	k ɔ n k u r s
посібник	p ɔ sʲ i b n ɪ k
люди	lʲ u d ɪ
плуг	p ɫ u ɦ
гро	ɦ r ɔ
птиця	p t ɪ t͡sʲ ɛ
безпосередній	b ɪ z p ɔ s ɪ r ɛ dʲ nʲ i i
кота	k ɔ t ɑ
давальний	d ɛ ʋ ɑ lʲ n ɪ i
підлогу	p i d ɫ ɔ ɦ u
могутній	m ɔ ɦ u tʲ nʲ i i
дитсадки	d ɪ t͡s ɛ d k ɪ
авіамаяк	ɛ ʋ i ɛ m ɛ j ɑ k
дивізій	d ɪ ʋ i zʲ i i
слов'янками	s ɫ ɔ ʋ j ɑ n k ɛ m ɪ
хурма	x u r m ɑ
новини	n ɔ ʋ ɪ n ɪ
періодизаціях	p ɪ rʲ i ɔ d ɪ z ɑ t͡sʲ i j ɛ x
різноманітність	rʲ i z n ɔ m ɛ nʲ i tʲ nʲ i sʲ tʲ
безпритульний	b ɪ z p r ɪ t u lʲ n ɪ i
вежа	ʋ ɛ ʒ ɛ
скандинавія	s k ɛ n d ɪ n ɑ ʋ i j ɛ
кишенею	k ɪ ʃ ɛ n ɪ j u
жона	ʒ ɔ n ɑ
працівницям	p r ɛ t͡sʲ i u n ɪ t͡sʲ ɛ m
індустріалізувати	i n d u s tʲ rʲ i ɛ lʲ i z u ʋ ɑ t ɪ
цією	t͡sʲ i j ɛ j u
катастрофи	k ɛ t ɛ s t r ɔ f ɪ
талія	t ɑ lʲ i j ɛ
поселення	p ɔ s ɛ ɫ ɪ nʲ ɛ
в'язниця	ʋ j ɛ z n ɪ t͡sʲ ɛ
федерація	f ɪ d ɪ r ɑ t͡sʲ i j ɛ
монумент	m ɔ n u m ɛ n t
козирок	k ɔ z ɪ r ɔ k
централізувати	t͡s ɪ n t r ɛ lʲ i z u ʋ ɑ t ɪ
асистентка	ɛ s ɪ s t ɛ n t k ɛ
єпископ	j ɪ p ɪ s k ɔ p
дорогий	d ɔ r ɔ ɦ ɪ i
вуглеводень	ʋ u ɦ ɫ ɪ ʋ ɔ d ɪ nʲ
інциденти	i n t͡s ɪ d ɛ n t ɪ
надзвуковий	n ɛ d͡z ʋ u k ɔ ʋ ɪ i
потилице	p ɔ t ɪ ɫ ɪ t͡s ɪ
грязь	ɦ rʲ ɑ zʲ
чехія	t͡ʃ ɛ x i j ɛ
реб	r ɛ b
безіменний	b ɪ zʲ i m ɛ n ɪ i
бацяр	b ɑ t͡sʲ ɛ r
переважний	p ɪ r ɪ ʋ ɑ ʒ n ɪ i
пацюк	p ɛ t͡sʲ u k
абрикос	ɛ b r ɪ k ɔ s
заєць	z ɑ j ɪ t͡sʲ
босоногий	b ɔ s ɔ n ɔ ɦ ɪ i
школа	ʃ k ɔ ɫ ɛ
конвенція	k ɔ n ʋ ɛ nʲ t͡sʲ i j ɛ
курити	k u r ɪ t ɪ
вираз	ʋ ɪ r ɛ z
ящик	j ɑ ʃ t͡ʃ ɪ k
засудити	z ɛ s u d ɪ t ɪ
імпортувати	i m p ɔ r t u ʋ ɑ t ɪ
революціонерка	r ɪ ʋ ɔ lʲ u t͡sʲ i ɔ n ɛ r k ɛ
тисячоліттями	t ɪ sʲ ɛ t͡ʃ ɔ lʲ i tʲ ɛ m ɪ
фіскальний	f i s k ɑ lʲ n ɪ i
абсанс	ɛ b s ɑ n s
автобусик	ɛ u t ɔ b u s ɪ k
утомлений	u t ɔ m ɫ ɪ n ɪ i
ізраїльтянка	i z r ɛ j i lʲ tʲ ɑ n k ɛ
фізіологічний	f i zʲ i ɔ ɫ ɔ ɦ i t͡ʃ n ɪ i
почесть	p ɔ t͡ʃ ɪ sʲ tʲ
багатогодинний	b ɛ ɦ ɛ t ɔ ɦ ɔ d ɪ n ɪ i
повернути	p ɔ ʋ ɪ r n u t ɪ
таємницею	t ɛ j ɪ m n ɪ t͡s ɪ j u
рацію	r ɑ t͡sʲ i j u
п'ятсот	p j ɛ t͡s ɔ t
позичати	p ɔ z ɪ t͡ʃ ɑ t ɪ
молоття	m ɔ ɫ ɔ tʲ ɑ
парадигма	p ɛ r ɛ d ɪ ɦ m ɛ
значний	z n ɛ t͡ʃ n ɪ i
район	r ɛ j ɔ n
заколот	z ɑ k ɔ ɫ ɔ t
взірцевий	ʋ zʲ i r t͡s ɛ ʋ ɪ i
господиню	ɦ ɔ s p ɔ d ɪ nʲ u
мріє	m rʲ i j ɪ
більшати	b i lʲ ʃ ɛ t ɪ
верем'я	ʋ ɪ r ɛ m j ɛ
венеціанський	ʋ ɪ n ɪ t͡sʲ i ɑ nʲ sʲ k ɪ i
кораблебудівник	k ɔ r ɛ b ɫ ɪ b u dʲ i u n ɪ k
увесь	u ʋ ɛ sʲ
тридцять	t r ɪ d͡zʲ t͡sʲ ɛ tʲ
луг	ɫ u ɦ
заїр	z ɛ j i r
колумбія	k ɔ ɫ u m b i j ɛ
масштаб	m ɛ ʃ t ɑ b
дрімати	dʲ rʲ i m ɑ t ɪ
вени	ʋ ɛ n ɪ
інфекціям	i n f ɛ k t͡sʲ i j ɛ m
тієї	tʲ i j ɛ j i
властивий	ʋ ɫ ɛ s t ɪ ʋ ɪ i
золото	z ɔ ɫ ɔ t ɔ
вказівний	ʋ k ɛ zʲ i u n ɪ i
похорони	p ɔ x ɔ r ɔ n ɪ
зайнятися	z ɛ i nʲ ɑ t ɪ sʲ ɛ
феями	f ɛ j ɛ m ɪ
християнський	x r ɪ s t ɪ j ɑ nʲ sʲ k ɪ i
неможливий	n ɪ m ɔ ʒ ɫ ɪ ʋ ɪ i
снідати	sʲ nʲ i d ɛ t ɪ
закінчення	z ɛ k i n t͡ʃ ɪ nʲ ɛ
висловлюватися	ʋ ɪ s ɫ ɔ u lʲ u ʋ ɛ t ɪ sʲ ɛ
втручання	ʋ t r u t͡ʃ ɑ nʲ ɛ
покупка	p ɔ k u p k ɛ
причина	p r ɪ t͡ʃ ɪ n ɛ
плавати	p ɫ ɑ ʋ ɛ t ɪ
бюрократка	b u r ɔ k r ɑ t k ɛ
інтенсифікація	i n t ɪ n s ɪ f i k ɑ t͡sʲ i j ɛ
припущень	p r ɪ p u ʃ t͡ʃ ɪ nʲ
їбати	j i b ɑ t ɪ
сідниця	sʲ i d n ɪ t͡sʲ ɛ
трансформаціям	t r ɛ n s f ɔ r m ɑ t͡sʲ i j ɛ m
білоруський	b i ɫ ɔ r u sʲ k ɪ i
невидимий	n ɪ ʋ ɪ d ɪ m ɪ i
доброзичливиця	d ɔ b r ɔ z ɪ t͡ʃ ɫ ɪ ʋ ɪ t͡sʲ ɛ
смак	s m ɑ k
наприкінці	n ɛ p r ɪ k i nʲ t͡sʲ i
автобіограф	ɛ u t ɔ b i ɔ ɦ r ɛ f
містичний	m i s t ɪ t͡ʃ n ɪ i
ананас	ɛ n ɛ n ɑ s
крихта	k r ɪ x t ɛ
припинення	p r ɪ p ɪ n ɪ nʲ ɛ
автоводоцистерна	ɛ u t ɔ ʋ ɔ d ɔ t͡s ɪ s t ɛ r n ɛ
небога	n ɪ b ɔ ɦ ɛ
падати	p ɑ d ɛ t ɪ
левиця	ɫ ɪ ʋ ɪ t͡sʲ ɛ
узяти	u zʲ ɑ t ɪ
лексикографія	ɫ ɪ k s ɪ k ɔ ɦ r ɑ f i j ɛ
оборонити	ɔ b ɔ r ɔ n ɪ t ɪ
горизонтами	ɦ ɔ r ɪ z ɔ n t ɛ m ɪ
року	r ɔ k u
заохотити	z ɛ ɔ x ɔ t ɪ t ɪ
конфета	k ɔ n f ɛ t ɛ
логістичний	ɫ ɔ ɦ i s t ɪ t͡ʃ n ɪ i
серце	s ɛ r t͡s ɪ
вирішення	ʋ ɪ rʲ i ʃ ɪ nʲ ɛ
театр	t ɪ ɑ t r
тротуарів	t r ɔ t u ɑ rʲ i u
кубічний	k u b i t͡ʃ n ɪ i
адреса	ɛ d r ɛ s ɛ
додатках	d ɔ d ɑ t k ɛ x
музикантка	m u z ɪ k ɑ n t k ɛ
полум'я	p ɔ ɫ u m j ɛ
заспокоювати	z ɛ s p ɔ k ɔ j u ʋ ɛ t ɪ
петиціях	p ɪ t ɪ t͡sʲ i j ɛ x
омбудсмен	ɔ m b u d͡z s m ɛ n
америка	ɛ m ɛ r ɪ k ɛ
банк	b ɑ n k
випити	ʋ ɪ p ɪ t ɪ
ними	n ɪ m ɪ
виконання	ʋ ɪ k ɔ n ɑ nʲ ɛ
уряд	u rʲ ɛ d
починати	p ɔ t͡ʃ ɪ n ɑ t ɪ
світ	sʲ ʋ i t
зазначити	z ɛ z n ɛ t͡ʃ ɪ t ɪ
виноградник	ʋ ɪ n ɔ ɦ r ɑ d n ɪ k
менший	m ɛ n ʃ ɪ i
добросусідський	d ɔ b r ɔ s u sʲ i d͡zʲ sʲ k ɪ i
обґрунтувати	ɔ b ɡ r u n t u ʋ ɑ t ɪ
слова	s ɫ ɔ ʋ ɛ
відкладати	ʋ i d k ɫ ɛ d ɑ t ɪ
абстракція	ɛ b s t r ɑ k t͡sʲ i j ɛ
продукція	p r ɔ d u k t͡sʲ i j ɛ
транспортний	t r ɑ n s p ɔ r t n ɪ i
чотирикутний	t͡ʃ ɔ t ɪ r ɪ k u t n ɪ i
естонія	ɪ s t ɔ nʲ i j ɛ
поляк	p ɔ lʲ ɑ k
валець	ʋ ɛ ɫ ɛ t͡sʲ
авіапорт	ɛ ʋ i ɛ p ɔ r t
п'ятдесят	p j ɛ d d ɪ sʲ ɑ t
багатолітній	b ɛ ɦ ɛ t ɔ lʲ i tʲ nʲ i i
біль	b i lʲ
гуманістичний	ɦ u m ɛ nʲ i s t ɪ t͡ʃ n ɪ i
батьківщина	b ɛ tʲ k i u ʃ t͡ʃ ɪ n ɛ
противник	p r ɔ t ɪ u n ɪ k
дівча	dʲ i u t͡ʃ ɑ
літера	lʲ i t ɪ r ɛ
меншина	m ɪ n ʃ ɪ n ɛ
пропорціях	p r ɔ p ɔ r t͡sʲ i j ɛ x
повечеряти	p ɔ ʋ ɪ t͡ʃ ɛ rʲ ɛ t ɪ
відродити	ʋ i d r ɔ d ɪ t ɪ
невідворотний	n ɪ ʋ i d ʋ ɔ r ɔ t n ɪ i
співзасновник	sʲ p i u z ɛ s n ɔ u n ɪ k
крейда	k r ɛ i d ɛ
інна	i n ɛ
мертвий	m ɛ r t ʋ ɪ i
органів	ɔ r ɦ ɛ nʲ i u
система	s ɪ s t ɛ m ɛ
знак	z n ɑ k
чемпіонський	t͡ʃ ɪ m p i ɔ nʲ sʲ k ɪ i
час	t͡ʃ ɑ s
товариство	t ɔ ʋ ɛ r ɪ s t ʋ ɔ
геометричний	ɦ ɪ ɔ m ɪ t r ɪ t͡ʃ n ɪ i
довгочасний	d ɔ u ɦ ɔ t͡ʃ ɑ s n ɪ i
директор	d ɪ r ɛ k t ɔ r
спір	sʲ p i r
забагти	z ɛ b ɑ ɦ t ɪ
пролетар	p r ɔ ɫ ɪ t ɑ r
гомосексуалізм	ɦ ɔ m ɔ s ɪ k s u ɛ lʲ i z m
троє	t r ɔ j ɪ
поселити	p ɔ s ɪ ɫ ɪ t ɪ
інституційний	i n s t ɪ t u t͡sʲ i i n ɪ i
вмерти	ʋ m ɛ r t ɪ
бруднитися	b r u d n ɪ t ɪ sʲ ɛ
альбатрос	ɛ lʲ b ɛ t r ɔ s
централізація	t͡s ɪ n t r ɛ lʲ i z ɑ t͡sʲ i j ɛ
ратифікація	r ɛ t ɪ f i k ɑ t͡sʲ i j ɛ
дейтон	d ɛ i t ɔ n
багатогранний	b ɛ ɦ ɛ t ɔ ɦ r ɑ n ɪ i
тож	t ɔ ʒ
стабілізувати	s t ɛ b i lʲ i z u ʋ ɑ t ɪ
перекладачки	p ɪ r ɪ k ɫ ɛ d ɑ t͡ʃ k ɪ
авіадвигун	ɛ ʋ i ɛ d ʋ ɪ ɦ u n
співпереживання	sʲ p i u p ɪ r ɪ ʒ ɪ ʋ ɑ nʲ ɛ
займенник	z ɛ i m ɛ n ɪ k
діагностика	dʲ i ɛ ɦ n ɔ s t ɪ k ɛ
відвернути	ʋ i d ʋ ɪ r n u t ɪ
кубинець	k u b ɪ n ɪ t͡sʲ
вимкнути	ʋ ɪ m k n u t ɪ
епічний	ɪ p i t͡ʃ n ɪ i
своєрідний	s ʋ ɔ j ɪ rʲ i d n ɪ i
пропорціям	p r ɔ p ɔ r t͡sʲ i j ɛ m
друзями	d r u zʲ ɛ m ɪ
ватру	ʋ ɑ t r u
пошта	p ɔ ʃ t ɛ
янтар	j ɛ n t ɑ r
станіслав	s t ɛ nʲ i s ɫ ɑ u
поняття	p ɔ nʲ ɑ tʲ ɛ
зовнішня	z ɔ u nʲ i ʃ nʲ ɛ
суднобудівна	s u d n ɔ b u dʲ i u n ɑ
розвідати	r ɔ zʲ ʋ i d ɛ t ɪ
град	ɦ r ɑ d
одержувачів	ɔ d ɛ r ʒ u ʋ ɛ t͡ʃʲ i u
клоччя	k ɫ ɔ t͡ʃʲː ɛ
знайти	z n ɛ i t ɪ
меланія	m ɪ ɫ ɑ nʲ i j ɛ
апатія	ɛ p ɑ tʲ i j ɛ
багато	b ɛ ɦ ɑ t ɔ
цитрина	t͡s ɪ t r ɪ n ɛ
працівником	p r ɛ t͡sʲ i u n ɪ k ɔ m
розпізнавання	r ɔ zʲ p i z n ɛ ʋ ɑ nʲ ɛ
купування	k u p u ʋ ɑ nʲ ɛ
свекруха	s ʋ ɪ k r u x ɛ
споживача	s p ɔ ʒ ɪ ʋ ɛ t͡ʃ ɑ
рік	rʲ i k
диспетчер	d ɪ s p ɛ tʃ ɪ r
осло	ɔ s ɫ ɔ
тисячоліттях	t ɪ sʲ ɛ t͡ʃ ɔ lʲ i tʲ ɛ x
моє	m ɔ j ɛ
батько	b ɑ tʲ k ɔ
хворий	x ʋ ɔ r ɪ i
стандартові	s t ɛ n d ɑ r t ɔ ʋ i
аболіціонізм	ɛ b ɔ lʲ i t͡sʲ i ɔ nʲ i z m
темний	t ɛ m n ɪ i
неправді	n ɪ p r ɑ u dʲ i
сказати	s k ɛ z ɑ t ɪ
витратити	ʋ ɪ t r ɛ t ɪ t ɪ
обміркувати	ɔ b m i r k u ʋ ɑ t ɪ
тарган	t ɛ r ɦ ɑ n
інструкцією	i n s t r u k t͡sʲ i j ɪ j u
зір	zʲ i r
автореференція	ɑ u t ɔ r ɪ f ɪ r ɛ nʲ t͡sʲ i j ɛ
гладіаторський	ɦ ɫ ɛ dʲ i ɑ t ɔ r sʲ k ɪ i
діаграма	dʲ i ɛ ɦ r ɑ m ɛ
дзеркало	d͡z ɛ r k ɛ ɫ ɔ
тактовний	t ɛ k t ɔ u n ɪ i
мур	m u r
оприлюднювати	ɔ p r ɪ lʲ u dʲ nʲ u ʋ ɛ t ɪ
молодий	m ɔ ɫ ɔ d ɪ i
потрібний	p ɔ tʲ rʲ i b n ɪ i
наука	n ɛ u k ɛ
візуальний	ʋ i z u ɑ lʲ n ɪ i
перукар	p ɪ r u k ɑ r
фашизм	f ɛ ʃ ɪ z m
зоопарк	z ɔ ɔ p ɑ r k
авіапарк	ɛ ʋ i ɛ p ɑ r k
плюш	p lʲ u ʃ
евакуація	ɪ ʋ ɛ k u ɑ t͡sʲ i j ɛ
нормальний	n ɔ r m ɑ lʲ n ɪ i
того	t ɔ ɦ ɔ
бавитися	b ɑ ʋ ɪ t ɪ sʲ ɛ
п'ятниця	p j ɑ t n ɪ t͡sʲ ɛ
добробут	d ɔ b r ɔ b u t
олово	ɔ ɫ ɔ ʋ ɔ
корисність	k ɔ r ɪ sʲ nʲ i sʲ tʲ
образливий	ɔ b r ɑ z ɫ ɪ ʋ ɪ i
делегаціях	d ɪ ɫ ɪ ɦ ɑ t͡sʲ i j ɛ x
недостатність	n ɪ d ɔ s t ɑ tʲ nʲ i sʲ tʲ
письменний	p ɪ sʲ m ɛ n ɪ i
покій	p ɔ k i i
літературний	lʲ i t ɪ r ɛ t u r n ɪ i
коментар	k ɔ m ɪ n t ɑ r
українських	u k r ɛ j i nʲ sʲ k ɪ x
копито	k ɔ p ɪ t ɔ
горизонтові	ɦ ɔ r ɪ z ɔ n t ɔ ʋ i
імпорт	i m p ɔ r t
хліб	x lʲ i b
залежний	z ɛ ɫ ɛ ʒ n ɪ i
мовознавство	m ɔ ʋ ɔ z n ɑ u s t ʋ ɔ
участь	u t͡ʃ ɛ sʲ tʲ
сауна	s ɑ u n ɛ
місяць	m i sʲ ɛ t͡sʲ
фольклор	f ɔ lʲ k ɫ ɔ r
успішний	u sʲ p i ʃ n ɪ i
правоохоронні	p r ɛ ʋ ɔ ɔ x ɔ r ɔ nʲ i
засмутити	z ɛ s m u t ɪ t ɪ
тацею	t ɑ t͡s ɪ j u
двосторонній	d ʋ ɔ s t ɔ r ɔ nʲ i i
все	ʋ s ɛ
самоповага	s ɛ m ɔ p ɔ ʋ ɑ ɦ ɛ
критерієм	k r ɪ t ɛ rʲ i j ɪ m
соловейко	s ɔ ɫ ɔ ʋ ɛ i k ɔ
молодиці	m ɔ ɫ ɔ d ɪ t͡sʲ i
збагатити	z b ɛ ɦ ɛ t ɪ t ɪ
арфістка	ɛ r f i s t k ɛ
передумувати	p ɪ r ɪ d u m u ʋ ɛ t ɪ
авіавиставка	ɛ ʋ i ɛ ʋ ɪ s t ɛ u k ɛ
субтитри	s u b t ɪ t r ɪ
зоря	z ɔ rʲ ɑ
лучник	ɫ u t͡ʃ n ɪ k
перевантаженість	p ɪ r ɪ ʋ ɛ n t ɑ ʒ ɪ nʲ i sʲ tʲ
картка	k ɑ r t k ɛ
суднобудівник	s u d n ɔ b u dʲ i u n ɪ k
східноєвропейський	sʲ x i d n ɔ j ɪ u r ɔ p ɛ i sʲ k ɪ i
русинка	r u s ɪ n k ɛ
меморіальний	m ɪ m ɔ rʲ i ɑ lʲ n ɪ i
монохромний	m ɔ n ɔ x r ɔ m n ɪ i
маленький	m ɛ ɫ ɛ nʲ k ɪ i
тунелю	t u n ɛ lʲ u
маргіналізація	m ɛ r ɦ i n ɛ lʲ i z ɑ t͡sʲ i j ɛ
економічний	ɪ k ɔ n ɔ m i t͡ʃ n ɪ i
підкреслювати	p i d k r ɛ sʲ lʲ u ʋ ɛ t ɪ
був	b u u
описовий	ɔ p ɪ s ɔ ʋ ɪ i
тільки	tʲ i lʲ k ɪ
почарківець	p ɔ t͡ʃ ɛ r k i ʋ ɪ t͡sʲ
обов'язково	ɔ b ɔ ʋ j ɛ z k ɔ ʋ ɔ
мамо	m ɑ m ɔ
норвежка	n ɔ r ʋ ɛ ʒ k ɛ
індивідуально	i n d ɪ ʋ i d u ɑ lʲ n ɔ
шабля	ʃ ɑ b lʲ ɛ
возити	ʋ ɔ z ɪ t ɪ
мірою	m i r ɔ j u
зменшень	z m ɛ n ʃ ɪ nʲ
угорка	u ɦ ɔ r k ɛ
тріска	tʲ rʲ i s k ɛ
скорочувати	s k ɔ r ɔ t͡ʃ u ʋ ɛ t ɪ
креативний	k r ɪ ɛ t ɪ u n ɪ i
рішити	rʲ i ʃ ɪ t ɪ
індонезія	i n d ɔ n ɛ zʲ i j ɛ
викрутка	ʋ ɪ k r u t k ɛ
вельможа	ʋ ɪ lʲ m ɔ ʒ ɛ
інтуїтивно	i n t u j i t ɪ u n ɔ
хлопчик	x ɫ ɔ p t͡ʃ ɪ k
коліно	k ɔ lʲ i n ɔ
компенсація	k ɔ m p ɪ n s ɑ t͡sʲ i j ɛ
сестриця	s ɪ s t r ɪ t͡sʲ ɛ
регіональний	r ɪ ɦ i ɔ n ɑ lʲ n ɪ i
запобігання	z ɛ p ɔ b i ɦ ɑ nʲ ɛ
решето	r ɛ ʃ ɪ t ɔ
військовий	ʋ i i sʲ k ɔ ʋ ɪ i
плутократією	p ɫ u t ɔ k r ɑ tʲ i j ɪ j u
андоррський	ɛ n d ɔ r sʲ k ɪ i
жорстокий	ʒ ɔ r s t ɔ k ɪ i
дур	d u r
стоматологія	s t ɔ m ɛ t ɔ ɫ ɔ ɦ i j ɛ
ловелас	ɫ ɔ ʋ ɪ ɫ ɑ s
амфібія	ɛ m f i b i j ɛ
експедиціям	ɪ k s p ɪ d ɪ t͡sʲ i j ɛ m
вичерпувати	ʋ ɪ t͡ʃ ɛ r p u ʋ ɛ t ɪ
минулий	m ɪ n u ɫ ɪ i
щорічний	ʃ t͡ʃ ɔ rʲ i t͡ʃ n ɪ i
транзит	t r ɛ n z ɪ t
фрустрація	f r u s t r ɑ t͡sʲ i j ɛ
кучма	k u t͡ʃ m ɛ
рот	r ɔ t
архієпископ	ɛ r x i j ɪ p ɪ s k ɔ p
виявитися	ʋ ɪ j ɛ ʋ ɪ t ɪ sʲ ɛ
пропаганда	p r ɔ p ɛ ɦ ɑ n d ɛ
обід	ɔ b i d
спростити	s p r ɔ s t ɪ t ɪ
століттю	s t ɔ lʲ i tʲ u
шкодити	ʃ k ɔ d ɪ t ɪ
криголам	k r ɪ ɦ ɔ ɫ ɑ m
засновниця	z ɛ s n ɔ u n ɪ t͡sʲ ɛ
йти	i t ɪ
приготувати	p r ɪ ɦ ɔ t u ʋ ɑ t ɪ
референдумами	r ɪ f ɪ r ɛ n d u m ɛ m ɪ
умисний	u m ɪ s n ɪ i
інженерія	i n ʒ ɪ n ɛ rʲ i j ɛ
підмінювати	p i dʲ m i nʲ u ʋ ɛ t ɪ
нагадувати	n ɛ ɦ ɑ d u ʋ ɛ t ɪ
мокнути	m ɔ k n u t ɪ
дядьо	dʲ ɑ dʲ ɔ
ростити	r ɔ s t ɪ t ɪ
критерієві	k r ɪ t ɛ rʲ i j ɪ ʋ i
зрости	z r ɔ s t ɪ
білолиций	b i ɫ ɔ ɫ ɪ t͡s ɪ i
вчити	ʋ t͡ʃ ɪ t ɪ
купальний	k u p ɑ lʲ n ɪ i
куди	k u d ɪ
ґудзик	ɡ u d͡z ɪ k
суддя	s u dʲ ɑ
волонтер	ʋ ɔ ɫ ɔ n t ɛ r
маківка	m ɑ k i u k ɛ
фрагментах	f r ɛ ɦ m ɛ n t ɛ x
жарт	ʒ ɑ r t
внука	ʋ n u k ɛ
рахунок	r ɛ x u n ɔ k
ластівка	ɫ ɑ sʲ tʲ i u k ɛ
захист	z ɑ x ɪ s t
експедицію	ɪ k s p ɪ d ɪ t͡sʲ i j u
гендер	ɦ ɛ n d ɪ r
мороз	m ɔ r ɔ z
частинка	t͡ʃ ɛ s t ɪ n k ɛ
корупція	k ɔ r u p t͡sʲ i j ɛ
відродження	ʋ i d r ɔ d͡ʒ ɪ nʲ ɛ
посталий	p ɔ s t ɑ ɫ ɪ i
його	j ɔ ɦ ɔ
кривавий	k r ɪ ʋ ɑ ʋ ɪ i
соха	s ɔ x ɑ
місцевий	m i s t͡s ɛ ʋ ɪ i
доза	d ɔ z ɛ
абсорбер	ɛ b s ɔ r b ɪ r
тонкий	t ɔ n k ɪ i
нескладовий	n ɪ s k ɫ ɛ d ɔ ʋ ɪ i
автодидакт	ɛ u t ɔ d ɪ d ɑ k t
їжакевич	j i ʒ ɛ k ɛ ʋ ɪ t͡ʃ
мем	m ɛ m
