трахнусь	t r a x n u sʲ
явственно	j a f s t vʲ i n a
разбродом	r a z b r o d a m
гомер	ɡ a mʲ e r
параллелен	p a r a lʲ e lʲ i n
виолончелях	vʲ i a ɫ a nʲ t͡ɕ e lʲ a x
сплетавший	s p lʲ i t a f ʂ i j
вламывалось	v ɫ a m i v a ɫ a sʲ
нёсши	nʲ o ʂ i
сканировало	s k a nʲ i r a v a ɫ a
усыновляйте	u s i n a v lʲ a j tʲ e
поросла	p a r a s ɫ a
рентабельность	rʲ i n t a bʲ i lʲ n a sʲ tʲ
льда	lʲ d a
прозвучишь	p r a z v u t͡ɕ i ʂ
наморщите	n a m o r ɕː i tʲ e
пристёгивай	p rʲ i sʲ tʲ o ɡʲ i v a j
маузеры	m a u z i r i
расхлёбываем	r a s x lʲ o b i v a j i m
вставило	f s t a vʲ i ɫ a
сатирах	s a tʲ i r a x
додумаешься	d a d u m a j i ʂ sʲ a
ремиксов	rʲ i mʲ i k s a f
залепляю	z a lʲ i p lʲ a j u
рассекретьте	r a sʲ i k rʲ e tʲː e
абсорбированиями	a p s a r bʲ i r a v a nʲ i j a mʲ i
котдивуарцев	k o dʲ i v u a r t͡s i f
вертунах	vʲ i r t u n a x
попыталось	p a p i t a ɫ a sʲ
закипятив	z a kʲ i pʲ i tʲ i f
синтетику	sʲ i n t e tʲ i k u
маточный	m a t a t͡ɕ n i j
плавкою	p ɫ a f k a j u
колыхав	k a ɫ i x a f
выразивший	v i r a zʲ i f ʂ i j
зашумит	z a ʂ u mʲ i t
пустякам	p u sʲ tʲ i k a m
мужененавистничествам	m u ʐ i nʲ i n a vʲ i sʲ nʲ i t͡ɕ i s t v a m
золотистым	z a ɫ a tʲ i s t i m
возглавляемый	v a z ɡ ɫ a v lʲ a j i m i j
катерочках	k a tʲ i r o t͡ɕ k a x
воевод	v a j i v o t
смеялось	s mʲ i j a ɫ a sʲ
замыслу	z a m i s ɫ u
слизняку	s ⁽ʲ ⁾ lʲ i zʲ nʲ i k u
семиугольника	sʲ i mʲ i u ɡ o lʲ nʲ i k a
защищаетесь	z a ɕː i ɕː a j i tʲ i sʲ
присягнувши	p rʲ i sʲ i ɡ n u f ʂ i
поносят	p a n o sʲ a t
необязательно	nʲ i a bʲ i z a tʲ i lʲ n a
растворителя	r a s t v a rʲ i tʲ i lʲ a
понудь	p a n u tʲ
истязанием	i sʲ tʲ i z a nʲ i j i m
изучитесь	i z u t͡ɕ i tʲ i sʲ
испуги	i s p u ɡʲ i
помойкою	p a m o j k a j u
облицевали	a b lʲ i t͡s i v a lʲ i
англицизациею	a n ɡ lʲ i t͡s i z a t͡s i j i j u
прыщавый	p r i ɕː a v i j
гектоваттов	ɡʲ i k t a v a t a f
усопла	u s o p ɫ a
затаптывавши	z a t a p t i v a f ʂ i
верны	vʲ e r n i
созналось	s a z n a ɫ a sʲ
красно	k r a s n a
пойл	p o j ɫ
полетать	p a lʲ i t a tʲ
рассказало	r a s k a z a ɫ a
укутывающий	u k u t i v a j u ɕː i j
ознакомляемся	a z n a k a m lʲ a j i m sʲ a
надоедал	n a d a j i d a ɫ
муруй	m u r u j
суммируешь	s u mʲ i r u j i ʂ
таскавшись	t a s k a f ʂ i sʲ
секта	sʲ e k t a
сынок	s i n o k
воздевший	v a zʲ dʲ e f ʂ i j
шагни	ʂ a ɡ nʲ i
заклейте	z a k lʲ e j tʲ e
посмеяться	p a s mʲ i j a t͡s a
старухой	s t a r u x a j
амилазой	a mʲ i ɫ a z a j
посодействовать	p a s a dʲ e j s t v a v a tʲ
опьянивший	a p ⁽ʲ ⁾ j i nʲ i f ʂ i j
понадеются	p a n a dʲ e j u t͡s a
утята	u tʲ a t a
списаний	s pʲ i s a nʲ i j
удалённостями	u d a lʲ o n a sʲ tʲ a mʲ i
трудясь	t r u dʲ a sʲ
заговаривайтесь	z a ɡ a v a rʲ i v a j tʲ i sʲ
ужесточения	u ʐ i s t a t͡ɕ e nʲ i j a
музыкою	m u z i k a j u
запирало	z a pʲ i r a ɫ a
расправах	r a s p r a v a x
совещаешься	s a vʲ i ɕː a j i ʂ sʲ a
годы	ɡ o d i
дизентериею	dʲ i zʲ i nʲ tʲ i rʲ i j i j u
проигрывал	p r a i ɡ r i v a ɫ
общагою	a p ɕː a ɡ a j u
летный	lʲ e t n i j
дубу	d u b u
патриарший	p a t rʲ i a r ʂ i j
загадит	z a ɡ a dʲ i t
пропитайтесь	p r a pʲ i t a j tʲ i sʲ
рдев	r dʲ e f
культурностей	k u lʲ t u r n a sʲ tʲ i j
разомлеваешь	r a z a m lʲ i v a j i ʂ
граничила	ɡ r a nʲ i t͡ɕ i ɫ a
акмеизма	a k mʲ i i z m a
померещишься	p a mʲ i rʲ e ɕː i ʂ sʲ a
знаменованный	z n a mʲ i n o v a n i j
отсчётах	a t͡ɕ ɕː o t a x
осклабила	a s k ɫ a bʲ i ɫ a
многословием	m n a ɡ a s ɫ o vʲ i j i m
отопрём	a t a p rʲ o m
ослабнет	a s ɫ a b nʲ i t
десницу	dʲ i sʲ nʲ i t͡s u
повторяющийся	p a f t a rʲ a j u ɕː i j sʲ a
обуевала	a b u j i v a ɫ a
сочувствовала	s a t͡ɕ u s t v a v a ɫ a
обручайте	a b r u t͡ɕ a j tʲ e
взведите	v z vʲ i dʲ i tʲ e
прилетаю	p rʲ i lʲ i t a j u
певчих	pʲ e f t͡ɕ i x
вертлуг	vʲ i r t ɫ u k
похоронят	p a x a r o nʲ a t
заевши	z a j e f ʂ i
приземлилась	p rʲ i zʲ i m lʲ i ɫ a sʲ
навевавший	n a vʲ i v a f ʂ i j
основе	a s n o vʲ e
полиграфиях	p a lʲ i ɡ r a fʲ i j a x
нанимает	n a nʲ i m a j i t
моделировали	m a d i lʲ i r a v a lʲ i
наследстве	n a s ⁽ʲ ⁾ lʲ e t͡s t vʲ e
харь	x a rʲ
хмурю	x m u rʲ u
развеивавши	r a z vʲ e i v a f ʂ i
западаешь	z a p a d a j i ʂ
дозрею	d a z rʲ e j u
спорткомплексах	s p o r t k o m p lʲ i k s a x
сотри	s a t rʲ i
инфраструктурами	i n f r a s t r u k t u r a mʲ i
натовский	n a t a f s kʲ i j
расхаживав	r a s x a ʐ i v a f
щитам	ɕː i t a m
стилисту	sʲ tʲ i lʲ i s t u
взыскиваете	v z i s kʲ i v a j i tʲ e
механизации	mʲ i x a nʲ i z a t͡s i i
проститутки	p r a sʲ tʲ i t u t kʲ i
попками	p o p k a mʲ i
изъянами	i z j a n a mʲ i
выпрямлявший	v i p rʲ i m lʲ a f ʂ i j
вдохнули	v d a x n u lʲ i
клюсям	k lʲ u sʲ a m
воспетый	v a s pʲ e t i j
разглядите	r a z ɡ lʲ i dʲ i tʲ e
метафизику	mʲ i t a fʲ i zʲ i k u
видеозапись	vʲ i dʲ i o z a pʲ i sʲ
веселеешь	vʲ i sʲ i lʲ e j i ʂ
мыслятся	m i s ⁽ʲ ⁾ lʲ a t͡s a
технократию	tʲ i x n a k r a tʲ i j u
пригородом	p rʲ i ɡ a r a d a m
пионеров	pʲ i a nʲ e r a f
поручительством	p a r u t͡ɕ i tʲ i lʲ s t v a m
гостьях	ɡ o sʲ tʲ j a x
кьят	kʲ j a t
вонзаешь	v a n z a j i ʂ
бестолочь	bʲ e s t a ɫ a t͡ɕ
обхватов	a p x v a t a f
подтягиваюсь	p a tʲː a ɡʲ i v a j u sʲ
присчитывай	p rʲ i ɕː i t i v a j
флейтами	f lʲ e j t a mʲ i
оттаяло	a t a j i ɫ a
рутиною	r u tʲ i n a j u
ски	s kʲ i
разворачиваю	r a z v a r a t͡ɕ i v a j u
монотонность	m a n a t o n a sʲ tʲ
флексией	f lʲ e k sʲ i j i j
толстячку	t a ɫ s ⁽ʲ ⁾ tʲ i t͡ɕ k u
опушалась	a p u ʂ a ɫ a sʲ
чулок	t͡ɕ u ɫ o k
потасовками	p a t a s o f k a mʲ i
поклонничество	p a k ɫ o nʲ i t͡ɕ i s t v a
добавляться	d a b a v lʲ a t͡s a
объезжав	a b j i ʐ a f
обгрызаем	a b ɡ r i z a j i m
равнодушию	r a v n a d u ʂ i j u
ку	k u
буксы	b u k s i
обакш	a b a k ʂ
аблаутов	a b ɫ a u t a f
абсолютизированиях	a p s a lʲ u tʲ i zʲ i r a v a nʲ i j a x
заседатели	z a sʲ i d a tʲ i lʲ i
отекаю	a tʲ i k a j u
выхаживаем	v i x a ʐ i v a j i m
почуете	p a t͡ɕ u j i tʲ e
оцепляете	a t͡s i pʲ a j i tʲ e
хрестоматий	x rʲ i s t a m a tʲ i j
стипендий	sʲ tʲ i pʲ e nʲ dʲ i j
сироты	sʲ i r o t i
однообразиям	a d n a a b r a zʲ i j a m
кромкой	k r o m k a j
всматриваешься	f s m a t rʲ i v a j i ʂ sʲ a
устраним	u s t r a nʲ i m
минчанками	mʲ i nʲ t͡ɕ a n k a mʲ i
агорафобиею	a ɡ a r a f o bʲ i j i j u
мачизмов	m a t͡ɕ i z m a f
вляпался	v lʲ a p a ɫ s ⁽ʲ ⁾ a
сенокосец	sʲ i n a k o sʲ i t͡s
подослало	p a d a s ɫ a ɫ a
накачавший	n a k a t͡ɕ a f ʂ i j
троичный	t r o i t͡ɕ n i j
мочевина	m a t͡ɕ i vʲ i n a
уверовать	u vʲ e r a v a tʲ
тонею	t o nʲ i j u
дождичкам	d o ʐ dʲ i t͡ɕ k a m
тускневши	t u s k nʲ e f ʂ i
прокалываешь	p r a k a ɫ i v a j i ʂ
сконфузят	s k a n f u zʲ a t
заставав	z a s t a v a f
извиняли	i z vʲ i nʲ a lʲ i
втаскивали	f t a s kʲ i v a lʲ i
простроилось	p r a s t r o i ɫ a sʲ
исключился	i s k lʲ u t͡ɕ i ɫ s ⁽ʲ ⁾ a
намок	n a m o k
дорыла	d a r i ɫ a
пофигизмами	p a fʲ i ɡʲ i z m a mʲ i
врезаешься	v rʲ i z a j i ʂ sʲ a
мурзиками	m u r zʲ i k a mʲ i
реквизициями	rʲ i k vʲ i zʲ i t͡s i j a mʲ i
кольчугами	k a lʲ t͡ɕ u ɡ a mʲ i
сжимав	ʐ i m a f
шоссейник	ʂ a s e j nʲ i k
бривший	b rʲ i f ʂ i j
администрациях	a d mʲ i nʲ i s t r a t͡s i j a x
мале	m a lʲ e
стерпеть	sʲ tʲ i r pʲ e tʲ
оттащила	a t a ɕː i ɫ a
сроднивший	s r a dʲ nʲ i f ʂ i j
выплативший	v i p ɫ a tʲ i f ʂ i j
забрызжите	z a b r i ʐ i tʲ e
откатившись	a t k a tʲ i f ʂ i sʲ
разгибаться	r a z ɡʲ i b a t͡s a
отыгрывалось	a t i ɡ r i v a ɫ a sʲ
щепок	ɕː e p a k
вальцу	v a lʲ t͡s u
шахназаров	ʂ a x n a z a r a f
прояснениями	p r a j i sʲ nʲ e nʲ i j a mʲ i
недолюбливайте	nʲ i d a lʲ u b lʲ i v a j tʲ e
напоролся	n a p a r o ɫ s ⁽ʲ ⁾ a
множится	m n o ʐ i t͡s a
нарды	n a r d i
истеки	i sʲ tʲ i kʲ i
местничество	mʲ e sʲ nʲ i t͡ɕ i s t v a
сквозняке	s k v a zʲ nʲ i kʲ e
правоохранительный	p r a v a a x r a nʲ i tʲ i lʲ n i j
прочувствовало	p r a t͡ɕ u s t v a v a ɫ a
пастеризациею	p a s t i rʲ i z a t͡s i j i j u
выскабливая	v i s k a b lʲ i v a j a
надрывало	n a d r i v a ɫ a
опекунами	a pʲ i k u n a mʲ i
извиняй	i z vʲ i nʲ a j
виноградинами	vʲ i n a ɡ r a dʲ i n a mʲ i
аудите	a u dʲ i tʲ e
дальнобойщиках	d a lʲ n a b o j ɕː i k a x
обвил	a b vʲ i ɫ
шепнув	ʂ i p n u f
крупинкой	k r u pʲ i n k a j
скалишь	s k a lʲ i ʂ
горкой	ɡ o r k a j
постукивающий	p a s t u kʲ i v a j u ɕː i j
хлопоты	x ɫ o p a t i
соус	s o u s
флексийный	f lʲ i k sʲ i j n i j
святою	s vʲ i t o j u
берестов	bʲ e rʲ i s t a f
изодрали	i z a d r a lʲ i
костры	k a s t r i
убирайте	u bʲ i r a j tʲ e
бодрства	b o d r s t v a
ухожено	u x o ʐ i n a
свалками	s v a ɫ k a mʲ i
кастаньеты	k a s t a nʲ j e t i
нажрёмся	n a ʐ rʲ o m sʲ a
хождении	x a ʐ dʲ e nʲ i i
распаривало	r a s p a rʲ i v a ɫ a
грызло	ɡ r i z ɫ a
тезисов	t e zʲ i s a f
сомнёмся	s a m nʲ o m sʲ a
пуншах	p u n ʂ a x
очертанию	a t͡ɕ i r t a nʲ i j u
куриц	k u rʲ i t͡s
комик	k o mʲ i k
повысите	p a v i sʲ i tʲ e
выпечкам	v i pʲ i t͡ɕ k a m
распознаешь	r a s p a z n a j i ʂ
подействовать	p a dʲ e j s t v a v a tʲ
продолжают	p r a d a ɫ ʐ a j u t
поступавшись	p a s t u p a f ʂ i sʲ
барахолок	b a r a x o ɫ a k
кебабах	kʲ i b a b a x
компенсируете	k a m ⁽ʲ ⁾ pʲ i n ⁽ʲ ⁾ sʲ i r u j i tʲ e
разговлялись	r a z ɡ a v lʲ a lʲ i sʲ
летящий	lʲ i tʲ a ɕː i j
сжалятся	ʐ a lʲ a t͡s a
перемежало	pʲ i rʲ i mʲ i ʐ a ɫ a
кириллицею	kʲ i rʲ i lʲ i t͡s i j u
оживляйтесь	a ʐ i v lʲ a j tʲ i sʲ
осклабляю	a s k ɫ a b lʲ a j u
увезённый	u vʲ i zʲ o n i j
уклонении	u k ɫ a nʲ e nʲ i i
оптимизирует	a p tʲ i mʲ i zʲ i r u j i t
брезгают	b rʲ e z ɡ a j u t
рыльцам	r i lʲ t͡s a m
междуречьям	mʲ i ʐ d u rʲ e t͡ɕ j a m
звонарях	z v a n a rʲ a x
усиках	u sʲ i k a x
адекватностях	a d i k v a t n a sʲ tʲ a x
анализирует	a n a lʲ i zʲ i r u j i t
лосося	ɫ a s o sʲ a
бабосам	b a b o s a m
восстанут	v a s t a n u t
сплетнями	s p lʲ e tʲ nʲ a mʲ i
гарда	ɡ a r d a
воспроизводивший	v a s p r a i z v a dʲ i f ʂ i j
красив	k r a sʲ i f
антенною	a n t e n a j u
лесотундрой	lʲ e s a t u n d r a j
интеллигент	i nʲ tʲ i lʲ i ɡʲ e n t
чайковский	t͡ɕ i j k o f s kʲ i j
вертишейке	vʲ i r tʲ i ʂ e j kʲ e
оладики	a ɫ a dʲ i kʲ i
асинхронный	a sʲ i n x r o n i j
говорунам	ɡ a v a r u n a m
мировыми	mʲ i r a v i mʲ i
совершенный	s a vʲ i r ʂ e n i j
мешковиною	mʲ i ʂ k a vʲ i n a j u
бонбоньеркою	b a n b a nʲ j e r k a j u
поджогами	p a d͡ʐ ʐ o ɡ a mʲ i
вакансию	v a k a n ⁽ʲ ⁾ sʲ i j u
отстроила	a t͡s s t r o i ɫ a
водяного	v a dʲ i n o v a
оттиски	o tʲː i s kʲ i
обросший	a b r o ʂ i j
откинула	a t kʲ i n u ɫ a
сломила	s ɫ a mʲ i ɫ a
абгомотопии	a b ɡ a m a t o pʲ i i
крову	k r o v u
текилах	tʲ i kʲ i ɫ a x
зелёном	zʲ i lʲ o n a m
французе	f r a n t͡s u zʲ e
образчиком	a b r a ɕː i k a m
насаждавши	n a s a ʐ d a f ʂ i
дискетах	dʲ i s kʲ e t a x
урочат	u r o t͡ɕ a t
рухните	r u x nʲ i tʲ e
скорчилась	s k o r t͡ɕ i ɫ a sʲ
закидонами	z a kʲ i d o n a mʲ i
приплясывать	p rʲ i p lʲ a s i v a tʲ
ставивши	s t a vʲ i f ʂ i
купаний	k u p a nʲ i j
плешь	p lʲ e ʂ
разнесите	r a zʲ nʲ i sʲ i tʲ e
предъявится	p rʲ i d j a vʲ i t͡s a
размягчаемый	r a z mʲ i x t͡ɕ a j i m i j
запрягут	z a p rʲ i ɡ u t
настучав	n a s t u t͡ɕ a f
губерниях	ɡ u bʲ e r nʲ i j a x
унесётесь	u nʲ i sʲ o tʲ i sʲ
раскачиваемся	r a s k a t͡ɕ i v a j i m sʲ a
больнаи	b a lʲ n a i
помазанников	p a m a z a nʲ i k a f
сюрреализм	sʲ u rʲ i a lʲ i z m
растащим	r a s t a ɕː i m
нумерацией	n u mʲ i r a t͡s i j i j
горгульею	ɡ a r ɡ u lʲ j i j u
изготовлением	i z ɡ a t a v lʲ e nʲ i j i m
метафизика	mʲ i t a fʲ i zʲ i k a
держава	dʲ i r ʐ a v a
втиснуть	f tʲ i s n u tʲ
умиришь	u mʲ i rʲ i ʂ
лотерее	ɫ a t i rʲ e j e
саня	s a nʲ a
храмы	x r a m i
убежим	u bʲ i ʐ i m
доводят	d a v o dʲ a t
привескам	p rʲ i vʲ e s k a m
отбудьте	a d b u tʲː e
монтажника	m a n t a ʐ nʲ i k a
ночники	n a t͡ɕ nʲ i kʲ i
опечатывали	a pʲ i t͡ɕ a t i v a lʲ i
еловый	j i ɫ o v i j
хиты	xʲ i t i
неприятностей	nʲ i p rʲ i j a t n a sʲ tʲ i j
перевешиваю	pʲ i rʲ i vʲ e ʂ i v a j u
стогами	s t a ɡ a mʲ i
угощениях	u ɡ a ɕː e nʲ i j a x
пронюхиваете	p r a nʲ u xʲ i v a j i tʲ e
природе	p rʲ i r o dʲ e
силаче	sʲ i ɫ a t͡ɕ e
заворачивающийся	z a v a r a t͡ɕ i v a j u ɕː i j sʲ a
закину	z a kʲ i n u
баянистку	b a j i nʲ i s t k u
попеть	p a pʲ e tʲ
прерывавши	p rʲ i r i v a f ʂ i
эвтаназиями	i f t a n a zʲ i j a mʲ i
афрофобиею	a f r a f o bʲ i j i j u
петрушевский	pʲ i t r u ʂ e f s kʲ i j
наездников	n a j e zʲ nʲ i k a f
зондируем	z a nʲ dʲ i r u j i m
упроси	u p r a sʲ i
сходит	s x o dʲ i t
скреплю	s k rʲ i p lʲ u
вотум	v o t u m
перельются	pʲ i rʲ i lʲ j u t͡s a
факельщиков	f a kʲ i lʲ ɕː i k a f
наскребавший	n a s k rʲ i b a f ʂ i j
жертву	ʐ e r t v u
дивимый	dʲ i vʲ i m i j
гирям	ɡʲ i rʲ a m
самосвалами	s a m a s v a ɫ a mʲ i
назначении	n a z n a t͡ɕ e nʲ i i
бодаем	b a d a j i m
моавитянине	m a a vʲ i tʲ i nʲ i nʲ e
облепляемый	a b lʲ i p lʲ a j i m i j
реабилитируем	rʲ i a bʲ i lʲ i tʲ i r u j i m
закроет	z a k r o j i t
чинодралы	t͡ɕ i n a d r a ɫ i
ликбезам	lʲ i ɡ bʲ e z a m
ничтожен	nʲ i t͡ɕ t o ʐ i n
недомогания	nʲ i d a m a ɡ a nʲ i j a
мотылькам	m a t i lʲ k a m
ускоришься	u s k o rʲ i ʂ sʲ a
поэтика	p a e tʲ i k a
предостерегать	p rʲ i d a sʲ tʲ i rʲ i ɡ a tʲ
насекомом	n a sʲ i k o m a m
швея	ʂ vʲ i j a
провозглашай	p r a v a z ɡ ɫ a ʂ a j
силуэты	sʲ i ɫ u e t i
промокай	p r a m a k a j
фасолей	f a s o lʲ i j
дуэта	d u e t a
соборяне	s a b a rʲ a nʲ e
багажниках	b a ɡ a ʐ nʲ i k a x
свистела	s vʲ i sʲ tʲ e ɫ a
мимикрий	mʲ i mʲ i k rʲ i j
прорежется	p r a rʲ e ʐ i t͡s a
мейтнериев	mʲ i j tʲ nʲ e rʲ i j i f
всхлипываниями	f s x lʲ i p i v a nʲ i j a mʲ i
откликалась	a t k lʲ i k a ɫ a sʲ
аллеях	a lʲ e j a x
бондарням	b a n d a r nʲ a m
склеило	s k lʲ e i ɫ a
буревестника	b u rʲ i vʲ e sʲ nʲ i k a
благоустрой	b ɫ a ɡ a u s t r o j
вьюгами	v ⁽ʲ ⁾ j u ɡ a mʲ i
труни	t r u nʲ i
бяках	bʲ a k a x
хуралов	x u r a ɫ a f
сподвижник	s p a d vʲ i ʐ nʲ i k
заглинизированности	z a ɡ lʲ i nʲ i zʲ i r a v a n a sʲ tʲ i
укреплений	u k rʲ i p lʲ e nʲ i j
лотке	ɫ a t kʲ e
агатом	a ɡ a t a m
пердеть	pʲ i r dʲ e tʲ
префикса	p rʲ e fʲ i k s a
заплетайтесь	z a p lʲ i t a j tʲ i sʲ
бисексуал	bʲ i s i k s u a ɫ
затворять	z a t v a rʲ a tʲ
приобщат	p rʲ i a p ɕː a t
пронюхивала	p r a nʲ u xʲ i v a ɫ a
гостю	ɡ o sʲ tʲ u
сгущаюсь	z ɡ u ɕː a j u sʲ
благоприличиями	b ɫ a ɡ a p rʲ i lʲ i t͡ɕ i j a mʲ i
провернуть	p r a vʲ i r n u tʲ
терабайтами	tʲ i r a b a j t a mʲ i
разговляются	r a z ɡ a v lʲ a j u t͡s a
возмужалый	v a z m u ʐ a ɫ i j
причастилось	p rʲ i t͡ɕ i sʲ tʲ i ɫ a sʲ
простите	p r a sʲ tʲ i tʲ e
биотоксичность	bʲ i a t a k sʲ i t͡ɕ n a sʲ tʲ
клавдия	k ɫ a v dʲ i j a
деканаты	d i k a n a t i
чтение	t͡ɕ tʲ e nʲ i j e
повторяют	p a f t a rʲ a j u t
краеведы	k r a j i vʲ e d i
компрометирующий	k a m p r a mʲ i tʲ i r u j u ɕː i j
переодевавши	pʲ i rʲ i a dʲ i v a f ʂ i
гранит	ɡ r a nʲ i t
возобновите	v a z a b n a vʲ i tʲ e
бодрствованиями	b o d r s t v a v a nʲ i j a mʲ i
конденсаторами	k a n d i n s a t a r a mʲ i
укрылся	u k r i ɫ s ⁽ʲ ⁾ a
разработайте	r a z r a b o t a j tʲ e
урезавший	u rʲ e z a f ʂ i j
отлучайте	a t ɫ u t͡ɕ a j tʲ e
матрон	m a t r o n
колбасить	k a ɫ b a sʲ i tʲ
экспансия	i k s p a n ⁽ʲ ⁾ sʲ i j a
рожаете	r a ʐ a j i tʲ e
помидорами	p a mʲ i d o r a mʲ i
шлемами	ʂ lʲ e m a mʲ i
заправляем	z a p r a v lʲ a j i m
отозваться	a t a z v a t͡s a
барбершопу	b a r bʲ i r ʂ o p u
прояснявшийся	p r a j i sʲ nʲ a f ʂ i j sʲ a
базаря	b a z a rʲ a
толщах	t o ɫ ɕː a x
ушибитесь	u ʂ i bʲ i tʲ i sʲ
угрожающий	u ɡ r a ʐ a j u ɕː i j
лишках	lʲ i ʂ k a x
крошкою	k r o ʂ k a j u
электростанциям	i lʲ e k t r a s t a n t͡s i j a m
преодолениям	p rʲ i a d a lʲ e nʲ i j a m
ласково	ɫ a s k a v a
фурфуролу	f u r f u r o ɫ u
толковании	t a ɫ k a v a nʲ i i
натерпелся	n a tʲ i r pʲ e ɫ s ⁽ʲ ⁾ a
деревяшкой	dʲ i rʲ i vʲ a ʂ k a j
лайкнула	ɫ a j k n u ɫ a
доносчиками	d a n o ɕ t͡ɕ i k a mʲ i
просвещений	p r a s vʲ i ɕː e nʲ i j
панграммами	p a n ɡ r a m a mʲ i
сачкуйте	s a t͡ɕ k u j tʲ e
обрабатывают	a b r a b a t i v a j u t
уволенный	u v o lʲ i n i j
гвардейца	ɡ v a r dʲ e j t͡s a
добивавшийся	d a bʲ i v a f ʂ i j sʲ a
завешивайте	z a vʲ e ʂ i v a j tʲ e
висело	vʲ i sʲ e ɫ a
сближает	z b lʲ i ʐ a j i t
рабынями	r a b i nʲ a mʲ i
капибарами	k a pʲ i b a r a mʲ i
бросьте	b r o sʲ tʲ e
растило	r a sʲ tʲ i ɫ a
пойменный	p o j mʲ i n i j
поносивший	p a n a sʲ i f ʂ i j
створяло	s t v a rʲ a ɫ a
лагуну	ɫ a ɡ u n u
вазочками	v a z a t͡ɕ k a mʲ i
закусила	z a k u sʲ i ɫ a
мадьярами	m a dʲ j a r a mʲ i
направляющий	n a p r a v lʲ a j u ɕː i j
льдинок	lʲ dʲ i n a k
печататься	pʲ i t͡ɕ a t a t͡s a
апофизою	a p a fʲ i z a j u
туземцами	t u zʲ e m t͡s a mʲ i
чахотке	t͡ɕ i x o t kʲ e
выломлю	v i ɫ a m lʲ u
бельгия	bʲ e lʲ ɡʲ i j a
изольются	i z a lʲ j u t͡s a
перелистает	pʲ i rʲ i lʲ i s t a j i t
лыком	ɫ i k a m
уединилась	u j i dʲ i nʲ i ɫ a sʲ
привстающий	p rʲ i f s t a j u ɕː i j
семнадцатиугольника	sʲ i m n a t͡s i tʲ i u ɡ o lʲ nʲ i k a
выкорчёвывайте	v i k a r t͡ɕ o v i v a j tʲ e
вместишь	v mʲ i sʲ tʲ i ʂ
реликта	rʲ i lʲ i k t a
луиджи	ɫ u i d͡ʐ ʐ i
бант	b a n t
отдалять	a d a lʲ a tʲ
блумфонтейн	b ɫ u m f a n t i j n
вышитый	v i ʂ i t i j
отрешаете	a t rʲ i ʂ a j i tʲ e
польстишь	p a lʲ sʲ tʲ i ʂ
отставший	a t͡s s t a f ʂ i j
толка	t o ɫ k a
подобострастие	p a d a b a s t r a sʲ tʲ i j e
описаешь	a pʲ i s a j i ʂ
засверкайте	z a s vʲ i r k a j tʲ e
токсичный	t a k sʲ i t͡ɕ n i j
валенком	v a lʲ i n k a m
ломись	ɫ a mʲ i sʲ
почти	p a t͡ɕ tʲ i
приземлявшийся	p rʲ i zʲ i m lʲ a f ʂ i j sʲ a
невежественна	nʲ i vʲ e ʐ i s t vʲ i n a
нанизывает	n a nʲ i z i v a j i t
поднимали	p a dʲ nʲ i m a lʲ i
артистка	a r tʲ i s t k a
насыщаюсь	n a s i ɕː a j u sʲ
шампуня	ʂ a m p u nʲ a
изводить	i z v a dʲ i tʲ
негодованию	nʲ i ɡ a d a v a nʲ i j u
казанах	k a z a n a x
приготовлением	p rʲ i ɡ a t a v lʲ e nʲ i j i m
магнатов	m a ɡ n a t a f
вступлениях	f s t u p lʲ e nʲ i j a x
бадей	b a dʲ e j
окопа	a k o p a
озарила	a z a rʲ i ɫ a
расторгла	r a s t o r ɡ ɫ a
отворачивающийся	a t v a r a t͡ɕ i v a j u ɕː i j sʲ a
расшифровывал	r a ʂ i f r o v i v a ɫ
смущал	s m u ɕː a ɫ
майданом	m a j d a n a m
усмотри	u s m a t rʲ i
простудивши	p r a s t u dʲ i f ʂ i
доулах	d o u ɫ a x
увозов	u v o z a f
комиссиями	k a mʲ i sʲ i j a mʲ i
экзамены	i ɡ z a mʲ i n i
единомышленников	j i dʲ i n a m i ʂ lʲ i nʲ i k a f
снисходили	sʲ nʲ i s x a dʲ i lʲ i
расхищав	r a s xʲ i ɕː a f
провидцу	p r a vʲ i t͡s u
нарекла	n a rʲ i k ɫ a
сманеврируют	s m a nʲ i v rʲ i r u j u t
корзна	k o r z n a
сровняйте	s r a v nʲ a j tʲ e
металась	mʲ i t a ɫ a sʲ
заслышит	z a s ɫ i ʂ i t
зачинам	z a t͡ɕ i n a m
воздухи	v o z d u xʲ i
дурной	d u r n o j
осияваешь	a sʲ i j i v a j i ʂ
оподельдока	a p a d i lʲ d o k a
ментом	mʲ i n t o m
инактивирую	i n a k tʲ i vʲ i r u j u
порок	p o r a k
умудрит	u m u d rʲ i t
ойкнувший	o j k n u f ʂ i j
гуглите	ɡ u ɡ lʲ i tʲ e
вышагнувши	v i ʂ a ɡ n u f ʂ i
пропитывав	p r a pʲ i t i v a f
воспев	v a s pʲ e f
накрахмаливала	n a k r a x m a lʲ i v a ɫ a
самоцвета	s a m a t͡s vʲ e t a
демографий	dʲ i m a ɡ r a fʲ i j
возвращениям	v a z v r a ɕː e nʲ i j a m
похвалилась	p a x v a lʲ i ɫ a sʲ
толстяком	t a ɫ s ⁽ʲ ⁾ tʲ i k o m
предусматривайте	p rʲ i d u s m a t rʲ i v a j tʲ e
предводителя	p rʲ i d v a dʲ i tʲ i lʲ a
горнилу	ɡ a r nʲ i ɫ u
щипая	ɕː i p a j a
насытите	n a s i tʲ i tʲ e
всклокоченный	f s k ɫ a k o t͡ɕ i n i j
уговаривая	u ɡ a v a rʲ i v a j a
дифференциальный	dʲ i fʲ i rʲ i n t͡s i a lʲ n i j
нервничавший	nʲ e r v nʲ i t͡ɕ i f ʂ i j
разочтусь	r a z a t͡ɕ t u sʲ
забудусь	z a b u d u sʲ
прижигайте	p rʲ i ʐ i ɡ a j tʲ e
восхождений	v a s x a ʐ dʲ e nʲ i j
борющийся	b o rʲ u ɕː i j sʲ a
выплёвывал	v i p lʲ o v i v a ɫ
ручниками	r u t͡ɕ nʲ i k a mʲ i
генпрокурорам	ɡʲ e n p r a k u r o r a m
сослагаете	s a s ɫ a ɡ a j i tʲ e
зачитывайся	z a t͡ɕ i t i v a j sʲ a
остужав	a s t u ʐ a f
лосьонам	ɫ a sʲ j o n a m
вальцующий	v a lʲ t͡s u j u ɕː i j
распиная	r a s pʲ i n a j a
запонок	z a p a n a k
осуждённый	a s u ʐ dʲ o n i j
затопляемый	z a t a p lʲ a j i m i j
вылезавший	v i lʲ i z a f ʂ i j
бомбометаниям	b o m b a mʲ i t a nʲ i j a m
бастурмою	b a s t u r m o j u
ожидая	a ʐ i d a j a
чокаешься	t͡ɕ o k a j i ʂ sʲ a
сорняком	s a r nʲ i k o m
топазу	t a p a z u
заправлял	z a p r a v lʲ a ɫ
телетекстах	tʲ e lʲ i tʲ e k s t a x
отображу	a t a b r a ʐ u
подзаголовков	p a d͡z z a ɡ a ɫ o f k a f
ревел	rʲ i vʲ e ɫ
откашлявшись	a t k a ʂ lʲ i f ʂ i sʲ
благословимся	b ɫ a ɡ a s ɫ a vʲ i m sʲ a
какую	k a k u j u
зажглись	z a ʐ ɡ lʲ i sʲ
сложившись	s ɫ a ʐ i f ʂ i sʲ
орошу	a r a ʂ u
рельефам	rʲ i lʲ j e f a m
шарахать	ʂ a r a x a tʲ
кудесу	k u dʲ e s u
молвила	m o ɫ vʲ i ɫ a
руководств	r u k a v o t͡s t f
клянчу	k lʲ a nʲ t͡ɕ u
врачах	v r a t͡ɕ a x
проскрипишь	p r a s k rʲ i pʲ i ʂ
зацепляло	z a t͡s i p lʲ a ɫ a
мамушке	m a m u ʂ kʲ e
абаданце	a b a d a n t͡s i
намыливающий	n a m i lʲ i v a j u ɕː i j
реяв	rʲ e j i f
стукнулся	s t u k n u ɫ s ⁽ʲ ⁾ a
ранетки	r a nʲ e t kʲ i
покладая	p a k ɫ a d a j a
долготе	d a ɫ ɡ a tʲ e
предпишем	p rʲ i t pʲ i ʂ i m
восславляю	v a s ɫ a v lʲ a j u
бороздим	b a r a zʲ dʲ i m
нуворишам	n u v a rʲ i ʂ a m
арке	a r kʲ e
взбегав	v z bʲ i ɡ a f
обрести	a b rʲ i sʲ tʲ i
спешил	s pʲ e ʂ i ɫ
прокрадываетесь	p r a k r a d i v a j i tʲ i sʲ
гуманизме	ɡ u m a nʲ i z mʲ e
наступления	n a s t u p lʲ e nʲ i j a
рожью	r o ʐ j u
проведши	p r a vʲ e t͡ʂ ʂ i
гидраты	ɡʲ i d r a t i
доверительностям	d a vʲ i rʲ i tʲ i lʲ n a sʲ tʲ a m
холодавши	x a ɫ a d a f ʂ i
тюльпана	tʲ u lʲ p a n a
выкрасило	v i k r a sʲ i ɫ a
взвинчивал	v z vʲ i nʲ t͡ɕ i v a ɫ
постыло	p a s t i ɫ a
срастусь	s r a s t u sʲ
шевельнётесь	ʂ i vʲ i lʲ nʲ o tʲ i sʲ
обуваете	a b u v a j i tʲ e
капотажами	k a p a t a ʐ a mʲ i
баблосы	b a b ɫ o s i
бесплодны	bʲ i s p ɫ o d n i
накачиваешь	n a k a t͡ɕ i v a j i ʂ
вуй	v u j
постираете	p a sʲ tʲ i r a j i tʲ e
портупей	p a r t u pʲ e j
добреешь	d a b rʲ e j i ʂ
маразмы	m a r a z m i
дисгармониею	dʲ i z ɡ a r m o nʲ i j i j u
тушёнками	t u ʂ o n k a mʲ i
унижавший	u nʲ i ʐ a f ʂ i j
курируйте	k u rʲ i r u j tʲ e
ломаку	ɫ a m a k u
памятей	p a mʲ i tʲ i j
вседозволенностях	f sʲ i d a z v o lʲ i n a sʲ tʲ a x
поставимся	p a s t a vʲ i m sʲ a
куркумой	k u r k u m a j
тушуй	t u ʂ u j
запрыгать	z a p r i ɡ a tʲ
недомыслиям	nʲ i d a m i s ⁽ʲ ⁾ lʲ i j a m
включав	f k lʲ u t͡ɕ a f
сгущая	z ɡ u ɕː a j a
чардаша	t͡ɕ a r d a ʂ a
переиграешь	pʲ i rʲ i i ɡ r a j i ʂ
заносит	z a n o sʲ i t
разрушились	r a z r u ʂ i lʲ i sʲ
киноаппаратом	kʲ i n a a p a r a t a m
умились	u mʲ i lʲ i sʲ
примадонну	p rʲ i m a d o n u
заступало	z a s t u p a ɫ a
припоминаешь	p rʲ i p a mʲ i n a j i ʂ
надавайте	n a d a v a j tʲ e
сигнализации	sʲ i ɡ n a lʲ i z a t͡s i i
ущемлениями	u ɕː i m lʲ e nʲ i j a mʲ i
зевал	zʲ i v a ɫ
закатывавшись	z a k a t i v a f ʂ i sʲ
выпустимся	v i p u sʲ tʲ i m sʲ a
сожитию	s a ʐ i tʲ i j u
накалывать	n a k a ɫ i v a tʲ
контрактниках	k a n t r a k tʲ nʲ i k a x
кастрировав	k a s t rʲ i r a v a f
противоправный	p r a tʲ i v a p r a v n i j
прозвучит	p r a z v u t͡ɕ i t
обучавшийся	a b u t͡ɕ a f ʂ i j sʲ a
лесосплавами	lʲ i s a s p ɫ a v a mʲ i
упоминаются	u p a mʲ i n a j u t͡s a
абдеритами	a b dʲ i rʲ i t a mʲ i
наркомтяжпром	n a r k a m tʲ i ʂ p r o m
намечаем	n a mʲ i t͡ɕ a j i m
теребейчук	tʲ i rʲ i bʲ i j t͡ɕ u k
четверостишиями	t͡ɕ i t vʲ i r a sʲ tʲ i ʂ i j a mʲ i
учугов	u t͡ɕ u ɡ a f
ностальгиям	n a s t a lʲ ɡʲ i j a m
суахили	s u a xʲ i lʲ i
изведав	i z vʲ e d a f
предприемлите	p rʲ i t p rʲ i j e m lʲ i tʲ e
серологию	sʲ i r a ɫ o ɡʲ i j u
продержится	p r a dʲ e r ʐ i t͡s a
дополнивший	d a p o ɫ nʲ i f ʂ i j
кибиток	kʲ i bʲ i t a k
нарушится	n a r u ʂ i t͡s a
регистрируясь	rʲ i ɡʲ i s t rʲ i r u j i sʲ
кристаллизуй	k rʲ i s t a lʲ i z u j
приводился	p rʲ i v a dʲ i ɫ s ⁽ʲ ⁾ a
переубеди	pʲ i rʲ i u bʲ i dʲ i
давлениям	d a v lʲ e nʲ i j a m
выпрямлявшийся	v i p rʲ i m lʲ a f ʂ i j sʲ a
запретам	z a p rʲ e t a m
приколоть	p rʲ i k a ɫ o tʲ
колосьям	k a ɫ o sʲ j a m
поведениям	p a vʲ i dʲ e nʲ i j a m
граммам	ɡ r a m a m
монголом	m a n ɡ o ɫ a m
высевок	v i sʲ i v a k
зарастите	z a r a sʲ tʲ i tʲ e
затешешь	z a tʲ e ʂ i ʂ
дураков	d u r a k o f
обобщить	a b a p ɕː i tʲ
коренившись	k a rʲ i nʲ i f ʂ i sʲ
тулии	t u lʲ i i
продлеваю	p r a d lʲ i v a j u
выкраиваются	v i k r a i v a j u t͡s a
сужений	s u ʐ e nʲ i j
афты	a f t i
поторопятся	p a t a r o pʲ a t͡s a
мнений	m nʲ e nʲ i j
просветлевший	p r a s vʲ i t lʲ e f ʂ i j
наколют	n a k o lʲ u t
раскусывали	r a s k u s i v a lʲ i
первые	pʲ e r v i j e
потру	p a t r u
перемычка	pʲ i rʲ i m i t͡ɕ k a
приписало	p rʲ i pʲ i s a ɫ a
буханке	b u x a n kʲ e
светиться	s vʲ i tʲ i t͡s a
завораживать	z a v a r a ʐ i v a tʲ
епитрахилей	j i pʲ i t r a xʲ i lʲ i j
фальсификациею	f a lʲ sʲ i fʲ i k a t͡s i j i j u
статейкой	s t a tʲ e j k a j
вмазывай	v m a z i v a j
купают	k u p a j u t
прощанья	p r a ɕː a nʲ j a
кочевнике	k a t͡ɕ e v nʲ i kʲ e
хлебцем	x lʲ e p t͡s i m
употребляли	u p a t rʲ i b lʲ a lʲ i
хадиса	x a dʲ i s a
копчений	k a p t͡ɕ e nʲ i j
переплыла	pʲ i rʲ i p ɫ i ɫ a
ощетинила	a ɕː i tʲ i nʲ i ɫ a
уладим	u ɫ a dʲ i m
сочинением	s a t͡ɕ i nʲ e nʲ i j i m
приползать	p rʲ i p a ɫ z a tʲ
съедутся	s j e d u t͡s a
опоссумом	a p o s u m a m
обустраивать	a b u s t r a i v a tʲ
цесарем	t͡s e s a rʲ i m
сосною	s a s n o j u
курилось	k u rʲ i ɫ a sʲ
сладким	s ɫ a t kʲ i m
патрульному	p a t r u lʲ n a m u
вёсла	vʲ o s ɫ a
душевыми	d u ʂ i v i mʲ i
распахиваясь	r a s p a xʲ i v a j i sʲ
прогреть	p r a ɡ rʲ e tʲ
пожирая	p a ʐ i r a j a
кирпич	kʲ i r pʲ i t͡ɕ
грилем	ɡ rʲ i lʲ i m
водосгон	v a d a z ɡ o n
выправка	v i p r a f k a
скатываешься	s k a t i v a j i ʂ sʲ a
сконфузитесь	s k a n f u zʲ i tʲ i sʲ
гобелене	ɡ a bʲ i lʲ e nʲ e
анусах	a n u s a x
исписывало	i s pʲ i s i v a ɫ a
хихикнули	xʲ i xʲ i k n u lʲ i
повадились	p a v a dʲ i lʲ i sʲ
отомщу	a t a m ɕː u
бесноватыми	bʲ i s n a v a t i mʲ i
вокзалах	v a ɡ z a ɫ a x
ризе	rʲ i zʲ e
террористе	t i r a rʲ i sʲ tʲ e
шиберов	ʂ i bʲ i r o f
вкрался	f k r a ɫ s ⁽ʲ ⁾ a
перелётом	pʲ i rʲ i lʲ o t a m
прислужили	p rʲ i s ɫ u ʐ i lʲ i
ослихам	a s ⁽ʲ ⁾ lʲ i x a m
артистке	a r tʲ i s t kʲ e
заняло	z a nʲ i ɫ a
облюю	a b lʲ u j u
отказались	a t k a z a lʲ i sʲ
выкапывали	v i k a p i v a lʲ i
вкрадывалась	f k r a d i v a ɫ a sʲ
перетекли	pʲ i rʲ i tʲ i k lʲ i
поправишь	p a p r a vʲ i ʂ
окаю	o k a j u
опосредуемый	a p a s rʲ e d u j i m i j
скорую	s k o r u j u
промашкам	p r a m a ʂ k a m
резнями	rʲ i zʲ nʲ a mʲ i
подворотне	p a d v a r o tʲ nʲ e
транслитерацией	t r a n s ⁽ʲ ⁾ lʲ i tʲ i r a t͡s i j i j
рассыплешься	r a s i p lʲ i ʂ sʲ a
паникёр	p a nʲ i kʲ o r
множим	m n o ʐ i m
кружениях	k r u ʐ e nʲ i j a x
жажда	ʐ a ʐ d a
прожидях	p r o ʐ i dʲ a x
закипим	z a kʲ i pʲ i m
обложитесь	a b ɫ o ʐ i tʲ i sʲ
хаяли	x a j i lʲ i
свечнике	s vʲ i t͡ɕ nʲ i kʲ e
понизишься	p a nʲ i zʲ i ʂ sʲ a
остряках	a s t rʲ i k a x
обнажите	a b n a ʐ i tʲ e
раздвинулись	r a z d vʲ i n u lʲ i sʲ
настань	n a s t a nʲ
подметайте	p a d mʲ i t a j tʲ e
скороговорка	s k a r a ɡ a v o r k a
поженить	p a ʐ i nʲ i tʲ
блогер	b ɫ o ɡʲ i r
адмиралов	a d mʲ i r a ɫ a f
набираем	n a bʲ i r a j i m
изобретая	i z a b rʲ i t a j a
отвыкавший	a t v i k a f ʂ i j
глумлениях	ɡ ɫ u m lʲ e nʲ i j a x
впоследствии	f p a s ⁽ʲ ⁾ lʲ e t͡s t vʲ i i
капишон	k a pʲ i ʂ o n
кляпами	k lʲ a p a mʲ i
него	nʲ i v o
аблефароном	a b lʲ i f a r o n a m
обносишь	a b n o sʲ i ʂ
сластён	s ɫ a sʲ tʲ o n
расправилось	r a s p r a vʲ i ɫ a sʲ
осмотрами	a s m o t r a mʲ i
сопутствую	s a p u t͡s t v u j u
шатах	ʂ a t a x
кипите	kʲ i pʲ i tʲ e
крошенный	k r o ʂ i n i j
полуподвала	p o ɫ u p a d v a ɫ a
санфранцисца	s a n f r a n t͡s i s t͡s a
попытками	p a p i t k a mʲ i
стремительно	s t rʲ i mʲ i tʲ i lʲ n a
формантой	f a r m a n t a j
растревоживают	r a s t rʲ i v o ʐ i v a j u t
коуче	k o u t͡ɕ e
загар	z a ɡ a r
продуцировать	p r a d u t͡s i r a v a tʲ
толкалось	t a ɫ k a ɫ a sʲ
сердцебиениях	sʲ i r t͡s i bʲ i j e nʲ i j a x
ромашкою	r a m a ʂ k a j u
лишивший	lʲ i ʂ i f ʂ i j
покривившись	p a k rʲ i vʲ i f ʂ i sʲ
воображаем	v a a b r a ʐ a j i m
углядите	u ɡ lʲ i dʲ i tʲ e
обветшалый	a b vʲ i t͡ʂ ʂ a ɫ i j
охнувший	o x n u f ʂ i j
обуреваешь	a b u rʲ i v a j i ʂ
отвесим	a t vʲ e sʲ i m
сгрудьтесь	z ɡ r u tʲː i sʲ
недержания	nʲ i dʲ i r ʐ a nʲ i j a
возобновись	v a z a b n a vʲ i sʲ
трактуете	t r a k t u j i tʲ e
сцала	s t͡s a ɫ a
спор	s p o r
букварями	b u k v a rʲ a mʲ i
ненадобный	nʲ i n a d a b n i j
слёзы	s ⁽ʲ ⁾ lʲ o z i
интегралом	i n t i ɡ r a ɫ a m
сверхприбылью	s vʲ e r x p rʲ i b i lʲ j u
перетягивавши	pʲ i rʲ i tʲ a ɡʲ i v a f ʂ i
ободам	o b a d a m
подведём	p a d vʲ i dʲ o m
увезёшь	u vʲ i zʲ o ʂ
преградивший	p rʲ i ɡ r a dʲ i f ʂ i j
засвистим	z a s vʲ i sʲ tʲ i m
киноактрисой	kʲ i n a a k t rʲ i s a j
унтер	u nʲ tʲ i r
бляшкам	b lʲ a ʂ k a m
строганый	s t r o ɡ a n i j
облупливаются	a b ɫ u p lʲ i v a j u t͡s a
уединявшись	u j i dʲ i nʲ a f ʂ i sʲ
высосали	v i s a s a lʲ i
активизируете	a k tʲ i vʲ i zʲ i r u j i tʲ e
захлопывайся	z a x ɫ o p i v a j sʲ a
замахивались	z a m a xʲ i v a lʲ i sʲ
поспешивший	p a s pʲ i ʂ i f ʂ i j
выдаст	v i d a s t
набивают	n a bʲ i v a j u t
ошарашить	a ʂ a r a ʂ i tʲ
вензаболеваний	vʲ e n z a b a lʲ i v a nʲ i j
огонькам	a ɡ a nʲ k a m
дымили	d i mʲ i lʲ i
аккомпанировали	a k a m p a nʲ i r a v a lʲ i
слюней	s ⁽ʲ ⁾ lʲ u nʲ e j
политологиям	p a lʲ i t a ɫ o ɡʲ i j a m
забирай	z a bʲ i r a j
эксцентрик	i k s t͡s e n t rʲ i k
бутилируют	b u tʲ i lʲ i r u j u t
расправа	r a s p r a v a
мобилизовав	m a bʲ i lʲ i z a v a f
привинчу	p rʲ i vʲ i nʲ t͡ɕ u
надоедания	n a d a j i d a nʲ i j a
наносекундах	n a n a sʲ i k u n d a x
печатанием	pʲ i t͡ɕ a t a nʲ i j i m
подрастала	p a d r a s t a ɫ a
бренчим	b rʲ i nʲ t͡ɕ i m
итальяшек	i t a lʲ j a ʂ i k
владиславом	v ɫ a dʲ i s ɫ a v a m
юлиана	j u lʲ i a n a
толкнёшь	t a ɫ k nʲ o ʂ
уполномоченный	u p a ɫ n a m o t͡ɕ i n i j
вступались	f s t u p a lʲ i sʲ
сохраниться	s a x r a nʲ i t͡s a
шкете	ʂ kʲ e tʲ e
вгибал	v ɡʲ i b a ɫ
расслабленные	r a s ɫ a b lʲ i n i j e
расквитается	r a s k vʲ i t a j i t͡s a
затирая	z a tʲ i r a j a
пользованиях	p o lʲ z a v a nʲ i j a x
прапорщик	p r a p a r ɕː i k
соревнуйтесь	s a rʲ i v n u j tʲ i sʲ
пелеринами	pʲ i lʲ i rʲ i n a mʲ i
исцелим	i s t͡s i lʲ i m
фабрикую	f a b rʲ i k u j u
выпустишься	v i p u sʲ tʲ i ʂ sʲ a
восприняла	v a s p rʲ i nʲ i ɫ a
каптенармусе	k a p t i n a r m u sʲ e
сковород	s k a v a r o t
похоронишь	p a x a r o nʲ i ʂ
кататься	k a t a t͡s a
грязнувший	ɡ rʲ a z n u f ʂ i j
консолидацией	k a n s a lʲ i d a t͡s i j i j
наклонности	n a k ɫ o n a sʲ tʲ i
сходна	s x o d n a
неполноту	nʲ i p a ɫ n a t u
шайтану	ʂ a j t a n u
возвышенно	v a z v i ʂ i n a
ёбанная	j o b a n a j a
влачимый	v ɫ a t͡ɕ i m i j
полтаблетки	p o ɫ t a b lʲ e t kʲ i
слепнем	s ⁽ʲ ⁾ lʲ e p nʲ i m
копило	k a pʲ i ɫ a
добивается	d a bʲ i v a j i t͡s a
двигают	d vʲ i ɡ a j u t
автогене	a f t a ɡʲ e nʲ e
выстелите	v i sʲ tʲ i lʲ i tʲ e
промокавший	p r a m a k a f ʂ i j
сколиоза	s k a lʲ i o z a
осмотримся	a s m o t rʲ i m sʲ a
перегрелись	pʲ i rʲ i ɡ rʲ e lʲ i sʲ
подготовляйте	p a d ɡ a t a v lʲ a j tʲ e
потребностях	p a t rʲ e b n a sʲ tʲ a x
котёночек	k a tʲ o n a t͡ɕ i k
отнимает	a tʲ nʲ i m a j i t
прокурору	p r a k u r o r u
работницами	r a b o tʲ nʲ i t͡s a mʲ i
целлюлозным	t͡s i lʲ u ɫ o z n i m
одаривая	a d a rʲ i v a j a
отмахавши	a t m a x a f ʂ i
чугунно	t͡ɕ u ɡ u n a
тарантулом	t a r a n t u ɫ a m
отваживаемся	a t v a ʐ i v a j i m sʲ a
презумпциями	p rʲ i z u m p t͡s i j a mʲ i
гугл	ɡ u ɡ ɫ
анграпа	a n ɡ r a p a
путепроводам	p u tʲ i p r a v o d a m
расстраивался	r a s t r a i v a ɫ s ⁽ʲ ⁾ a
постигнувший	p a sʲ tʲ i ɡ n u f ʂ i j
пневмонии	p nʲ i v m a nʲ i i
полился	p a lʲ i ɫ s ⁽ʲ ⁾ a
вредоносу	v rʲ i d a n o s u
гончары	ɡ a nʲ t͡ɕ i r i
довлело	d a v lʲ e ɫ a
мужской	m u ʂ s k o j
теоретиков	tʲ i a rʲ e tʲ i k a f
смрадишь	s m r a dʲ i ʂ
воображал	v a a b r a ʐ a ɫ
адсорбировав	a t͡s s a r bʲ i r a v a f
подмигивай	p a d mʲ i ɡʲ i v a j
фальцету	f a lʲ t͡s e t u
рефракторе	rʲ i f r a k t a rʲ e
обстановку	a p s t a n o f k u
излияниями	i z ⁽ʲ ⁾ lʲ i j a nʲ i j a mʲ i
похожестях	p a x o ʐ i sʲ tʲ a x
разглядишь	r a z ɡ lʲ i dʲ i ʂ
гобеленами	ɡ a bʲ i lʲ e n a mʲ i
пястях	pʲ a sʲ tʲ a x
охлопать	a x ɫ o p a tʲ
барабанщику	b a r a b a nʲ ɕː i k u
запаздывав	z a p a z d i v a f
погрешите	p a ɡ rʲ i ʂ i tʲ e
приглядывавшийся	p rʲ i ɡ lʲ a d i v a f ʂ i j sʲ a
выставляясь	v i s t a v lʲ a j i sʲ
обливающийся	a b lʲ i v a j u ɕː i j sʲ a
тюфяком	tʲ u fʲ i k o m
эксцессов	i k s t͡s e s a f
поставщиков	p a s t a f ɕː i k o f
найдёнышей	n a j dʲ o n i ʂ i j
коллажах	k a ɫ a ʐ a x
взяточникам	v zʲ a t a t͡ɕ nʲ i k a m
кличьте	k lʲ i t͡ɕ tʲ e
радиопередач	r a dʲ i o pʲ i rʲ i d a t͡ɕ
ухаживают	u x a ʐ i v a j u t
бандеролью	b a n d i r o lʲ j u
однороден	a d n a r o dʲ i n
утопят	u t o pʲ a t
потёрла	p a tʲ o r ɫ a
абстрактам	a p s t r a k t a m
проткнём	p r a t k nʲ o m
слонопотамам	s ɫ a n a p a t a m a m
рыскает	r i s k a j i t
сосками	s o s k a mʲ i
старое	s t a r a j a
брёха	b rʲ o x a
разрастался	r a z r a s t a ɫ s ⁽ʲ ⁾ a
поблагодарить	p a b ɫ a ɡ a d a rʲ i tʲ
жучков	ʐ u t͡ɕ k o f
населяв	n a sʲ i lʲ a f
осечкам	a sʲ e t͡ɕ k a m
специализмы	s pʲ i t͡s i a lʲ i z m i
дозоров	d a z o r a f
попадётся	p a p a dʲ o t͡s a
водрузив	v a d r u zʲ i f
сертификата	sʲ i r tʲ i fʲ i k a t a
гонореи	ɡ a n a rʲ e i
администраторах	a d mʲ i nʲ i s t r a t a r a x
украдёшь	u k r a dʲ o ʂ
воздадите	v a z d a dʲ i tʲ e
сушатся	s u ʂ a t͡s a
диаграммами	dʲ i a ɡ r a m a mʲ i
руководством	r u k a v o t͡s t v a m
прожигаем	p r a ʐ i ɡ a j i m
безматку	bʲ i z m a t k u
камням	k a m nʲ a m
бутафорией	b u t a f o rʲ i j i j
заботитесь	z a b o tʲ i tʲ i sʲ
мироточение	mʲ i r a t a t͡ɕ e nʲ i j e
покаявшийся	p a k a j i f ʂ i j sʲ a
древоподобный	d rʲ i v a p a d o b n i j
устремлённостей	u s t rʲ i m lʲ o n a sʲ tʲ i j
дисциплинировала	dʲ i s t͡s i p lʲ i nʲ i r a v a ɫ a
осунется	a s u nʲ i t͡s a
взяточничеством	v zʲ a t a t͡ɕ nʲ i t͡ɕ i s t v a m
пирожник	pʲ i r o ʐ nʲ i k
виновницах	vʲ i n o v nʲ i t͡s a x
язвивши	j i z vʲ i f ʂ i
питомце	pʲ i t o m t͡s i
замяло	z a mʲ a ɫ a
стихаем	sʲ tʲ i x a j i m
порочили	p a r o t͡ɕ i lʲ i
убийцы	u bʲ i j t͡s i
деточка	dʲ e t a t͡ɕ k a
перигея	pʲ i rʲ i ɡʲ e j a
городишь	ɡ a r o dʲ i ʂ
осатанеешь	a s a t a nʲ e j i ʂ
вариантах	v a rʲ i a n t a x
тапочек	t a p a t͡ɕ i k
мазом	m a z a m
пересказываем	pʲ i rʲ i s k a z i v a j i m
башке	b a ʂ kʲ e
поблагодарим	p a b ɫ a ɡ a d a rʲ i m
зайдя	z a j dʲ a
дублёнки	d u b lʲ o n kʲ i
изжогах	i ʐ o ɡ a x
руферствам	r u fʲ i r s t v a m
развернувший	r a z vʲ i r n u f ʂ i j
ларьках	ɫ a rʲ k a x
катеров	k a tʲ i r o f
ситами	sʲ i t a mʲ i
противоположу	p r o tʲ i v a p a ɫ a ʐ u
созывав	s a z i v a f
георгинов	ɡʲ i a r ɡʲ i n a f
нюхальщики	nʲ u x a lʲ ɕː i kʲ i
сплавы	s p ɫ a v i
мигаешь	mʲ i ɡ a j i ʂ
шхун	ʂ x u n
обговаривает	a b ɡ a v a rʲ i v a j i t
защищавшийся	z a ɕː i ɕː a f ʂ i j sʲ a
дозванивайтесь	d a z v a nʲ i v a j tʲ i sʲ
озари	a z a rʲ i
шевельнули	ʂ i vʲ i lʲ n u lʲ i
древнейший	d rʲ i v nʲ e j ʂ i j
фокстерьерах	f a k s t i rʲ j e r a x
залатавши	z a ɫ a t a f ʂ i
провидца	p r a vʲ i t͡s a
интерферометра	i n t i r fʲ i r o mʲ i t r a
смахиваю	s m a xʲ i v a j u
отчужу	a t͡ɕ u ʐ u
буферах	b u fʲ i r a x
сморкая	s m a r k a j a
подножьям	p a d n o ʐ j a m
дотягивающийся	d a tʲ a ɡʲ i v a j u ɕː i j sʲ a
венчания	vʲ i nʲ t͡ɕ a nʲ i j a
окупленный	a k u p lʲ i n i j
коллапсам	k a ɫ a p s a m
лаская	ɫ a s k a j a
венерологом	vʲ i nʲ i r o ɫ a ɡ a m
построит	p a s t r o i t
уязвляя	u j i z v lʲ a j a
поговорите	p a ɡ a v a rʲ i tʲ e
субъективностью	s u b j i k tʲ i v n a sʲ tʲ j u
бекасу	bʲ i k a s u
ветрениц	vʲ e t rʲ i nʲ i t͡s
переливало	pʲ i rʲ i lʲ i v a ɫ a
скептично	s kʲ i p tʲ i t͡ɕ n a
царевна	t͡s a rʲ e v n a
согласовываетесь	s a ɡ ɫ a s o v i v a j i tʲ i sʲ
сладкое	s ɫ a t k a j a
секирам	sʲ i kʲ i r a m
докатитесь	d a k a tʲ i tʲ i sʲ
изъяснят	i z j i sʲ nʲ a t
болте	b a ɫ tʲ e
подстрекателем	p a t͡s s t rʲ i k a tʲ i lʲ i m
надувающийся	n a d u v a j u ɕː i j sʲ a
клирошанам	k lʲ i r a ʂ a n a m
провозы	p r a v o z i
флотский	f ɫ o t͡s kʲ i j
выметаю	v i mʲ i t a j u
станком	s t a n k o m
зацеплять	z a t͡s i p lʲ a tʲ
забил	z a bʲ i ɫ
кругосветный	k r u ɡ a s vʲ e t n i j
тору	t o r u
чалтыкам	t͡ɕ i ɫ t i k a m
люкс	lʲ u k s
разукрашу	r a z u k r a ʂ u
бабахал	b a b a x a ɫ
сбило	z bʲ i ɫ a
разгневаюсь	r a z ɡ nʲ e v a j u sʲ
зампредседателях	z a m p rʲ i t͡sʲ sʲ i d a tʲ i lʲ a x
дозволение	d a z v a lʲ e nʲ i j e
чаячий	t͡ɕ a j i t͡ɕ i j
гудела	ɡ u dʲ e ɫ a
генофонда	ɡʲ i n a f o n d a
пиздить	pʲ i zʲ dʲ i tʲ
терапии	tʲ i r a pʲ i i
ошеломлением	a ʂ i ɫ a m lʲ e nʲ i j i m
забредают	z a b rʲ i d a j u t
размазывая	r a z m a z i v a j a
теплотрассе	tʲ i p ɫ a t r a sʲ e
пародируешь	p a r a dʲ i r u j i ʂ
громящий	ɡ r a mʲ a ɕː i j
надававший	n a d a v a f ʂ i j
конку	k o n k u
истопим	i s t o pʲ i m
усмехаясь	u s mʲ i x a j i sʲ
светилось	s vʲ i tʲ i ɫ a sʲ
идеалистов	i dʲ i a lʲ i s t a f
доработавши	d a r a b o t a f ʂ i
привязь	p rʲ i vʲ i sʲ
парадигмам	p a r a dʲ i ɡ m a m
подавляют	p a d a v lʲ a j u t
зачёркиваем	z a t͡ɕ o r kʲ i v a j i m
приписать	p rʲ i pʲ i s a tʲ
сущностью	s u ɕː n a sʲ tʲ j u
аншлюсов	a n ʂ lʲ u s a f
вселить	f sʲ i lʲ i tʲ
подмечавший	p a d mʲ i t͡ɕ a f ʂ i j
гастрит	ɡ a s t rʲ i t
реек	rʲ e j i k
пьянствовало	p ⁽ʲ ⁾ j a n s t v a v a ɫ a
просветишь	p r a s vʲ e tʲ i ʂ
нидерландского	nʲ i dʲ i r ɫ a n t s k a v a
обусловили	a b u s ɫ o vʲ i lʲ i
болотам	b a ɫ o t a m
майонезы	m a j i n e z i
поладив	p a ɫ a dʲ i f
заполонённый	z a p a ɫ a nʲ o n i j
сопряжёшь	s a p rʲ i ʐ o ʂ
новоангличанах	n o v a a n ɡ lʲ i t͡ɕ a n a x
пожирает	p a ʐ i r a j i t
аблактировать	a b ɫ a k tʲ i r a v a tʲ
звоночке	z v a n o t͡ɕ kʲ e
тарифов	t a rʲ i f a f
сутулишься	s u t u lʲ i ʂ sʲ a
насчёт	n a ɕː o t
сузила	s u zʲ i ɫ a
распускавшись	r a s p u s k a f ʂ i sʲ
мобильники	m a bʲ i lʲ nʲ i kʲ i
обогните	a b a ɡ nʲ i tʲ e
употребляюсь	u p a t rʲ i b lʲ a j u sʲ
забывался	z a b i v a ɫ s ⁽ʲ ⁾ a
оклемаетесь	a k lʲ i m a j i tʲ i sʲ
провозя	p r a v a zʲ a
строителю	s t r a i tʲ i lʲ u
загремишь	z a ɡ rʲ i mʲ i ʂ
нацист	n a t͡s i s t
уделах	u dʲ e ɫ a x
объевший	a b j e f ʂ i j
вытряхивает	v i t rʲ a xʲ i v a j i t
штурмовой	ʂ t u r m a v o j
начитывали	n a t͡ɕ i t i v a lʲ i
верующим	vʲ e r u j u ɕː i m
отхватываемый	a t x v a t i v a j i m i j
затрудни	z a t r u dʲ nʲ i
ознакомлялось	a z n a k a m lʲ a ɫ a sʲ
палит	p a lʲ i t
принимавшись	p rʲ i nʲ i m a f ʂ i sʲ
окружностей	a k r u ʐ n a sʲ tʲ i j
прокладывающий	p r a k ɫ a d i v a j u ɕː i j
русифицируешься	r u sʲ i fʲ i t͡s i r u j i ʂ sʲ a
створу	s t v o r u
расходовали	r a s x o d a v a lʲ i
растревоживая	r a s t rʲ i v o ʐ i v a j a
ростовой	r a s t a v o j
взыскавши	v z i s k a f ʂ i
одиннадцатилетиям	a dʲ i n a t͡s i tʲ i lʲ e tʲ i j a m
пастеризациями	p a s t i rʲ i z a t͡s i j a mʲ i
дознании	d a z n a nʲ i i
выкраивал	v i k r a i v a ɫ
зачаровав	z a t͡ɕ i r a v a f
антикварках	a nʲ tʲ i k v a r k a x
парижане	p a rʲ i ʐ a nʲ e
чемпионами	t͡ɕ i m ⁽ʲ ⁾ pʲ i o n a mʲ i
камышниц	k a m i ʂ nʲ i t͡s
расчёсывалась	r a ɕ t͡ɕ o s i v a ɫ a sʲ
заревом	z a rʲ i v a m
хмелея	x mʲ i lʲ e j a
корыту	k a r i t u
неформально	nʲ i f a r m a lʲ n a
инкубацией	i n k u b a t͡s i j i j
отслеживает	a t͡s s ⁽ʲ ⁾ lʲ e ʐ i v a j i t
санитары	s a nʲ i t a r i
приглядываем	p rʲ i ɡ lʲ a d i v a j i m
брюссельский	b rʲ u sʲ e lʲ s kʲ i j
роках	r o k a x
мастодонты	m a s t a d o n t i
раскручивало	r a s k r u t͡ɕ i v a ɫ a
шпионке	ʂ pʲ i o n kʲ e
челнок	t͡ɕ i ɫ n o k
отмывайте	a t m i v a j tʲ e
вскипали	f s kʲ i p a lʲ i
хранило	x r a nʲ i ɫ a
вероучением	vʲ e r a u t͡ɕ e nʲ i j i m
рогачу	r a ɡ a t͡ɕ u
предрекала	p rʲ i d rʲ i k a ɫ a
торговцы	t a r ɡ o f t͡s i
слижите	s ⁽ʲ ⁾ lʲ i ʐ i tʲ e
околицы	a k o lʲ i t͡s i
проговоримся	p r a ɡ a v a rʲ i m sʲ a
поучаствуете	p a u t͡ɕ a s t v u j i tʲ e
пересматривал	pʲ i rʲ i s m a t rʲ i v a ɫ
волчицам	v a ɫ t͡ɕ i t͡s a m
ремешкам	rʲ i mʲ i ʂ k a m
ознакомляем	a z n a k a m lʲ a j i m
ведавший	vʲ e d a f ʂ i j
выгрузчиками	v i ɡ r u ɕː i k a mʲ i
иволгою	i v a ɫ ɡ a j u
презрел	p rʲ i z rʲ e ɫ
вскидывалась	f s kʲ i d i v a ɫ a sʲ
сплетениями	s p lʲ i tʲ e nʲ i j a mʲ i
тирамису	tʲ i r a mʲ i s u
мяукала	mʲ i u k a ɫ a
вырыв	v i r i f
лезгинкою	lʲ i z ɡʲ i n k a j u
пообедай	p a a bʲ e d a j
остервенел	a sʲ tʲ i r vʲ i nʲ e ɫ
скрепляешь	s k rʲ i p lʲ a j i ʂ
любовником	lʲ u b o v nʲ i k a m
разлились	r a z ⁽ʲ ⁾ lʲ i lʲ i sʲ
колледж	k o lʲ i t͡ʂ ʂ
одиссеями	a dʲ i sʲ e j a mʲ i
проверив	p r a vʲ e rʲ i f
отряхнули	a t rʲ i x n u lʲ i
формализовавший	f a r m a lʲ i z a v a f ʂ i j
стилистика	sʲ tʲ i lʲ i sʲ tʲ i k a
микросхемы	mʲ i k r a s xʲ e m i
отпускавши	a t p u s k a f ʂ i
выясняешь	v i j i sʲ nʲ a j i ʂ
торопыга	t a r a p i ɡ a
гимназией	ɡʲ i m n a zʲ i j i j
тойтерьер	t a j t i rʲ j e r
аблактировке	a b ɫ a k tʲ i r o f kʲ e
духовниках	d u x a v nʲ i k a x
благодарностью	b ɫ a ɡ a d a r n a sʲ tʲ j u
надколеннике	n a t k a lʲ e nʲ i kʲ e
перекусят	pʲ i rʲ i k u sʲ a t
черкать	t͡ɕ i r k a tʲ
покрученный	p a k r u t͡ɕ i n i j
лопари	ɫ o p a rʲ i
обручавший	a b r u t͡ɕ a f ʂ i j
ниггерам	nʲ i ɡʲ i r a m
облеплять	a b lʲ i p lʲ a tʲ
затирав	z a tʲ i r a f
бляшка	b lʲ a ʂ k a
перечтём	pʲ i rʲ i t͡ɕ tʲ o m
бедняке	bʲ i dʲ nʲ i kʲ e
подданству	p o d a n s t v u
ниточками	nʲ i t a t͡ɕ k a mʲ i
всевышним	f sʲ i v i ʂ nʲ i m
маток	m a t a k
колесить	k a lʲ i sʲ i tʲ
патокам	p a t a k a m
выливался	v i lʲ i v a ɫ s ⁽ʲ ⁾ a
порастёт	p a r a sʲ tʲ o t
провайдеры	p r a v a j d i r i
маркиза	m a r kʲ i z a
репортёрах	rʲ i p a r tʲ o r a x
полемику	p a lʲ e mʲ i k u
абстракционистский	a p s t r a k t͡s i a nʲ i s t͡s kʲ i j
утихаете	u tʲ i x a j i tʲ e
переломлю	pʲ i rʲ i ɫ a m lʲ u
разъём	r a z j o m
ответству	a t vʲ e t͡s t v u
изменяло	i z mʲ i nʲ a ɫ a
абсорбатам	a p s a r b a t a m
писателями	pʲ i s a tʲ i lʲ a mʲ i
олимпиек	a lʲ i m ⁽ʲ ⁾ pʲ i j i k
перекладывайте	pʲ i rʲ i k ɫ a d i v a j tʲ e
пощёлкали	p a ɕː o ɫ k a lʲ i
сигналите	sʲ i ɡ n a lʲ i tʲ e
лад	ɫ a t
подешевевши	p a dʲ i ʂ i vʲ e f ʂ i
претенденткою	p rʲ i tʲ i nʲ dʲ e n t k a j u
замечается	z a mʲ i t͡ɕ a j i t͡s a
решалось	rʲ i ʂ a ɫ a sʲ
прикажу	p rʲ i k a ʐ u
номинирует	n a mʲ i nʲ i r u j i t
коклюш	k a k lʲ u ʂ
мантиями	m a nʲ tʲ i j a mʲ i
ахи	a xʲ i
извлекут	i z v lʲ i k u t
взбираетесь	v z bʲ i r a j i tʲ i sʲ
скрепляя	s k rʲ i p lʲ a j a
фотокарточками	f a t a k a r t a t͡ɕ k a mʲ i
ввязав	vʲ i z a f
западало	z a p a d a ɫ a
пупсиков	p u p sʲ i k a f
объедаемый	a b j i d a j i m i j
завалитесь	z a v a lʲ i tʲ i sʲ
штрафанёте	ʂ t r a f a nʲ o tʲ e
смотрелось	s m a t rʲ e ɫ a sʲ
содрогавшийся	s a d r a ɡ a f ʂ i j sʲ a
закладывай	z a k ɫ a d i v a j
урезывав	u rʲ e z i v a f
приделать	p rʲ i dʲ e ɫ a tʲ
запугав	z a p u ɡ a f
поруководи	p a r u k a v a dʲ i
оцепеней	a t͡s i pʲ i nʲ e j
отсидят	a t͡sʲ sʲ i dʲ a t
переставить	pʲ i rʲ i s t a vʲ i tʲ
алебастр	a lʲ i b a s t r
гримировкам	ɡ rʲ i mʲ i r o f k a m
кремниев	k rʲ e m nʲ i j i f
всовавши	f s a v a f ʂ i
перекликаем	pʲ i rʲ i k lʲ i k a j i m
проткнуло	p r a t k n u ɫ a
харьковчанах	x a rʲ k a f t͡ɕ a n a x
волкодава	v a ɫ k a d a v a
цингою	t͡s i n ɡ o j u
грозясь	ɡ r a zʲ a sʲ
криптонов	k rʲ i p t o n a f
маскируетесь	m a s kʲ i r u j i tʲ i sʲ
нахмурюсь	n a x m u rʲ u sʲ
вавилонянами	v a vʲ i ɫ o nʲ i n a mʲ i
двусмысленны	d v u s m i s ⁽ʲ ⁾ lʲ i n i
послушался	p a s ɫ u ʂ a ɫ s ⁽ʲ ⁾ a
охраняетесь	a x r a nʲ a j i tʲ i sʲ
гомони	ɡ a m a nʲ i
думаем	d u m a j i m
присылавши	p rʲ i s i ɫ a f ʂ i
морфий	m o r fʲ i j
прохождениям	p r a x a ʐ dʲ e nʲ i j a m
протестуешь	p r a tʲ i s t u j i ʂ
англосфере	a n ɡ ɫ a s fʲ e rʲ e
беспощадно	bʲ i s p a ɕː a d n a
напряжённа	n a p rʲ i ʐ o n a
обатуром	a b a t u r a m
абсурдиста	a p s u r dʲ i s t a
вышибалу	v i ʂ i b a ɫ u
бездн	bʲ e z d n
эмигранты	i mʲ i ɡ r a n t i
повязанный	p a vʲ a z a n i j
спортивны	s p a r tʲ i v n i
приспособите	p rʲ i s p a s o bʲ i tʲ e
застрелив	z a s t rʲ i lʲ i f
стлались	s t ɫ a lʲ i sʲ
апограф	a p o ɡ r a f
распустишься	r a s p u sʲ tʲ i ʂ sʲ a
своровавший	s v a r a v a f ʂ i j
саунам	s a u n a m
подсолнухе	p a t͡s s o ɫ n u xʲ e
вздорожании	v z d a r a ʐ a nʲ i i
ракша	r a k ʂ a
перекладывал	pʲ i rʲ i k ɫ a d i v a ɫ
цевках	t͡s e f k a x
задумчивостями	z a d u m t͡ɕ i v a sʲ tʲ a mʲ i
лепя	lʲ i pʲ a
зацепитесь	z a t͡s e pʲ i tʲ i sʲ
прививай	p rʲ i vʲ i v a j
подлокотником	p a d ɫ a k o tʲ nʲ i k a m
гитаристам	ɡʲ i t a rʲ i s t a m
буккеры	b u kʲ i r i
фейсконтролей	f e j s k a n t r o lʲ i j
окисью	o kʲ i sʲ j u
рейхстагу	r i j x s t a ɡ u
выпускается	v i p u s k a j i t͡s a
раскрадывают	r a s k r a d i v a j u t
ручейник	r u t͡ɕ e j nʲ i k
задёргиваем	z a dʲ o r ɡʲ i v a j i m
юмористическая	j u m a rʲ i sʲ tʲ i t͡ɕ i s k a j a
выдворявши	v i d v a rʲ a f ʂ i
дождливый	d a ʐ d lʲ i v i j
недоступностью	nʲ i d a s t u p n a sʲ tʲ j u
втыкаете	f t i k a j i tʲ e
подлодке	p a d ɫ o t kʲ e
позволяла	p a z v a lʲ a ɫ a
надрезы	n a d rʲ e z i
лапали	ɫ a p a lʲ i
выговорившись	v i ɡ a v a rʲ i f ʂ i sʲ
хвалимся	x v a lʲ i m sʲ a
отщепляйте	a t͡ɕ ɕː i p lʲ a j tʲ e
заведованием	z a vʲ e d a v a nʲ i j i m
смудрит	s m u d rʲ i t
здесь	zʲ dʲ e sʲ
децентрализовали	d e t͡s i n t r a lʲ i z a v a lʲ i
хищения	xʲ i ɕː e nʲ i j a
гирей	ɡʲ i rʲ i j
заимейте	z a i mʲ e j tʲ e
глотает	ɡ ɫ a t a j i t
кувшинках	k u f ʂ i n k a x
покатаешь	p a k a t a j i ʂ
впущенный	f p u ɕː i n i j
подшипникам	p a t͡ʂ ʂ i p nʲ i k a m
претворить	p rʲ i t v a rʲ i tʲ
расселив	r a sʲ i lʲ i f
экспериментировавший	i k s pʲ i rʲ i mʲ i nʲ tʲ i r a v a f ʂ i j
несбыточный	nʲ i z b i t a t͡ɕ n i j
плантациях	p ɫ a n t a t͡s i j a x
абсолютизмах	a p s a lʲ u tʲ i z m a x
высь	v i sʲ
зачислявши	z a t͡ɕ i s ⁽ʲ ⁾ lʲ a f ʂ i
парейдолиях	p a rʲ i j d a lʲ i j a x
стоил	s t o i ɫ
уменьшайся	u mʲ i nʲ ʂ a j sʲ a
заебать	z a j i b a tʲ
заразятся	z a r a zʲ a t͡s a
выразителям	v i r a zʲ i tʲ i lʲ a m
абдраганами	a b d r a ɡ a n a mʲ i
спросонок	s p r a s o n a k
голье	ɡ a lʲ j e
приводили	p rʲ i v a dʲ i lʲ i
заперлись	z a pʲ i r lʲ i sʲ
героинях	ɡʲ i r a i nʲ a x
мучу	m u t͡ɕ u
цензурировавший	t͡s i n z u rʲ i r a v a f ʂ i j
запираюсь	z a pʲ i r a j u sʲ
непогрешимый	nʲ i p a ɡ rʲ i ʂ i m i j
аккредитива	a k rʲ i dʲ i tʲ i v a
бронетехникою	b r o nʲ i tʲ e x nʲ i k a j u
оттискиваем	a tʲː i s kʲ i v a j i m
пакистанцы	p a kʲ i s t a n t͡s i
повертит	p a vʲ e r tʲ i t
стуке	s t u kʲ e
епархия	j i p a r xʲ i j a
покрышка	p a k r i ʂ k a
проверяй	p r a vʲ i rʲ a j
театре	tʲ i a t a rʲ e
затянемся	z a tʲ a nʲ i m sʲ a
лязгнуло	lʲ a z ɡ n u ɫ a
тучности	t u t͡ɕ n a sʲ tʲ i
спёр	s pʲ o r
вставишься	f s t a vʲ i ʂ sʲ a
великодушием	vʲ i lʲ i k a d u ʂ i j i m
выправлять	v i p r a v lʲ a tʲ
старцы	s t a r t͡s i
синкансэном	sʲ i n k a n s e n a m
разбредалась	r a z b rʲ i d a ɫ a sʲ
ветшаем	vʲ i t͡ʂ ʂ a j i m
механизатор	mʲ i x a nʲ i z a t a r
надушу	n a d u ʂ u
размежевавши	r a z mʲ i ʐ i v a f ʂ i
лизнув	lʲ i z n u f
поджариваем	p a d͡ʐ ʐ a rʲ i v a j i m
маскировкою	m a s kʲ i r o f k a j u
завываете	z a v i v a j i tʲ e
опасения	a p a sʲ e nʲ i j a
зимовав	zʲ i m a v a f
переливает	pʲ i rʲ i lʲ i v a j i t
напрашиваетесь	n a p r a ʂ i v a j i tʲ i sʲ
чувствуйте	t͡ɕ u s t v u j tʲ e
распевавший	r a s pʲ i v a f ʂ i j
сомнениями	s a m nʲ e nʲ i j a mʲ i
осушал	a s u ʂ a ɫ
пагубах	p a ɡ u b a x
вводимся	v o dʲ i m sʲ a
радикалу	r a dʲ i k a ɫ u
неприкасаемом	nʲ i p rʲ i k a s a j i m a m
павлинах	p a v lʲ i n a x
секунды	sʲ i k u n d i
подхваченный	p a t x v a t͡ɕ i n i j
походом	p a x o d a m
разводились	r a z v a dʲ i lʲ i sʲ
осведомляющийся	a s vʲ i d a m lʲ a j u ɕː i j sʲ a
деспотизм	dʲ i s p a tʲ i z m
плюрализмам	p lʲ u r a lʲ i z m a m
демонстрацией	dʲ i m a n s t r a t͡s i j i j
чуявши	t͡ɕ u j i f ʂ i
синюхой	sʲ i nʲ u x a j
матраца	m a t r a t͡s a
звенеть	z vʲ i nʲ e tʲ
бездари	bʲ e z d a rʲ i
пейджер	p e j d͡ʐ ʐ i r
монорельса	m a n a rʲ e lʲ s a
уют	u j u t
закономерностями	z a k a n a mʲ e r n a sʲ tʲ a mʲ i
повалила	p a v a lʲ i ɫ a
разыгрался	r a z i ɡ r a ɫ s ⁽ʲ ⁾ a
патологоанатомию	p a t o ɫ a ɡ a a n a t o mʲ i j u
феминизмом	fʲ i mʲ i nʲ i z m a m
промышляло	p r a m i ʂ lʲ a ɫ a
электрон	i lʲ i k t r o n
ренессанса	r i n i s a n s a
салфеточкам	s a ɫ fʲ e t a t͡ɕ k a m
разноцветен	r a z n a t͡s vʲ e tʲ i n
аскетом	a s kʲ e t a m
синтеза	sʲ i n t i z a
потирать	p a tʲ i r a tʲ
граммами	ɡ r a m a mʲ i
сигнализаций	sʲ i ɡ n a lʲ i z a t͡s i j
кроссовках	k r a s o f k a x
гнобите	ɡ n a bʲ i tʲ e
киноплёнках	kʲ i n a p lʲ o n k a x
оплатим	a p ɫ a tʲ i m
клетку	k lʲ e t k u
вметут	v mʲ i t u t
отменимся	a t mʲ e nʲ i m sʲ a
мироточцами	mʲ i r a t o t͡ɕ t͡s a mʲ i
позитроны	p a zʲ i t r o n i
соучастниц	s a u t͡ɕ a sʲ nʲ i t͡s
марева	m a rʲ i v a
отворачиваюсь	a t v a r a t͡ɕ i v a j u sʲ
погреетесь	p a ɡ rʲ e j i tʲ i sʲ
закопушкой	z a k a p u ʂ k a j
упоениям	u p a j e nʲ i j a m
сателлиту	s a tʲ i lʲ i t u
чернуху	t͡ɕ i r n u x u
преобразовывавшийся	p rʲ i a b r a z o v i v a f ʂ i j sʲ a
обтёсывают	a p tʲ o s i v a j u t
зарядный	z a rʲ a d n i j
отборы	a d b o r i
алкинов	a ɫ kʲ i n a f
вжал	v ʐ a ɫ
посовещаются	p a s a vʲ i ɕː a j u t͡s a
треклистах	t r i k lʲ i s t a x
гонялись	ɡ a nʲ a lʲ i sʲ
обнадёживай	a b n a dʲ o ʐ i v a j
разрыдается	r a z r i d a j i t͡s a
постылевший	p a s t i lʲ i f ʂ i j
хмыкнут	x m i k n u t
гармоники	ɡ a r m o nʲ i kʲ i
чуланчиков	t͡ɕ u ɫ a nʲ t͡ɕ i k a f
извергший	i z vʲ e r k ʂ i j
паприках	p a p rʲ i k a x
накалялась	n a k a lʲ a ɫ a sʲ
соизволив	s a i z v o lʲ i f
ветютнями	vʲ i tʲ u tʲ nʲ a mʲ i
трепыхаемся	t rʲ i p i x a j i m sʲ a
горячностей	ɡ a rʲ a t͡ɕ n a sʲ tʲ i j
отворачивай	a t v a r a t͡ɕ i v a j
кустарям	k u s t a rʲ a m
слиться	s ⁽ʲ ⁾ lʲ i t͡s a
входивши	f x a dʲ i f ʂ i
конопатят	k a n a p a tʲ a t
симулируй	sʲ i m u lʲ i r u j
отяжелеть	a tʲ i ʐ i lʲ e tʲ
туманностях	t u m a n a sʲ tʲ a x
птаха	p t a x a
усложняем	u s ɫ a ʐ nʲ a j i m
рябинам	rʲ a bʲ i n a m
студнями	s t u dʲ nʲ a mʲ i
приписываемый	p rʲ i pʲ i s i v a j i m i j
плутон	p ɫ u t o n
промолвлю	p r a m o ɫ v lʲ u
разгоняете	r a z ɡ a nʲ a j i tʲ e
трансляциям	t r a n s ⁽ʲ ⁾ lʲ a t͡s i j a m
булавкой	b u ɫ a f k a j
наполняя	n a p a ɫ nʲ a j a
умён	u mʲ o n
эклер	i k lʲ e r
перевешивай	pʲ i rʲ i vʲ e ʂ i v a j
обёртках	a bʲ o r t k a x
переустроит	pʲ i rʲ i u s t r o i t
видоискателем	vʲ i d a i s k a tʲ i lʲ i m
накренишь	n a k rʲ i nʲ i ʂ
заблагорассудил	z a b ɫ a ɡ a r a s u dʲ i ɫ
ударяемся	u d a rʲ a j i m sʲ a
осмысливаемый	a s m i s ⁽ʲ ⁾ lʲ i v a j i m i j
пройдусь	p r a j d u sʲ
загрязнив	z a ɡ rʲ i zʲ nʲ i f
причинить	p rʲ i t͡ɕ i nʲ i tʲ
мыслителях	m i s ⁽ʲ ⁾ lʲ i tʲ i lʲ a x
властолюбия	v ɫ a s t a lʲ u bʲ i j a
выстрадала	v i s t r a d a ɫ a
лошадке	ɫ a ʂ a t kʲ e
черенами	t͡ɕ e rʲ i n a mʲ i
туловищем	t u ɫ a vʲ i ɕː i m
стыдобам	s t i d o b a m
залепляя	z a lʲ i p lʲ a j a
волокут	v a ɫ a k u t
шаромыгой	ʂ a r a m i ɡ a j
черемшах	t͡ɕ i rʲ i m ʂ a x
шаромыгами	ʂ a r a m i ɡ a mʲ i
остротой	a s t r o t a j
дружественен	d r u ʐ i s t vʲ i nʲ i n
редакция	rʲ i d a k t͡s i j a
безмолвиями	bʲ i z m o ɫ vʲ i j a mʲ i
ассемблера	a s e m b lʲ i r a
попросись	p a p r a sʲ i sʲ
устаревали	u s t a rʲ i v a lʲ i
ворочанный	v a r o t͡ɕ i n i j
пролезла	p r a lʲ e z ɫ a
разгласят	r a z ɡ ɫ a sʲ a t
темпераментами	tʲ i m ⁽ʲ ⁾ pʲ i r a mʲ i n t a mʲ i
абсорбироваться	a p s a r bʲ i r a v a t͡s a
дрейфами	d rʲ e j f a mʲ i
утком	u t k o m
даннике	d a nʲ i kʲ e
пробурчала	p r a b u r t͡ɕ a ɫ a
шаттлу	ʂ a t ɫ u
лоханулись	ɫ a x a n u lʲ i sʲ
кинолентами	kʲ i n a lʲ e n t a mʲ i
забора	z a b o r a
совокупление	s a v a k u p lʲ e nʲ i j e
мастодонтов	m a s t a d o n t a f
буржуазны	b u r ʐ u a z n i
видывали	vʲ i d i v a lʲ i
картонах	k a r t o n a x
опробованный	a p r o b a v a n i j
бомбистах	b a m ⁽ʲ ⁾ bʲ i s t a x
машите	m a ʂ i tʲ e
потаскушки	p a t a s k u ʂ kʲ i
заискивали	z a i s kʲ i v a lʲ i
крылышке	k r i ɫ i ʂ kʲ e
заключайтесь	z a k lʲ u t͡ɕ a j tʲ i sʲ
навигация	n a vʲ i ɡ a t͡s i j a
гидрологиях	ɡʲ i d r a ɫ o ɡʲ i j a x
предпочтению	p rʲ i t p a t͡ɕ tʲ e nʲ i j u
омрачав	a m r a t͡ɕ a f
повидать	p a vʲ i d a tʲ
спокойствии	s p a k o j s t vʲ i i
табличку	t a b lʲ i t͡ɕ k u
уставившись	u s t a vʲ i f ʂ i sʲ
трефы	t rʲ e f i
абазинкою	a b a zʲ i n k a j u
взгромождавши	v z ɡ r a m a ʐ d a f ʂ i
педиатрией	pʲ i dʲ i a t rʲ i j i j
информационный	i n f a r m a t͡s i o n i j
выписало	v i pʲ i s a ɫ a
потопталось	p a t a p t a ɫ a sʲ
возведши	v a z vʲ e t͡ʂ ʂ i
интерпретированный	i n t i r p rʲ i tʲ i r a v a n i j
кукушкам	k u k u ʂ k a m
аллергене	a lʲ i r ɡʲ e nʲ e
дубли	d u b lʲ i
хаживал	x a ʐ i v a ɫ
снабжал	s n a b ʐ a ɫ
погону	p a ɡ o n u
мегаэрги	mʲ i ɡ a e r ɡʲ i
отеческий	a tʲ e t͡ɕ i s kʲ i j
кусаем	k u s a j i m
волокит	v a ɫ a kʲ i t
хатах	x a t a x
самсарою	s a m s a r a j u
отдохнувший	a d a x n u f ʂ i j
насылаем	n a s i ɫ a j i m
речёвках	rʲ i t͡ɕ o f k a x
сталкиваюсь	s t a ɫ kʲ i v a j u sʲ
накапливаем	n a k a p lʲ i v a j i m
систола	sʲ i s t a ɫ a
отводилась	a t v a dʲ i ɫ a sʲ
сдвинутся	z d vʲ i n u t͡s a
миньетчиком	mʲ i nʲ j e t͡ɕ i k a m
уточняй	u t a t͡ɕ nʲ a j
наперстянок	n a pʲ i r s ⁽ʲ ⁾ tʲ a n a k
разыгрывайся	r a z i ɡ r i v a j sʲ a
обеспокоил	a bʲ i s p a k o i ɫ
новациям	n a v a t͡s i j a m
вжимаемся	v ʐ i m a j i m sʲ a
разбувшись	r a z b u f ʂ i sʲ
притягаете	p rʲ i tʲ i ɡ a j i tʲ e
опушив	a p u ʂ i f
шайбах	ʂ a j b a x
глашу	ɡ ɫ a ʂ u
навлекали	n a v lʲ i k a lʲ i
разговорись	r a z ɡ a v a rʲ i sʲ
вальцом	v a lʲ t͡s o m
пиву	pʲ i v u
заглохло	z a ɡ ɫ o x ɫ a
краткам	k r a t k a m
придавливало	p rʲ i d a v lʲ i v a ɫ a
отвалишься	a t v a lʲ i ʂ sʲ a
заповедниках	z a p a vʲ e dʲ nʲ i k a x
колеблющий	k a lʲ e b lʲ u ɕː i j
председательствовавши	p rʲ i t͡sʲ sʲ i d a tʲ i lʲ s t v a v a f ʂ i
причитывайте	p rʲ i t͡ɕ i t i v a j tʲ e
чищенный	t͡ɕ i ɕː i n i j
арумынкой	a r u m i n k a j
выкаливает	v i k a lʲ i v a j i t
иваси	i v a sʲ i
вырисовываться	v i rʲ i s o v i v a t͡s a
обнадёживать	a b n a dʲ o ʐ i v a tʲ
абецадло	a b i t͡s a d ɫ a
рабфаках	r a p f a k a x
обидами	a bʲ i d a mʲ i
состряпаете	s a s t rʲ a p a j i tʲ e
одышка	a d i ʂ k a
разогнув	r a z a ɡ n u f
коверкаемый	k a vʲ e r k a j i m i j
тротуару	t r a t u a r u
безобразием	bʲ i z a b r a zʲ i j i m
выспрашиваемый	v i s p r a ʂ i v a j i m i j
перепивав	pʲ i rʲ i pʲ i v a f
плацента	p ɫ a t͡s e n t a
узлом	u z ɫ o m
утончи	u t a nʲ t͡ɕ i
политологиею	p a lʲ i t a ɫ o ɡʲ i j i j u
фургону	f u r ɡ o n u
волнении	v a ɫ nʲ e nʲ i i
сердцебиениями	sʲ i r t͡s i bʲ i j e nʲ i j a mʲ i
распишите	r a s pʲ i ʂ i tʲ e
выворачиваете	v i v a r a t͡ɕ i v a j i tʲ e
радиями	r a dʲ i j a mʲ i
выражен	v i r a ʐ i n
чернью	t͡ɕ e r nʲ j u
уставу	u s t a v u
соизволением	s a i z v a lʲ e nʲ i j i m
предприимайте	p rʲ i t p rʲ i i m a j tʲ e
завязло	z a vʲ a z ɫ a
раздельно	r a zʲ dʲ e lʲ n a
хуёвина	x u j o vʲ i n a
олимпийкою	a lʲ i m ⁽ʲ ⁾ pʲ i j k a j u
загорались	z a ɡ a r a lʲ i sʲ
сформулировал	s f a r m u lʲ i r a v a ɫ
ринусь	rʲ i n u sʲ
кровавил	k r a v a vʲ i ɫ
вскинул	f s kʲ i n u ɫ
обуславливаем	a b u s ɫ a v lʲ i v a j i m
говоруне	ɡ a v a r u nʲ e
переболевала	pʲ i rʲ i b a lʲ i v a ɫ a
литов	lʲ i t a f
выбравши	v i b r a f ʂ i
елям	j e lʲ a m
просиживая	p r a sʲ i ʐ i v a j a
съязвил	s j i z vʲ i ɫ
пырнёшь	p i r nʲ o ʂ
лепетать	lʲ i pʲ i t a tʲ
лень	lʲ e nʲ
лесокатки	lʲ e s a k a t kʲ i
полонян	p a ɫ a nʲ a n
взмолились	v z m a lʲ i lʲ i sʲ
должные	d o ɫ ʐ n i j e
высокохудожественный	v i s a k a x u d o ʐ i s t vʲ i n i j
захлопнитесь	z a x ɫ o p nʲ i tʲ i sʲ
осечётесь	a sʲ i t͡ɕ o tʲ i sʲ
алкаете	a ɫ k a j i tʲ e
африкандерах	a f rʲ i k a n d i r a x
дающийся	d a j u ɕː i j sʲ a
вытворяешь	v i t v a rʲ a j i ʂ
стар	s t a r
защитим	z a ɕː i tʲ i m
поведываете	p a vʲ e d i v a j i tʲ e
пригибают	p rʲ i ɡʲ i b a j u t
сигало	sʲ i ɡ a ɫ a
опаску	a p a s k u
усилителю	u sʲ i lʲ i tʲ i lʲ u
тамильским	t a mʲ i lʲ s kʲ i m
амбра	a m b r a
мытарствами	m i t a r s t v a mʲ i
контузим	k a n t u zʲ i m
разговорчиками	r a z ɡ a v o r t͡ɕ i k a mʲ i
подкузьмит	p a t k u zʲ mʲ i t
поощряв	p a a ɕː rʲ a f
вжимались	v ʐ i m a lʲ i sʲ
патронажах	p a t r a n a ʐ a x
подвозите	p a d v o zʲ i tʲ e
пиздючествах	pʲ i zʲ dʲ u t͡ɕ i s t v a x
обветренный	a b vʲ e t rʲ i n i j
огорчав	a ɡ a r t͡ɕ a f
транспортам	t r a n s p a r t a m
подделывали	p a dʲ e ɫ i v a lʲ i
обретайтесь	a b rʲ i t a j tʲ i sʲ
затмениях	z a t mʲ e nʲ i j a x
катране	k a t r a nʲ e
снашивала	s n a ʂ i v a ɫ a
смыкал	s m i k a ɫ
нахлынувший	n a x ɫ i n u f ʂ i j
сигналю	sʲ i ɡ n a lʲ u
отчаливала	a t͡ɕ a lʲ i v a ɫ a
поразительны	p a r a zʲ i tʲ i lʲ n i
разрешимый	r a z rʲ i ʂ i m i j
свешивайте	s vʲ e ʂ i v a j tʲ e
разрознивши	r a z r o zʲ nʲ i f ʂ i
устрашим	u s t r a ʂ i m
зажил	z a ʐ i ɫ
прилепляется	p rʲ i lʲ i p lʲ a j i t͡s a
заменялись	z a mʲ i nʲ a lʲ i sʲ
барина	b a rʲ i n a
ухаживавши	u x a ʐ i v a f ʂ i
расслабляться	r a s ɫ a b lʲ a t͡s a
затемняла	z a tʲ i m nʲ a ɫ a
налегке	n a lʲ i xʲ kʲ e
подводники	p a d v o dʲ nʲ i kʲ i
резюмировал	rʲ i zʲ u mʲ i r a v a ɫ
жидкостями	ʐ i t k a sʲ tʲ a mʲ i
разны	r a z n i
свинина	s vʲ i nʲ i n a
рисовал	rʲ i s a v a ɫ
ливийка	lʲ i vʲ i j k a
чохой	t͡ɕ i x o j
подъявши	p a d j a f ʂ i
лицензиар	lʲ i t͡s i n ⁽ʲ ⁾ zʲ i a r
интеллектами	i nʲ tʲ i lʲ e k t a mʲ i
причитают	p rʲ i t͡ɕ i t a j u t
отработайте	a t r a b o t a j tʲ e
пятёрках	pʲ i tʲ o r k a x
удостоверял	u d a s t a vʲ i rʲ a ɫ
дрессировок	d rʲ i sʲ i r o v a k
аллюзиями	a lʲ u zʲ i j a mʲ i
шумов	ʂ u m a f
отповедям	o t p a vʲ i dʲ a m
хачике	x a t͡ɕ i kʲ e
краба	k r a b a
кровоснабжение	k r a v a s n a b ʐ e nʲ i j e
вбегаю	v ⁽ʲ ⁾ bʲ i ɡ a j u
разъезжать	r a z j i ʐ a tʲ
проложивши	p r a ɫ a ʐ i f ʂ i
оскверняю	a s k vʲ i r nʲ a j u
задумках	z a d u m k a x
растопила	r a s t a pʲ i ɫ a
разразившись	r a z r a zʲ i f ʂ i sʲ
обнимусь	a b nʲ i m u sʲ
текил	tʲ i kʲ i ɫ
понудит	p a n u dʲ i t
просматриваете	p r a s m a t rʲ i v a j i tʲ e
самосвалах	s a m a s v a ɫ a x
вскриков	f s k rʲ i k a f
силиконы	sʲ i lʲ i k o n i
плевав	p lʲ i v a f
тыква	t i k v a
пальбой	p a lʲ b o j
распространяйся	r a s p r a s t r a nʲ a j sʲ a
варьируют	v a rʲ j i r u j u t
интриган	i n t rʲ i ɡ a n
видайся	vʲ i d a j sʲ a
засорю	z a s a rʲ u
просвещай	p r a s vʲ i ɕː a j
хуярил	x u j a rʲ i ɫ
священстве	s vʲ i ɕː e n s t vʲ e
завернуть	z a vʲ i r n u tʲ
поживавший	p a ʐ i v a f ʂ i j
адсорбируя	a t͡s s a r bʲ i r u j a
тавре	t a v rʲ e
умеет	u mʲ e j i t
заканчивала	z a k a nʲ t͡ɕ i v a ɫ a
оперативностью	a pʲ i r a tʲ i v n a sʲ tʲ j u
аэрограмм	a i r a ɡ r a m
пополнять	p a p a ɫ nʲ a tʲ
доросли	d a r a s ⁽ʲ ⁾ lʲ i
нелепицею	nʲ i lʲ e pʲ i t͡s i j u
полозьям	p a ɫ o zʲ j a m
врезаете	v rʲ i z a j i tʲ e
приятны	p rʲ i j a t n i
утопаем	u t o p a j i m
поели	p a j e lʲ i
поубавься	p a u b a f ⁽ʲ ⁾ sʲ a
манкой	m a n k a j
оспариваете	a s p a rʲ i v a j i tʲ e
втором	f t a r o m
садит	s a dʲ i t
опушавшись	a p u ʂ a f ʂ i sʲ
антидоте	a nʲ tʲ i d o tʲ e
рабский	r a p s kʲ i j
заработало	z a r a b o t a ɫ a
нива	nʲ i v a
позавидуйте	p a z a vʲ i d u j tʲ e
похищавший	p a xʲ i ɕː a f ʂ i j
отопим	a t o pʲ i m
комбинируешь	k a m ⁽ʲ ⁾ bʲ i nʲ i r u j i ʂ
сопроводишь	s a p r a v a dʲ i ʂ
заказчиков	z a k a ɕː i k a f
замочками	z a m o t͡ɕ k a mʲ i
рэпера	r e pʲ i r a
нормированиями	n a r mʲ i r a v a nʲ i j a mʲ i
кувшинку	k u f ʂ i n k u
досадовавший	d a s a d a v a f ʂ i j
орешь	o rʲ i ʂ
пригодность	p rʲ i ɡ o d n a sʲ tʲ
буквам	b u k v a m
козлищ	k o z ⁽ʲ ⁾ lʲ i ɕː
электроснабжениям	i lʲ e k t r a s n a b ʐ e nʲ i j a m
маневренностями	m a nʲ e v rʲ i n a sʲ tʲ a mʲ i
сыроваров	s i r a v a r a f
сигналимый	sʲ i ɡ n a lʲ i m i j
вложивший	v ɫ a ʐ i f ʂ i j
наладимся	n a ɫ a dʲ i m sʲ a
обугливала	a b u ɡ lʲ i v a ɫ a
залепляла	z a lʲ i p lʲ a ɫ a
атласов	a t ɫ a s a f
октябрь	a k tʲ a b rʲ
прожёвываемый	p r a ʐ o v i v a j i m i j
касайтесь	k a s a j tʲ i sʲ
дожах	d o ʐ a x
смотрят	s m o t rʲ a t
занято	z a nʲ i t a
женит	ʐ e nʲ i t
перевесила	pʲ i rʲ i vʲ e sʲ i ɫ a
неповторимостях	nʲ i p a f t a rʲ i m a sʲ tʲ a x
жёрнов	ʐ o r n a f
аравитянина	a r a vʲ i tʲ a nʲ i n a
отпугивало	a t p u ɡʲ i v a ɫ a
хлебнул	x lʲ i b n u ɫ
файликах	f a j lʲ i k a x
изобарою	i z a b a r a j u
тын	t i n
парейдолиею	p a rʲ i j d a lʲ i j i j u
очаг	a t͡ɕ a k
размежует	r a z mʲ i ʐ u j i t
опушайся	a p u ʂ a j sʲ a
разозлить	r a z a z ⁽ʲ ⁾ lʲ i tʲ
дорожкою	d a r o ʂ k a j u
военнослужащих	v a j e n a s ɫ u ʐ a ɕː i x
покупающий	p a k u p a j u ɕː i j
обрушивают	a b r u ʂ i v a j u t
милитаризируя	mʲ i lʲ i t a rʲ i zʲ i r u j a
подпорка	p a t p o r k a
предамся	p rʲ i d a m sʲ a
баклага	b a k ɫ a ɡ a
угасла	u ɡ a s ɫ a
категоричностей	k a tʲ i ɡ a rʲ i t͡ɕ n a sʲ tʲ i j
выводкам	v i v a t k a m
взвешивавши	v z vʲ e ʂ i v a f ʂ i
трахнуть	t r a x n u tʲ
крякав	k rʲ a k a f
декларировав	dʲ i k ɫ a rʲ i r a v a f
фляжек	f lʲ a ʐ i k
холмиками	x o ɫ mʲ i k a mʲ i
диску	dʲ i s k u
атавизмов	a t a vʲ i z m a f
вокале	v a k a lʲ e
опьянением	a p ⁽ʲ ⁾ j i nʲ e nʲ i j i m
дорожавши	d a r a ʐ a f ʂ i
узрю	u z rʲ u
обуздывают	a b u z d i v a j u t
изъехало	i z j e x a ɫ a
проиграешь	p r a i ɡ r a j i ʂ
божественны	b a ʐ e s t vʲ i n i
заверещи	z a vʲ i rʲ i ɕː i
наказаниями	n a k a z a nʲ i j a mʲ i
шорский	ʂ o r s kʲ i j
волноломы	v a ɫ n a ɫ o m i
палантине	p a ɫ a nʲ tʲ i nʲ e
производительности	p r a i z v a dʲ i tʲ i lʲ n a sʲ tʲ i
мессою	mʲ e s a j u
печатании	pʲ i t͡ɕ a t a nʲ i i
проговаривалось	p r a ɡ a v a rʲ i v a ɫ a sʲ
ботиночках	b a tʲ i n a t͡ɕ k a x
энергоносители	i n e r ɡ a n a sʲ i tʲ i lʲ i
пробоя	p r a b o j a
мякните	mʲ a k nʲ i tʲ e
погрешу	p a ɡ rʲ i ʂ u
угрях	u ɡ rʲ a x
усиженный	u sʲ i ʐ i n i j
увенчался	u vʲ i nʲ t͡ɕ a ɫ s ⁽ʲ ⁾ a
зажарят	z a ʐ a rʲ a t
вялостей	vʲ a ɫ a sʲ tʲ i j
промахах	p r o m a x a x
опером	o pʲ i r a m
заела	z a j e ɫ a
холостяке	x a ɫ a sʲ tʲ i kʲ e
котировать	k a tʲ i r a v a tʲ
адоптировавшийся	a d a p tʲ i r a v a f ʂ i j sʲ a
неустроенностям	nʲ i u s t r o j i n a sʲ tʲ a m
орграфами	a r ɡ r a f a mʲ i
табу	t a b u
подчёркивают	p a t͡ɕ o r kʲ i v a j u t
жанров	ʐ a n r a f
генетикам	ɡʲ i n e tʲ i k a m
ревизия	rʲ i vʲ i zʲ i j a
каскадам	k a s k a d a m
сослуживший	s a s ɫ u ʐ i f ʂ i j
вкладывают	f k ɫ a d i v a j u t
питону	pʲ i t o n u
родимся	r a dʲ i m sʲ a
диссонансами	dʲ i s a n a n s a mʲ i
искалечило	i s k a lʲ e t͡ɕ i ɫ a
неумерен	nʲ i u mʲ e rʲ i n
отмерит	a t mʲ e rʲ i t
уславший	u s ɫ a f ʂ i j
допускаетесь	d a p u s k a j i tʲ i sʲ
финансировало	fʲ i n a n ⁽ʲ ⁾ sʲ i r a v a ɫ a
общо	a p ɕː o
оросил	a r a sʲ i ɫ
вампирах	v a m ⁽ʲ ⁾ pʲ i r a x
ошибётесь	a ʂ i bʲ o tʲ i sʲ
выловят	v i ɫ a vʲ a t
мотайтесь	m a t a j tʲ i sʲ
наноса	n a n o s a
училкой	u t͡ɕ i ɫ k a j
присмотрев	p rʲ i s m a t rʲ e f
ворочающий	v a r o t͡ɕ i j u ɕː i j
богословы	b a ɡ a s ɫ o v i
взяточниках	v zʲ a t a t͡ɕ nʲ i k a x
расстилавши	r a sʲ tʲ i ɫ a f ʂ i
боронивши	b a r a nʲ i f ʂ i
прихватизацией	p rʲ i x v a tʲ i z a t͡s i j i j
подпрыгну	p a t p r i ɡ n u
перебираться	pʲ i rʲ i bʲ i r a t͡s a
нацеливаясь	n a t͡s e lʲ i v a j i sʲ
искорёжило	i s k a rʲ o ʐ i ɫ a
тварях	t v a rʲ a x
припарка	p rʲ i p a r k a
выказать	v i k a z a tʲ
стукаясь	s t u k a j i sʲ
колбасите	k a ɫ b a sʲ i tʲ e
донах	d o n a x
превозмогаешь	p rʲ i v a z m a ɡ a j i ʂ
отчисляем	a t͡ɕ i s ⁽ʲ ⁾ lʲ a j i m
выдачею	v i d a t͡ɕ i j u
леях	lʲ e j a x
ола	o ɫ a
красавчик	k r a s a f t͡ɕ i k
дорывавшийся	d a r i v a f ʂ i j sʲ a
прогудевший	p r a ɡ u dʲ e f ʂ i j
родословными	r a d a s ɫ o v n i mʲ i
околёсицах	a k a lʲ o sʲ i t͡s a x
бенгальский	bʲ i n ɡ a lʲ s kʲ i j
рогаликом	r a ɡ a lʲ i k a m
доняло	d o nʲ i ɫ a
молодят	m a ɫ a dʲ a t
устремив	u s t rʲ i mʲ i f
осматривавшийся	a s m a t rʲ i v a f ʂ i j sʲ a
астероидах	a s t i r o i d a x
урону	u r o n u
мистера	mʲ i s t i r a
потрохам	p a t r a x a m
беляев	bʲ i lʲ a j i f
мораторий	m a r a t o rʲ i j
подкормке	p a t k o r m kʲ e
заимеет	z a i mʲ e j i t
штрафовал	ʂ t r a f a v a ɫ
заутрень	z a u t rʲ i nʲ
слушанию	s ɫ u ʂ a nʲ i j u
ссужал	s u ʐ a ɫ
планированиям	p ɫ a nʲ i r a v a nʲ i j a m
придаваемый	p rʲ i d a v a j i m i j
оттянешь	a tʲː a nʲ i ʂ
сдавило	z d a vʲ i ɫ a
сковывай	s k o v i v a j
радары	r a d a r i
обсуждением	a p s u ʐ dʲ e nʲ i j i m
стрекозы	s t rʲ i k o z i
показываясь	p a k a z i v a j i sʲ
плетёмся	p lʲ i tʲ o m sʲ a
пуза	p u z a
стремянку	s t rʲ i mʲ a n k u
дубком	d u p k o m
стачкой	s t a t͡ɕ k a j
длительный	d lʲ i tʲ i lʲ n i j
времечке	v rʲ e mʲ i t͡ɕ kʲ e
эмиграциям	i mʲ i ɡ r a t͡s i j a m
понимаетесь	p a nʲ i m a j i tʲ i sʲ
присудим	p rʲ i s u dʲ i m
балдел	b a ɫ dʲ e ɫ
скорректировал	s k a rʲ i k tʲ i r a v a ɫ
искусите	i s k u sʲ i tʲ e
сплющивавший	s p lʲ u ɕː i v a f ʂ i j
свергала	s vʲ i r ɡ a ɫ a
трудовой	t r u d a v o j
заблагорассудим	z a b ɫ a ɡ a r a s u dʲ i m
пожелтеем	p a ʐ i ɫ tʲ e j i m
раскисла	r a s kʲ i s ɫ a
маникюра	m a nʲ i kʲ u r a
эполетом	i p a lʲ e t a m
бабульку	b a b u lʲ k u
высохнешь	v i s a x nʲ i ʂ
грузимый	ɡ r u zʲ i m i j
спарывали	s p a r i v a lʲ i
востоковедам	v a s t a k a vʲ e d a m
правобережный	p r a v a bʲ i rʲ e ʐ n i j
хусткою	x u s t k a j u
поразите	p a r a zʲ i tʲ e
апелляцию	a pʲ i lʲ a t͡s i j u
затаптывающий	z a t a p t i v a j u ɕː i j
жерлах	ʐ e r ɫ a x
добыть	d a b i tʲ
обозначься	a b a z n a t͡ɕ sʲ a
бесполезный	bʲ i s p a lʲ e z n i j
мнусь	m n u sʲ
полётом	p a lʲ o t a m
княжества	k nʲ a ʐ i s t v a
триатлонов	t rʲ i a t ɫ o n a f
выпрямлял	v i p rʲ i m lʲ a ɫ
разработалась	r a z r a b o t a ɫ a sʲ
вытряхнешь	v i t rʲ i x nʲ i ʂ
мензуре	mʲ i n z u rʲ e
ватка	v a t k a
пестуйте	pʲ e s t u j tʲ e
чекать	t͡ɕ i k a tʲ
именуй	i mʲ i n u j
окрылили	a k r i lʲ i lʲ i
садку	s a t k u
нарвусь	n a r v u sʲ
картинно	k a r tʲ i n a
выправляйте	v i p r a v lʲ a j tʲ e
оробевший	a r a bʲ e f ʂ i j
окошечек	a k o ʂ i t͡ɕ i k
дугу	d u ɡ u
заколебать	z a k a lʲ i b a tʲ
разживалась	r a ʐ i v a ɫ a sʲ
ворвитесь	v a r vʲ i tʲ i sʲ
зачарует	z a t͡ɕ i r u j i t
блядовало	b lʲ i d a v a ɫ a
задремлют	z a d rʲ e m lʲ u t
раскраской	r a s k r a s k a j
обилие	a bʲ i lʲ i j e
баловал	b a ɫ a v a ɫ
дарвиниста	d a r vʲ i nʲ i s t a
курский	k u r s kʲ i j
баллончик	b a ɫ o nʲ t͡ɕ i k
неявкой	nʲ i j a f k a j
гувернантку	ɡ u vʲ i r n a n t k u
бризантностях	b rʲ i z a n t n a sʲ tʲ a x
сгруппировалась	z ɡ r u pʲ i r a v a ɫ a sʲ
отношению	a t n a ʂ e nʲ i j u
дружила	d r u ʐ i ɫ a
контроллера	k a n t r o lʲ i r a
варшавянин	v a r ʂ a vʲ a nʲ i n
клонись	k ɫ a nʲ i sʲ
льнам	lʲ n a m
абсолютистах	a p s a lʲ u tʲ i s t a x
сбербанки	z bʲ i r b a n kʲ i
открыткам	a t k r i t k a m
фурункулами	f u r u n k u ɫ a mʲ i
людоеде	lʲ u d a j e dʲ e
испустить	i s p u sʲ tʲ i tʲ
соломами	s a ɫ o m a mʲ i
доме	d o mʲ e
пристрастимся	p rʲ i s t r a sʲ tʲ i m sʲ a
оканчивавшись	a k a nʲ t͡ɕ i v a f ʂ i sʲ
упокоении	u p a k a j e nʲ i i
набирав	n a bʲ i r a f
жутями	ʐ u tʲ a mʲ i
удавался	u d a v a ɫ s ⁽ʲ ⁾ a
тупишь	t u pʲ i ʂ
прославляйтесь	p r a s ɫ a v lʲ a j tʲ i sʲ
ложечек	ɫ o ʐ i t͡ɕ i k
навязаешь	n a vʲ i z a j i ʂ
искупления	i s k u p lʲ e nʲ i j a
поджидала	p a d͡ʐ ʐ i d a ɫ a
библиотекарша	bʲ i b lʲ i a tʲ e k a r ʂ a
сраженью	s r a ʐ e nʲ j u
кошелях	k a ʂ i lʲ a x
вкалывая	f k a ɫ i v a j a
сливами	s ⁽ʲ ⁾ lʲ i v a mʲ i
полутьмах	p a ɫ u tʲ m a x
куркумы	k u r k u m i
выдают	v i d a j u t
просчётах	p r a ɕː o t a x
хозяева	x a zʲ a j i v a
клеивший	k lʲ e i f ʂ i j
корням	k a r nʲ a m
перелагала	pʲ i rʲ i ɫ a ɡ a ɫ a
замере	z a mʲ e rʲ e
путаюсь	p u t a j u sʲ
проектировщики	p r a i k tʲ i r o f ɕː i kʲ i
барахтайся	b a r a x t a j sʲ a
руконожках	r u k a n o ʂ k a x
разведка	r a z vʲ e t k a
наворачивает	n a v a r a t͡ɕ i v a j i t
клади	k ɫ a dʲ i
перестройка	pʲ i rʲ i s t r o j k a
скелеты	s kʲ i lʲ e t i
появиться	p a j i vʲ i t͡s a
совратили	s a v r a tʲ i lʲ i
мановении	m a n a vʲ e nʲ i i
диагнозу	dʲ i a ɡ n a z u
матрасами	m a t r a s a mʲ i
лежанки	lʲ i ʐ a n kʲ i
вкладе	f k ɫ a dʲ e
отъедешь	a t j e dʲ i ʂ
лесоматериалам	lʲ e s a m a tʲ i rʲ i a ɫ a m
задремлешь	z a d rʲ e m lʲ i ʂ
промахивался	p r a m a xʲ i v a ɫ s ⁽ʲ ⁾ a
связисте	s vʲ i zʲ i sʲ tʲ e
вклинивавшийся	f k lʲ i nʲ i v a f ʂ i j sʲ a
нынешний	n i nʲ i ʂ nʲ i j
заявительнице	z a j i vʲ i tʲ i lʲ nʲ i t͡s i
привяжу	p rʲ i vʲ i ʐ u
деспотами	dʲ e s p a t a mʲ i
примеряйтесь	p rʲ i mʲ e rʲ i j tʲ i sʲ
выявишься	v i j i vʲ i ʂ sʲ a
талый	t a ɫ i j
долбануть	d a ɫ b a n u tʲ
управляетесь	u p r a v lʲ a j i tʲ i sʲ
левизною	lʲ i vʲ i z n o j u
проебём	p r a j i bʲ o m
пропитаниях	p r a pʲ i t a nʲ i j a x
отворяв	a t v a rʲ a f
просрочке	p r a s r o t͡ɕ kʲ e
мясорубками	mʲ i s a r u p k a mʲ i
литром	lʲ i t r a m
районах	r a j o n a x
смешались	s mʲ i ʂ a lʲ i sʲ
нагревают	n a ɡ rʲ i v a j u t
зонтами	z a n t a mʲ i
зарвёшься	z a r vʲ o ʂ sʲ a
укутавши	u k u t a f ʂ i
дынями	d i nʲ a mʲ i
мудоёба	m u d a j o b a
маркировками	m a r kʲ i r o f k a mʲ i
выдумками	v i d u m k a mʲ i
подстраховал	p a t͡s s t r a x a v a ɫ
обзвонит	a b z v a nʲ i t
адмотделом	a d m a dʲ e ɫ a m
натянешься	n a tʲ a nʲ i ʂ sʲ a
лейкозом	lʲ i j k o z a m
установит	u s t a n o vʲ i t
совершатся	s a vʲ i r ʂ a t͡s a
десятиугольнику	dʲ i sʲ i tʲ i u ɡ o lʲ nʲ i k u
подставке	p a t͡s s t a f kʲ e
упрятав	u p rʲ a t a f
заглохший	z a ɡ ɫ o x ʂ i j
жадала	ʐ a d a ɫ a
фальшивите	f a lʲ ʂ i vʲ i tʲ e
родильный	r a dʲ i lʲ n i j
сгрудись	z ɡ r u dʲ i sʲ
проституции	p r a sʲ tʲ i t u t͡s i i
всевозможна	f sʲ i v a z m o ʐ n a
подушечка	p a d u ʂ i t͡ɕ k a
провзаимодействуешь	p r a v z a i m a dʲ e j s t v u j i ʂ
щитках	ɕː i t k a x
недоедавший	nʲ i d a j i d a f ʂ i j
чунями	t͡ɕ u nʲ a mʲ i
чревами	t͡ɕ rʲ e v a mʲ i
запросят	z a p r o sʲ a t
клипа	k lʲ i p a
лженаука	ɫ ʐ i n a u k a
приостанавливающийся	p rʲ i a s t a n a v lʲ i v a j u ɕː i j sʲ a
предприемлете	p rʲ i t p rʲ i j e m lʲ i tʲ e
брайан	b r a j i n
выселишь	v i sʲ i lʲ i ʂ
вёзся	vʲ o sʲ a
решавши	rʲ i ʂ a f ʂ i
учует	u t͡ɕ u j i t
одинока	a dʲ i n o k a
сумасброды	s u m a z b r o d i
армянофобе	a r mʲ a n a f o bʲ e
выдавливая	v i d a v lʲ i v a j a
бомбардировка	b a m b a r dʲ i r o f k a
преломлял	p rʲ i ɫ a m lʲ a ɫ
назначит	n a z n a t͡ɕ i t
задаюсь	z a d a j u sʲ
дотаскаешь	d a t a s k a j i ʂ
плацах	p ɫ a t͡s a x
котелки	k a tʲ i ɫ kʲ i
складен	s k ɫ a dʲ i n
крепчают	k rʲ i p t͡ɕ a j u t
придерусь	p rʲ i dʲ i r u sʲ
изящный	i zʲ a ɕː n i j
разобьёшься	r a z a b ⁽ʲ ⁾ j o ʂ sʲ a
мирив	mʲ i rʲ i f
типажах	tʲ i p a ʐ a x
хламы	x ɫ a m i
подвыло	p a d v i ɫ a
ангстрем	a n k s t r i m
преуспеете	p rʲ i u s pʲ e j i tʲ e
волжан	v a ɫ ʐ a n
швартуете	ʂ v a r t u j i tʲ e
лодыря	ɫ o d i rʲ a
рассказикам	r a s k a zʲ i k a m
толщами	t o ɫ ɕː a mʲ i
переступавший	pʲ i rʲ i s t u p a f ʂ i j
амбарный	a m b a r n i j
жестокий	ʐ i s t o kʲ i j
энцефалитах	i n t͡s i f a lʲ i t a x
посвистывали	p a s vʲ i s t i v a lʲ i
лысиной	ɫ i sʲ i n a j
заявляешь	z a j i v lʲ a j i ʂ
тропинок	t r a pʲ i n a k
нагрузка	n a ɡ r u s k a
беспокоить	bʲ i s p a k o i tʲ
удочерениях	u d a t͡ɕ i rʲ e nʲ i j a x
баловнике	b a ɫ a v nʲ i kʲ e
азиками	a zʲ i k a mʲ i
привинти	p rʲ i vʲ i nʲ tʲ i
синхронизаций	sʲ i n x r a nʲ i z a t͡s i j
объявлений	a b j i v lʲ e nʲ i j
помышляем	p a m i ʂ lʲ a j i m
каске	k a s kʲ e
разбушевались	r a z b u ʂ i v a lʲ i sʲ
остригавшись	a s t rʲ i ɡ a f ʂ i sʲ
заносу	z a n o s u
заржаветь	z a r ʐ a vʲ i tʲ
отлежалась	a t lʲ i ʐ a ɫ a sʲ
осязает	a sʲ i z a j i t
девайсам	dʲ i v a j s a m
пирофорами	pʲ i r a f o r a mʲ i
дублин	d u b lʲ i n
допустимость	d a p u sʲ tʲ i m a sʲ tʲ
обережённый	a bʲ i rʲ i ʐ o n i j
дрожанию	d r a ʐ a nʲ i j u
эликсиром	i lʲ i k sʲ i r a m
запричитаешь	z a p rʲ i t͡ɕ i t a j i ʂ
взмётываемый	v z mʲ o t i v a j i m i j
откраиваешь	a t k r a i v a j i ʂ
пионеру	pʲ i a nʲ e r u
однородностям	a d n a r o d n a sʲ tʲ a m
акойт	a k o j t
рогоносце	r a ɡ a n o s t͡s i
дотаскав	d a t a s k a f
обжа	o b ʐ a
обесчещивает	a bʲ i ɕ t͡ɕ e ɕː i v a j i t
завершало	z a vʲ i r ʂ a ɫ a
спрячьтесь	s p rʲ a t͡ɕ tʲ i sʲ
сетованию	sʲ e t a v a nʲ i j u
кормёжками	k a r mʲ o ʂ k a mʲ i
твой	t v o j
исполкому	i s p a ɫ k o m u
истребишь	i s t rʲ i bʲ i ʂ
нику	nʲ i k u
разъяряете	r a z j i rʲ a j i tʲ e
анахоретов	a n a x a rʲ e t a f
