холандски	x o ɫ a n t s kʲ i
литература	lʲ i t ɛ r ɐ t u r ɐ
браташ	b r ɐ t a ʃ
овластителен	o v ɫ ɐ s t i t ɛ lʲ ɛ n
родител	r o d i t ɛ ɫ
осип	ɔ s i p
лабилен	ɫ ɐ b i lʲ ɛ n
причина	p r i t͡ʃ i n ɐ
саламандър	s ɐ ɫ ɐ m a n d ɐ r
изплаша	i s p ɫ a ʃ ɐ
ветрилник	v ɛ t r i ɫ n i k
легла	lʲ ɛ ɡ ɫ a
лакът	ɫ a k ɐ t
липа	lʲ i p a
съзра	s ɐ z r ɤ
гърне	ɡ ɐ r n ɛ
сервитьор	s ɛ r v i tʲ ɔ r
кръсточовка	k r ɐ s t o t͡ʃ ɔ f k ɐ
тревист	t r ɛ v i s t
арамия	ɐ r ɐ m i j ɐ
мренията	m r ɛ n i j ɐ t ɐ
кубатура	k u b ɐ t u r ɐ
чупя	t͡ʃ u pʲ ɐ
нито	n i t o
пърдя	p ɐ r dʲ a
състояние	s ɐ s t o j a n i ɛ
викам	v i k ɐ m
борец	b o r ɛ t͡s
мерзък	m ɛ r z ɐ k
хидроелектричен	xʲ i d r o ɛ lʲ ɛ k t r i t͡ʃ ɛ n
науча	n ɐ u t͡ʃ ɐ
внимателно	v n i m a t ɛ ɫ n o
диона	d i ɔ n ɐ
координационен	k o o r d i n ɐ t͡s i ɔ n ɛ n
артикулационен	ɐ r t i k u ɫ ɐ t͡s i ɔ n ɛ n
тишина	t i ʃ i n a
иман	i m ɐ n
пренасям	p r ɛ n a sʲ ɐ m
събудя	s ɐ b u dʲ ɐ
хомосексуалистка	x ɔ m o s ɛ k s u ɐ lʲ i s k ɐ
морелетник	m o r ɛ lʲ ɛ t n i k
панпсихизъм	p ɐ n p s i xʲ i z ɐ m
революция	r ɛ v o lʲ u t͡s i j ɐ
женски	ʒ ɛ n s kʲ i
обещавам	o b ɛ ʃ t a v ɐ m
интернет	i n t ɛ r n ɛ t
пушене	p u ʃ ɛ n ɛ
абанос	ɐ b ɐ n ɔ s
кои	k o i
без	b ɛ s
улица	u lʲ i t͡s ɐ
знаме	z n a m ɛ
вашта	v a ʃ t ɐ
фенер	f ɛ n ɛ r
че	t͡ʃ ɛ
туркменистан	t u r k m ɛ n i s t a n
къжлица	k ɐ ʒ lʲ i t͡s ɐ
икономически	i k o n o m i t͡ʃ ɛ s kʲ i
узаконявала	u z ɐ k o nʲ a v ɐ ɫ ɐ
бида	b i d ɐ
материя	m ɐ t ɛ r i j ɐ
узаконява	u z ɐ k o nʲ a v ɐ
изгледам	i z ɡ lʲ ɛ d ɐ m
узаконяваха	u z ɐ k o nʲ a v ɐ x ɐ
козодой	k o z o d ɔ j
присое	p r i s ɔ ɛ
прекаля	p r ɛ k ɐ lʲ ɤ
витег	v i t ɛ k
низина	n i z i n a
климатик	k lʲ i m ɐ t i k
навътре	n ɐ v ɤ t r ɛ
хлабав	x ɫ ɐ b a f
мезе	m ɛ z ɛ
биха	b i x ɐ
пернат	p ɛ r n a t
щелите	ʃ t ɛ lʲ i t ɛ
например	n ɐ p r i m ɛ r
гъркиня	ɡ ɐ r kʲ i nʲ ɐ
зрян	z rʲ a n
лавка	ɫ a f k ɐ
течен	t ɛ t͡ʃ ɛ n
телесен	t ɛ lʲ ɛ s ɛ n
андора	ɐ n d ɔ r ɐ
бегъл	b ɛ ɡ ɐ ɫ
стръмнина	s t r ɐ m n i n a
разсед	r ɐ s s ɛ t
работилница	r ɐ b o t i ɫ n i t͡s ɐ
набожен	n ɐ b ɔ ʒ ɛ n
спален	s p a lʲ ɛ n
сочен	s ɔ t͡ʃ ɛ n
съобщавам	s ɐ o p ʃ t a v ɐ m
обоснова	o b o s n o v a
над	n a t
нанасям	n ɐ n a sʲ ɐ m
върху	v ɐ r x u
плевен	p lʲ ɛ v ɛ n
яйчен	j a j t͡ʃ ɛ n
продавач	p r o d ɐ v a t͡ʃ
друг	d r u k
назад	n ɐ z a t
синкав	s i n k ɐ f
съветвам	s ɐ v ɛ t v ɐ m
драка	d r a k ɐ
ропот	r ɔ p o t
мамин	m a m i n
немощност	n ɛ m o ʃ n o s t
цезий	t͡s ɛ z i
зъл	z ɤ ɫ
начало	n ɐ t͡ʃ a ɫ o
надебелявам	n ɐ d ɛ b ɛ lʲ a v ɐ m
цупят	t͡s u pʲ ɐ t
ездачка	ɛ z d a t͡ʃ k ɐ
наведе	n ɐ v ɛ d ɛ
ябълка	j a b ɐ ɫ k ɐ
петдесет	p ɛ d d ɛ s ɛ t
любопитство	lʲ u b o p i t s t v o
самарий	s ɐ m a r i
тука	t u k ɐ
хербарий	xʲ ɛ r b a r i
принцеса	p r i n t͡s ɛ s ɐ
абатския	ɐ b a t s kʲ i j ɐ
глобя	ɡ ɫ o bʲ ɤ
протека	p r o t ɛ k ɤ
скрия	s k r i j ɐ
ценен	t͡s ɛ n ɛ n
чучулига	t͡ʃ u t͡ʃ u lʲ i ɡ ɐ
мухоловка	m u x o ɫ ɔ f k ɐ
париж	p ɐ r i ʃ
примирам	p r i m i r ɐ m
течение	t ɛ t͡ʃ ɛ n i ɛ
галба	ɡ ɐ ɫ b a
щирица	ʃ t i r i t͡s ɐ
лакей	ɫ ɐ kʲ ɛ j
узаконявано	u z ɐ k o nʲ a v ɐ n o
глагол	ɡ ɫ ɐ ɡ ɔ ɫ
цирей	t͡s i r ɛ j
число	t͡ʃ i s ɫ ɔ
турция	t u r t͡s i j ɐ
окажа	o k a ʒ ɐ
поставя	p o s t a vʲ ɐ
въстание	v ɐ s t a n i ɛ
художник	x u d ɔ ʒ n i k
доверчив	d o v ɛ r t͡ʃ i f
чешма	t͡ʃ ɛ ʃ m a
дебна	d ɛ b n a
пасящ	p ɐ sʲ a ʃ t
боя	b o j a
успех	u s p ɛ x
горист	ɡ o r i s t
катерица	k a t ɛ r i t͡s ɐ
започвам	z ɐ p ɔ t͡ʃ v ɐ m
направям	n ɐ p r a vʲ ɐ m
абдукция	ɐ b d u k t͡s i j ɐ
лоуренсий	ɫ o u r ɛ n s i
стигна	s t i ɡ n ɐ
трепетлика	t r ɛ p ɛ t lʲ i k ɐ
доведе	d o v ɛ d ɛ
миров	m i r o f
видра	v i d r ɐ
стисна	s t i s n ɐ
брегове	b r ɛ ɡ o v ɛ
озаглавявам	o z ɐ ɡ ɫ ɐ vʲ a v ɐ m
врабче	v r ɐ p t͡ʃ ɛ
светлосянка	s v ɛ t ɫ o sʲ a n k ɐ
кланица	k ɫ a n i t͡s ɐ
щастие	ʃ t a s t i ɛ
получавам	p o ɫ u t͡ʃ a v ɐ m
живот	ʒ i v ɔ t
аджемилъшки	ɐ d ʒ ɛ m i ɫ ɤ ʃ kʲ i
повторно	p o f t ɔ r n o
превзема	p r ɛ v z ɛ m ɐ
проститутка	p r o s t i t u t k ɐ
близък	b lʲ i z ɐ k
крехък	k r ɛ x ɐ k
изпявам	i s pʲ a v ɐ m
аллах	ɐ ɫ ɫ a x
орден	ɔ r d ɛ n
сивкав	s i f k ɐ f
оставка	o s t a f k ɐ
определено	o p r ɛ d ɛ lʲ ɛ n o
модел	m o d ɛ ɫ
ментовка	m ɛ n t ɔ f k ɐ
извлека	i z v lʲ ɛ k ɤ
щя	ʃ tʲ a
към	k ɤ m
чавка	t͡ʃ a f k ɐ
дневен	d n ɛ v ɛ n
липък	lʲ i p ɐ k
принуждавам	p r i n u ʒ d a v ɐ m
джунгла	d ʒ u n ɡ ɫ ɐ
грохот	ɡ r ɔ x o t
случаен	s ɫ u t͡ʃ ɐ ɛ n
ароматен	ɐ r o m a t ɛ n
неизвестен	n ɛ i z v ɛ s t ɛ n
лев	lʲ ɛ f
личба	lʲ i d͡ʒ b ɐ
правилник	p r a v i ɫ n i k
непрекъснато	n ɛ p r ɛ k ɤ s n ɐ t o
пиколитър	p i k o lʲ i t ɐ r
страница	s t r a n i t͡s ɐ
лят	lʲ a t
киноцентрове	kʲ i n o t͡s ɛ n t r o v ɛ
почитаем	p o t͡ʃ i t a ɛ m
поради	p o r ɐ d i
развитие	r ɐ z v i t i ɛ
мързел	m ɤ r z ɛ ɫ
ателие	ɐ t ɛ lʲ i ɛ
кое	k o ɛ
платя	p ɫ ɐ tʲ ɤ
идентификационен	i d ɛ n t i f i k ɐ t͡s i ɔ n ɛ n
изкуство	i s k u s t v o
ясминов	j ɐ s m i n o f
оногова	o n o ɡ ɔ v ɐ
подвързия	p o d v ɐ r z i j ɐ
втрисане	f t r i s ɐ n ɛ
високо	v i s ɔ k o
цербер	t͡s ɛ r b ɛ r
пощаджия	p ɔ ʃ t ɐ d ʒ i j ɐ
печален	p ɛ t͡ʃ a lʲ ɛ n
въдя	v ɤ dʲ ɐ
изневяра	i z n ɛ vʲ a r ɐ
брания	b r a n i j ɐ
първи	p ɤ r v i
абонат	a b o n a t
ръководител	r ɐ k o v o d i t ɛ ɫ
превозен	p r ɛ v o z ɛ n
бъбрек	b ɤ b r ɛ k
стрела	s t r ɛ ɫ a
навра	n ɐ v r ɤ
зарист	z ɐ r i s t
престол	p r ɛ s t ɔ ɫ
улей	u lʲ ɛ j
албания	ɐ ɫ b a n i j ɐ
простак	p r o s t a k
върша	v ɐ r ʃ a
неутрален	n ɛ u t r a lʲ ɛ n
занимая	z ɐ n i m a j ɐ
абдикиралия	ɐ b d i kʲ i r ɐ lʲ i j ɐ
забитък	z ɐ b i i t ɐ k
ама	a m ɐ
как	k a k
декември	d ɛ kʲ ɛ m v r i
упова	u p o v a
канарче	k ɐ n a r t͡ʃ ɛ
камила	k ɐ m i ɫ ɐ
благодаря	b ɫ ɐ ɡ o d ɐ rʲ ɤ
бисмут	b i s m u t
забождам	z ɐ b ɔ ʒ d ɐ m
минск	m i n s k
изпея	i s p ɛ j ɐ
взрив	v z r i f
силно	s i ɫ n o
попичам	p o p i t͡ʃ ɐ m
аглика	ɐ ɡ lʲ i k ɐ
цица	t͡s i t͡s ɐ
стреме	s t r ɛ m ɛ
пшеница	p ʃ ɛ n i t͡s ɐ
нивье	n i vʲ ɛ
абсолютен	ɐ p s o lʲ u t ɛ n
имах	i m a x
селекционен	s ɛ lʲ ɛ k t͡s i ɔ n ɛ n
чуващ	t͡ʃ u v ɐ ʃ t
слава	s ɫ a v ɐ
лае	ɫ a ɛ
откъслек	o t k ɤ s lʲ ɛ k
жалък	ʒ a ɫ ɐ k
иск	i s k
кат	k a t
губя	ɡ u bʲ ɐ
стратегичен	s t r ɐ t ɛ ɡʲ i t͡ʃ ɛ n
нов	n ɔ f
смрад	s m r a t
ухапя	u x a pʲ ɐ
хамбургер	x a m b u r ɡʲ ɛ r
певец	p ɛ v ɛ t͡s
кроя	k r o j ɤ
крава	k r a v ɐ
ему	ɛ m u
мускулен	m u s k u lʲ ɛ n
юфка	j u f k ɐ
ловец	ɫ o v ɛ t͡s
мръсен	m r ɤ s ɛ n
то	t ɔ
гангстер	ɡ a n k s t ɛ r
кур	k u r
страхливец	s t r ɐ x lʲ i v ɛ t͡s
тънък	t ɤ n ɐ k
чай	t͡ʃ a j
онакава	o n ɐ k a v ɐ
мобилизационен	m o b i lʲ i z ɐ t͡s i ɔ n ɛ n
мойто	m ɔ j t o
отговорност	o d ɡ o v ɔ r n o s t
явен	j a v ɛ n
вземам	v z ɛ m ɐ m
тимар	t i m a r
алчба	a ɫ d͡ʒ b ɐ
югоизток	j u ɡ o i s t o k
немкиня	n ɛ m kʲ i nʲ ɐ
спогодба	s p o ɡ ɔ d b ɐ
проследяем	p r o s lʲ ɛ dʲ a ɛ m
светлана	s v ɛ t ɫ a n ɐ
опера	ɔ p ɛ r ɐ
черква	t͡ʃ ɛ r k v ɐ
край	k r a j
калий	k a lʲ i
боде	b o d ɛ
сияй	s i j a j
комар	k o m a r
околен	o k ɔ lʲ ɛ n
облаче	ɔ b ɫ ɐ t͡ʃ ɛ
абсолютизъм	ɐ p s o lʲ u t i z ɐ m
мозък	m ɔ z ɐ k
паткан	p ɐ t k a n
представям	p r ɛ t s t a vʲ ɐ m
глобявам	ɡ ɫ o bʲ a v ɐ m
брега	b r ɛ ɡ a
център	t͡s ɛ n t ɐ r
арестувахте	a r ɛ s t u v a x t ɛ
аджемия	ɐ d ʒ ɛ m i j ɐ
малки	m a ɫ kʲ i
изваждам	i z v a ʒ d ɐ m
информационен	i n f o r m ɐ t͡s i ɔ n ɛ n
холмий	x ɔ ɫ m i
моите	m ɔ i t ɛ
лекарствен	lʲ ɛ k a r s t v ɛ n
какъвто	k ɐ k ɤ f t o
алка	a ɫ k ɐ
монголия	m o n ɡ ɔ lʲ i j ɐ
бижу	b i ʒ u
аерофлот	ɐ ɛ r o f ɫ ɔ t
чичопей	t͡ʃ i t͡ʃ o p ɛ j
месо	m ɛ s ɔ
пита	p i t a
позитрон	p o z i t r ɔ n
североизток	s ɛ v ɛ r o i s t o k
узаконили	u z ɐ k o n i lʲ i
пък	p ɤ k
водоскок	v o d o s k ɔ k
социален	s o t͡s i a lʲ ɛ n
пръч	p r ɤ t͡ʃ
откажа	o t k a ʒ ɐ
усещам	u s ɛ ʃ t ɐ m
абдикирайте	ɐ b d i kʲ i r ɐ j t ɛ
дъх	d ɤ x
такива	t ɐ kʲ i v ɐ
запад	z a p ɐ t
узаконявалия	u z ɐ k o nʲ a v ɐ lʲ i j ɐ
гуждам	ɡ u ʒ d ɐ m
гаяче	ɡ ɐ j a t͡ʃ ɛ
анатомичен	ɐ n ɐ t o m i t͡ʃ ɛ n
изслушам	i s ɫ u ʃ ɐ m
съд	s ɤ t
молитва	m o lʲ i t v ɐ
представа	p r ɛ t s t a v ɐ
почивка	p o t͡ʃ i f k ɐ
конопарче	k o n o p a r t͡ʃ ɛ
езичен	ɛ z i t͡ʃ ɛ n
кутсуз	k u t s u s
ливада	lʲ i v a d ɐ
елемент	ɛ lʲ ɛ m ɛ n t
вървите	v ɐ r v i t ɛ
гробище	ɡ r ɔ b i ʃ t ɛ
мажете	m a ʒ ɛ t ɛ
аквариум	ɐ k v a r i u m
декларация	d ɛ k ɫ ɐ r a t͡s i j ɐ
склонен	s k ɫ ɔ n ɛ n
препека	p r ɛ p ɛ k ɤ
сума	s u m ɐ
джазов	d ʒ a z o f
белодробен	b ɛ ɫ o d r ɔ b ɛ n
авторитарен	ɐ f t o r i t a r ɛ n
съгласен	s ɐ ɡ ɫ a s ɛ n
върволяк	v ɐ r v o lʲ a k
звучен	z v u t͡ʃ ɛ n
сингапур	s i n ɡ ɐ p u r
сън	s ɤ n
абсурдност	ɐ p s u r d n o s t
словения	s ɫ o v ɛ n i j ɐ
тъкан	t ɐ k a n
рай	r a j
зрял	z rʲ a ɫ
пя	pʲ a
панкреатит	p ɐ n k r ɛ ɐ t i t
хладък	x ɫ a d ɐ k
моден	m ɔ d ɛ n
резба	r ɛ z b a
добре	d o b r ɛ
породист	p o r o d i s t
южняшки	j u ʒ nʲ a ʃ kʲ i
легален	lʲ ɛ ɡ a lʲ ɛ n
скопие	s k ɔ p i ɛ
списание	s p i s a n i ɛ
алармен	ɐ ɫ a r m ɛ n
резка	r ɛ s k a
кола	k o ɫ a
възголям	v ɐ z ɡ o lʲ a m
кюлоти	kʲ u ɫ ɔ t i
хамбар	x ɐ m b a r
зърнест	z ɤ r n ɛ s t
изтребвам	i s t r ɛ b v ɐ m
технически	t ɛ x n i t͡ʃ ɛ s kʲ i
нос	n ɔ s
адаптационен	ɐ d ɐ p t ɐ t͡s i ɔ n ɛ n
възсин	v ɐ s s i n
хроничен	x r o n i t͡ʃ ɛ n
сладост	s ɫ a d o s t
побеждавам	p o b ɛ ʒ d a v ɐ m
прага	p r a ɡ ɐ
едноличен	ɛ d n o lʲ i t͡ʃ ɛ n
подпиша	p o t p i ʃ ɐ
жътва	ʒ ɤ t v ɐ
творба	t v o r b a
бих	b i x
височина	v i s o t͡ʃ i n a
децилитър	d ɛ t͡s i lʲ i t ɐ r
леджа	lʲ ɛ d ʒ ɐ
прекарам	p r ɛ k a r ɐ m
синхронизационен	s i n x r o n i z ɐ t͡s i ɔ n ɛ n
наредба	n ɐ r ɛ d b ɐ
прахоляк	p r ɐ x o lʲ a k
щателен	ʃ t a t ɛ lʲ ɛ n
зло	z ɫ ɔ
самун	s ɐ m u n
кожа	k ɔ ʒ ɐ
бахър	b a x ɐ r
негово	n ɛ ɡ o v o
кражба	k r a ʒ b ɐ
сянка	sʲ a n k ɐ
лутеций	ɫ u t ɛ t͡s i
яденета	j a d ɛ n ɛ t ɐ
яд	j a t
реклама	r ɛ k ɫ a m ɐ
благаш	b ɫ ɐ ɡ a ʃ
кълва	k ɐ ɫ v a
ангелина	ɐ n ɡʲ ɛ lʲ i n ɐ
издател	i z d a t ɛ ɫ
хубавец	x u b ɐ v ɛ t͡s
напластяване	n ɐ p ɫ ɐ s tʲ a v ɐ n ɛ
продам	p r o d a m
балюстрада	b ɐ lʲ u s t r a d ɐ
щяха	ʃ tʲ a x ɐ
постоянен	p o s t o j a n ɛ n
хранилка	x r ɐ n i ɫ k ɐ
аршин	ɐ r ʃ i n
проблем	p r o b lʲ ɛ m
пролет	p r ɔ lʲ ɛ t
членувана	t͡ʃ lʲ ɛ n u v ɐ n ɐ
изгреба	i z ɡ r ɛ b ɐ
държава	d ɐ r ʒ a v ɐ
изучаем	i z u t͡ʃ a ɛ m
бързолет	b ɐ r z o lʲ ɛ t
кошара	k o ʃ a r ɐ
жълтък	ʒ ɐ ɫ t ɤ k
приемам	p r i ɛ m ɐ m
млечнобял	m lʲ ɛ t͡ʃ n o bʲ a ɫ
пеганка	p ɛ ɡ a n k ɐ
кожарница	k o ʒ a r n i t͡s ɐ
кубичен	k u b i t͡ʃ ɛ n
икона	i k ɔ n ɐ
ядяхте	j a dʲ a x t ɛ
затворен	z ɐ t v ɔ r ɛ n
сараево	s ɐ r a ɛ v o
сирийка	s i r i k ɐ
коронясвам	k o r o nʲ a s v ɐ m
смяна	s mʲ a n ɐ
избягам	i z bʲ a ɡ ɐ m
свойство	s v ɔ j s t v o
шейна	ʃ ɛ j n a
краче	k r ɐ t͡ʃ ɛ
абдоминалния	ɐ b d o m i n a ɫ n i j ɐ
буна	b u n ɐ
същ	s ɤ ʃ t
гледам	ɡ lʲ ɛ d ɐ m
поп	p ɔ p
устат	u s t a t
вършея	v ɐ r ʃ ɛ j ɐ
атолитър	ɐ t o lʲ i t ɐ r
твоята	t v ɔ j ɐ t ɐ
невярващ	n ɛ vʲ a r v ɐ ʃ t
кучи	k u t͡ʃ i
история	i s t ɔ r i j ɐ
повтор	p o f t ɔ r
битпазар	b i t p ɐ z a r
вашият	v a ʃ i j ɐ t
градски	ɡ r a t s kʲ i
обичай	o b i t͡ʃ a j
трудоемък	t r u d o ɛ m ɐ k
онакова	o n ɐ k ɔ v ɐ
данък	d a n ɐ k
граната	ɡ r ɐ n a t ɐ
буца	b u t͡s ɐ
предприемач	p r ɛ t p r i ɛ m a t͡ʃ
професионален	p r o f ɛ s i o n a lʲ ɛ n
справедливост	s p r ɐ v ɛ d lʲ i v o s t
китайка	kʲ i t a j k ɐ
каца	k a t͡s ɐ
узаконяващите	u z ɐ k o nʲ a v ɐ ʃ t i t ɛ
абонаментен	ɐ b o n ɐ m ɛ n t ɛ n
възбял	v ɐ z bʲ a ɫ
бекон	b ɛ k ɔ n
цинк	t͡s i n k
технеций	t ɛ x n ɛ t͡s i
миролюбив	m i r o lʲ u b i f
люксембург	lʲ u k s ɛ m b u r k
изненада	i z n ɛ n a d ɐ
лачен	ɫ a t͡ʃ ɛ n
кокоши	k o k ɔ ʃ i
изведнъж	i z v ɛ d n ɤ ʃ
пропаст	p r ɔ p ɐ s t
мисъл	m i s ɐ ɫ
авиобомба	a v i o b ɔ m b ɐ
прекален	p r ɛ k ɐ lʲ ɛ n
плитък	p lʲ i t ɐ k
скръбав	s k r ɤ b ɐ f
косинус	k ɔ s i n u s
кофа	k ɔ f ɐ
чия	t͡ʃ i j a
дърча	d ɤ r t͡ʃ ɐ
павилион	p ɐ v i lʲ i ɔ n
узаконихме	u z ɐ k o n i x m ɛ
модален	m o d a lʲ ɛ n
вашия	v a ʃ i j ɐ
забележа	z ɐ b ɛ lʲ ɛ ʒ ɐ
братя	b r a tʲ ɐ
щъркел	ʃ t ɤ r kʲ ɛ ɫ
резултат	r ɛ z u ɫ t a t
подривен	p o d r i v ɛ n
щрих	ʃ t r i x
узаконявало	u z ɐ k o nʲ a v ɐ ɫ o
измете	i z m ɛ t ɛ
неразбория	n ɛ r ɐ z b o r i j ɐ
щърбав	ʃ t ɤ r b ɐ f
ноември	n o ɛ m v r i
безпаричен	b ɛ s p ɐ r i t͡ʃ ɛ n
пафкам	p a f k ɐ m
миг	m i k
сияехте	s i j a ɛ x t ɛ
нога	n o ɡ a
гмурец	ɡ m u r ɛ t͡s
дървен	d ɤ r v ɛ n
оставя	o s t a vʲ ɐ
патица	p a t i t͡s ɐ
преда	p r ɛ d ɤ
длан	d ɫ a n
музей	m u z ɛ j
припадна	p r i p a d n ɐ
готов	ɡ ɔ t o f
хиляда	xʲ i lʲ a d ɐ
помоля	p o m ɔ lʲ ɐ
ракия	r a kʲ i j a
блед	b lʲ ɛ t
чувам	t͡ʃ u v ɐ m
изпълнителен	i s p ɐ ɫ n i t ɛ lʲ ɛ n
век	v ɛ k
хладен	x ɫ a d ɛ n
узаконяващия	u z ɐ k o nʲ a v ɐ ʃ t i j ɐ
поилка	p o i ɫ k ɐ
изведа	i z v ɛ d ɤ
досега	d o s ɛ ɡ a
архипелаг	ɐ r xʲ i p ɛ ɫ a k
зала	z a ɫ ɐ
почивам	p o t͡ʃ i v a m
ядящото	j a dʲ a ʃ t o t o
обходим	o p x o d i m
клиент	k lʲ i ɛ n t
женен	ʒ ɛ n ɛ n
извадя	i z v a dʲ ɐ
повторим	p o f t o r i m
безгрижен	b ɛ z ɡ r i ʒ ɛ n
глупост	ɡ ɫ u p o s t
завинаги	z ɐ v i n ɐ ɡʲ i
бърне	b ɐ r n ɛ
крякот	k rʲ a k o t
власт	v ɫ a s t
сврачи	s v r a t͡ʃ i
единия	ɛ d i n i j ɐ
горчив	ɡ o r t͡ʃ i f
победите	p o b ɛ d i t ɛ
раздразним	r ɐ z d r ɐ z n i m
гърция	ɡ ɤ r t͡s i j ɐ
тенесин	t ɛ n ɛ s i n
хидра	xʲ i d r ɐ
восхищение	v o s xʲ i ʃ t ɛ n i ɛ
победя	p o b ɛ dʲ ɤ
паспорт	p ɐ s p ɔ r t
завивка	z ɐ v i f k ɐ
довеждам	d o v ɛ ʒ d ɐ m
читателка	t͡ʃ i t a t ɛ ɫ k ɐ
колко	k ɔ ɫ k o
васил	v ɐ s i ɫ
джудже	d ʒ u d ʒ ɛ
артист	ɐ r t i s t
водопад	v o d o p a t
непълен	n ɛ p ɤ lʲ ɛ n
мренета	m r ɛ n ɛ t ɐ
мразилник	m r ɐ z i ɫ n i k
кубометър	k u b o m ɛ t ɐ r
хлапе	x ɫ ɐ p ɛ
узаконилите	u z ɐ k o n i lʲ i t ɛ
хава	x a v ɐ
ограничен	o ɡ r ɐ n i t͡ʃ ɛ n
наводня	n ɐ v o d nʲ ɤ
леля	lʲ ɛ lʲ ɐ
беда	b ɛ d a
септември	s ɛ p t ɛ m v r i
плен	p lʲ ɛ n
цупя	t͡s u pʲ ɐ
възсед	v ɐ s s ɛ t
лале	ɫ ɐ lʲ ɛ
мече	m ɛ t͡ʃ ɛ
швейцарски	ʃ v ɛ j t͡s a r s kʲ i
гадина	ɡ ɐ d i n ɐ
втечня	f t ɛ t͡ʃ nʲ ɤ
образован	o b r ɐ z ɔ v ɐ n
телевизия	t ɛ lʲ ɛ v i z i j ɐ
девойка	d ɛ v ɔ j k ɐ
ерида	ɛ r i d ɐ
зрящ	z rʲ a ʃ t
пласт	p ɫ a s t
орехче	ɔ r ɛ x t͡ʃ ɛ
тилтия	t i ɫ t i j ɐ
заслужавам	z ɐ s ɫ u ʒ a v ɐ m
инакво	i n a k v o
събирам	s ɐ b i r ɐ m
стъпка	s t ɤ p k ɐ
деймос	d ɛ j m o s
служа	s ɫ u ʒ ɐ
поопичам	p o o p i t͡ʃ ɐ m
есенция	ɛ s ɛ n t͡s i j ɐ
имащи	i m ɐ ʃ t i
неща	n ɛ ʃ t a
сретя	s r ɛ tʲ ɐ
стеля	s t ɛ lʲ ɐ
надолу	n ɐ d ɔ ɫ u
шифър	ʃ i f ɐ r
предупредя	p r ɛ d u p r ɛ dʲ ɤ
карти	k a r t i
ищай	i ʃ t a j
среда	s r ɛ d a
славянин	s ɫ ɐ vʲ a n i n
оногози	o n o ɡ ɔ z i
гайда	ɡ a j d ɐ
буляк	b u lʲ ɐ k
аджаба	a d ʒ ɐ b ɐ
стоя	s t o j ɤ
ровина	r o v i n ɐ
възхищение	v ɐ s xʲ i ʃ t ɛ n i ɛ
яла	j a ɫ ɐ
кания	k ɐ n i j ɐ
пруст	p r u s t
никоя	n i k o j ɐ
езотеричен	ɛ z o t ɛ r i t͡ʃ ɛ n
врана	v r a n ɐ
волфрам	v ɔ ɫ f r ɐ m
премяна	p r ɛ mʲ a n ɐ
кавал	k ɐ v a ɫ
негодяй	n ɛ ɡ o dʲ a j
азербайджански	ɐ z ɛ r b ɐ j d͡ʒ a n s kʲ i
разгръщам	r ɐ z ɡ r ɤ ʃ t ɐ m
юрод	j u r o t
арама	ɐ r a m ɐ
блия	b lʲ i j ɐ
сребрист	s r ɛ b r i s t
сто	s t ɔ
абортивен	ɐ b o r t i v ɛ n
рог	r ɔ k
тухла	t u x ɫ ɐ
арестува	a r ɛ s t u v a
мечок	m ɛ t͡ʃ ɔ k
нека	n ɛ k ɐ
зрител	z r i t ɛ ɫ
вино	v i n o
апологет	ɐ p o ɫ o ɡʲ ɛ t
германий	ɡʲ ɛ r m a n i
почти	p o t͡ʃ t i
мегалитър	m ɛ ɡ ɐ lʲ i t ɐ r
техничен	t ɛ x n i t͡ʃ ɛ n
анархия	ɐ n a r xʲ i j ɐ
свра	s v r ɤ
ядък	j a d ɐ k
международен	m ɛ ʒ d u n ɐ r ɔ d ɛ n
индий	i n d i
зъболекарски	z ɐ b o lʲ ɛ k ɐ r s kʲ i
рогов	r ɔ ɡ o f
рода	r o d a
инстинктивен	i n s t i n k t i v ɛ n
супермаркет	s u p ɛ r m a r kʲ ɛ t
меч	m ɛ t͡ʃ
парещ	p a r ɛ ʃ t
обятия	o bʲ a t i j ɐ
пепелник	p ɛ p ɛ ɫ n i k
русалия	r u s a lʲ i j ɐ
даде	d a d ɛ
ренде	r ɛ n d ɛ
влека	v lʲ ɛ k ɤ
ала	a ɫ ɐ
имахме	i m a x m ɛ
възкръсвам	v ɐ s k r ɤ s v ɐ m
щене	ʃ t ɛ n ɛ
апарат	ɐ p ɐ r a t
зареждам	z ɐ r ɛ ʒ d ɐ m
руснаци	r u s n a t͡s i
робот	r ɔ b o t
опаковчик	o p ɐ k ɔ f t͡ʃ i k
отрови	o t r o v i
рева	r ɛ v a
ягодов	j a ɡ o d o f
дрозен	d r ɔ z ɛ n
тогова	t o ɡ ɔ v ɐ
швейцария	ʃ v ɛ j t͡s a r i j ɐ
чие	t͡ʃ i ɛ
тъпочовка	t ɐ p o t͡ʃ ɔ f k ɐ
скачам	s k a t͡ʃ ɐ m
термин	t ɛ r m i n
абатско	ɐ b a t s k o
където	k ɐ d ɛ t o
отнеса	o t n ɛ s ɤ
жъна	ʒ ɤ n ɐ
като	k ɐ t ɔ
говно	ɡ o v n ɔ
харамия	x ɐ r ɐ m i j ɐ
вяра	vʲ a r ɐ
наркотик	n ɐ r k o t i k
заслужено	z ɐ s ɫ u ʒ ɛ n o
раздялба	r ɐ z dʲ a ɫ b ɐ
ваше	v a ʃ ɛ
прав	p r a f
именно	i m ɛ n n o
гмуркач	ɡ m u r k a t͡ʃ
щом	ʃ t ɔ m
ограничителен	o ɡ r ɐ n i t͡ʃ i t ɛ lʲ ɛ n
абстрактен	ɐ p s t r a k t ɛ n
хасий	x a s i
средняк	s r ɛ d nʲ a k
зреше	z r ɛ ʃ ɛ
лъх	ɫ ɤ x
пиша	p i ʃ ɐ
възбуден	v ɐ z b u d ɛ n
подялба	p o dʲ a ɫ b ɐ
кръстат	k r ɐ s t a t
седемнадесет	s ɛ d ɛ m n a d ɛ s ɛ t
творя	t v o rʲ a
сад	s a t
войски	v o j s kʲ i
явя	j a vʲ a
спомня	s p ɔ m nʲ ɐ
чет	t͡ʃ ɛ t
самка	s a m k ɐ
брадва	b r a d v ɐ
града	ɡ r a d ɐ
довлека	d o v lʲ ɛ k ɤ
панкреас	p a n k r ɛ ɐ s
борба	b o r b a
говорех	ɡ o v ɔ r ɛ x
гулия	ɡ u lʲ i j ɐ
дърволазка	d ɐ r v o ɫ a s k ɐ
отред	o t r ɛ t
тихо	t i x o
пек	p ɛ k
седеф	s ɛ d ɛ f
наште	n a ʃ t ɛ
чутура	t͡ʃ u t u r ɐ
убеждавам	u b ɛ ʒ d a v ɐ m
вишна	v i ʃ n ɐ
манастир	m ɐ n ɐ s t i r
узаконяванета	u z ɐ k o nʲ a v ɐ n ɛ t ɐ
февруари	f ɛ v r u a r i
човек	t͡ʃ o v ɛ k
дъхна	d ɤ x n ɐ
езда	ɛ z d ɤ
павлака	p a v ɫ ɐ k ɐ
биле	b i lʲ ɛ
съюз	s ɐ j u s
репортер	r ɛ p o r t ɛ r
рибар	r i b a r
яденото	j a d ɛ n o t o
население	n ɐ s ɛ lʲ ɛ n i ɛ
сък	s ɤ k
мрат	m r ɤ t
апология	ɐ p o ɫ ɔ ɡʲ i j ɐ
каменарче	k ɐ m ɛ n a r t͡ʃ ɛ
будуя	b u d u j ɐ
измъкна	i z m ɤ k n ɐ
тон	t ɔ n
керамика	kʲ ɛ r a m i k ɐ
узаконен	u z ɐ k o n ɛ n
билото	b i ɫ o t o
трева	t r ɛ v a
доказателство	d o k ɐ z a t ɛ ɫ s t v o
семейство	s ɛ m ɛ j s t v o
арестувах	a r ɛ s t u v a x
любовен	lʲ u b ɔ v ɛ n
чао	t͡ʃ a o
главен	ɡ ɫ a v ɛ n
кротък	k r ɔ t ɐ k
тежа	t ɛ ʒ ɤ
абсорбирания	ɐ p s o r b i r ɐ n i j ɐ
сладко	s ɫ a t k o
отделен	o d d ɛ lʲ ɛ n
тежест	t ɛ ʒ ɛ s t
оногоз	o n o ɡ ɔ s
допека	d o p ɛ k ɤ
алкохол	ɐ ɫ k o x ɔ ɫ
неодим	n ɛ o d i m
япет	j ɐ p ɛ t
прекарвам	p r ɛ k a r v ɐ m
стихия	s t i xʲ i j ɐ
върна	v ɤ r n ɐ
хопам	x ɔ p ɐ m
междуметие	m ɛ ʒ d u m ɛ t i ɛ
бил	b i ɫ
интересувам	i n t ɛ r ɛ s u v ɐ m
чиито	t͡ʃ i i t o
австралийски	ɐ f s t r ɐ lʲ i s kʲ i
пролом	p r o ɫ ɔ m
вертолет	v ɛ r t o lʲ ɛ t
лидер	lʲ i d ɛ r
кафез	k ɐ f ɛ s
дотичам	d o t i t͡ʃ ɐ m
надуваем	n ɐ d u v a ɛ m
здравей	z d r ɐ v ɛ j
цяр	t͡sʲ a r
решим	r ɛ ʃ i m
дигна	d i ɡ n ɐ
нет	n ɛ t
падало	p a d ɐ ɫ o
перилен	p ɛ r i lʲ ɛ n
поддръжка	p o d d r ɤ ʃ k ɐ
какаду	k ɐ k ɐ d u
абатски	ɐ b a t s kʲ i
оставям	o s t a vʲ ɐ m
текстилен	t ɛ k s t i lʲ ɛ n
принеса	p r i n ɛ s ɤ
обсъждам	o p s ɤ ʒ d ɐ m
корморан	k o r m o r a n
провлак	p r ɔ v ɫ ɐ k
местност	m ɛ s n o s t
различим	r ɐ z lʲ i t͡ʃ i m
гламав	ɡ ɫ a m ɐ f
яж	j a ʃ
агитпункт	ɐ ɡʲ i t p u n k t
трети	t r ɛ t i
различие	r ɐ z lʲ i t͡ʃ i ɛ
членувам	t͡ʃ lʲ ɛ n u v ɐ m
криптон	k r i p t ɔ n
струва	s t r u v a
стил	s t i ɫ
бяхме	bʲ a x m ɛ
тарос	t a r o s
небеса	n ɛ b ɛ s a
турци	t u r t͡s i
анкетен	ɐ n kʲ ɛ t ɛ n
бей	b ɛ j
фермий	f ɛ r m i
суесловие	s u ɛ s ɫ ɔ v i ɛ
кърнак	k ɐ r n a k
скорошен	s k ɔ r o ʃ ɛ n
ням	nʲ a m
имала	i m a ɫ ɐ
острица	o s t r i t͡s ɐ
внезапен	v n ɛ z a p ɛ n
конгрес	k o n ɡ r ɛ s
пепеляв	p ɛ p ɛ lʲ a f
август	a v ɡ u s t
гяур	ɡʲ ɐ u r
церий	t͡s ɛ r i
нему	n ɛ m u
стърга	s t ɤ r ɡ ɐ
специален	s p ɛ t͡s i a lʲ ɛ n
елате	ɛ ɫ a t ɛ
софийски	s o f i s kʲ i
резлив	r ɛ z lʲ i f
коря	k o rʲ ɤ
неопределен	n ɛ o p r ɛ d ɛ lʲ ɛ n
трофей	t r o f ɛ j
кайгана	k ɐ j ɡ ɐ n a
пасем	p ɐ s ɛ m
швейцарка	ʃ v ɛ j t͡s a r k ɐ
самотен	s ɐ m ɔ t ɛ n
покруса	p o k r u s ɐ
заплитам	z ɐ p lʲ i t ɐ m
летя	lʲ ɛ tʲ a
нанометър	n ɐ n o m ɛ t ɐ r
зърнен	z ɤ r n ɛ n
гигант	ɡʲ i ɡ a n t
гагарка	ɡ ɐ ɡ a r k ɐ
дьо	dʲ ɔ
мартеница	m a r t ɛ n i t͡s ɐ
силиций	s i lʲ i t͡s i
средновековие	s r ɛ d n o v ɛ k ɔ v i ɛ
бол	b ɔ ɫ
градус	ɡ r a d u s
отвор	o t v ɔ r
проклитичен	p r o k lʲ i t i t͡ʃ ɛ n
глезен	ɡ lʲ ɛ z ɛ n
чуя	t͡ʃ u j ɐ
бабанка	b ɐ b a n k ɐ
чул	t͡ʃ u ɫ
зрак	z r a k
мирта	m i r t ɐ
март	m a r t
сияеше	s i j a ɛ ʃ ɛ
напека	n ɐ p ɛ k ɤ
пасенета	p a s ɛ n ɛ t ɐ
карам	k a r ɐ m
палав	p a ɫ ɐ f
зашивам	z ɐ ʃ i v ɐ m
двор	d v ɔ r
роветина	r o v ɛ t i n ɐ
проблема	p r o b lʲ ɛ m ɐ
софиянка	s o f i j a n k ɐ
политичен	p o lʲ i t i t͡ʃ ɛ n
облак	ɔ b ɫ ɐ k
шум	ʃ u m
накаже	n ɐ k a ʒ ɛ
изплашвам	i s p ɫ a ʃ v ɐ m
берилий	b ɛ r i lʲ i
дебелея	d ɛ b ɛ lʲ ɛ j ɐ
докторка	d ɔ k t o r k ɐ
дарба	d a r b ɐ
управителен	u p r a v i t ɛ lʲ ɛ n
автобиографично	ɐ f t o b i o ɡ r ɐ f i t͡ʃ n o
бъдеще	b ɤ d ɛ ʃ t ɛ
архитектура	ɐ r xʲ i t ɛ k t u r ɐ
иманетата	i m ɐ n ɛ t ɐ t ɐ
от	o t
давам	d a v ɐ m
потребител	p o t r ɛ b i t ɛ ɫ
ейприл	ɛ j p r i ɫ
бръглеш	b r ɤ ɡ lʲ ɛ ʃ
разчитам	r ɐ ʃ t͡ʃ i t ɐ m
лъжи	ɫ ɐ ʒ i
показвам	p o k a z v ɐ m
къртица	k ɐ r t i t͡s ɐ
южнячка	j u ʒ nʲ a t͡ʃ k ɐ
стадион	s t ɐ d i ɔ n
ударя	u d a rʲ ɐ
обърна	o b ɤ r n ɐ
зор	z ɔ r
мощност	m ɔ ʃ n o s t
кюфте	kʲ o f t ɛ
град	ɡ r a t
обесвам	o b ɛ s v ɐ m
свидетелство	s v i d ɛ t ɛ ɫ s t v o
сега	s ɛ ɡ a
зярвам	zʲ a r v ɐ m
боричкам	b o r i t͡ʃ k ɐ m
имайте	i m ɐ j t ɛ
наема	n ɐ ɛ m ɐ
два	d v a
изпитвам	i s p i t v ɐ m
русе	r u s ɛ
биографичен	b i o ɡ r ɐ f i t͡ʃ ɛ n
чествам	t͡ʃ ɛ s t v ɐ m
връст	v r ɤ s t
риж	r i ʃ
цикламен	t͡s i k ɫ a m ɛ n
сплав	s p ɫ a f
съобщя	s ɐ o p ʃ tʲ ɤ
пуст	p u s t
милостиня	m i ɫ o s t i nʲ ɐ
някои	nʲ ɐ k ɔ i
нехая	n ɛ x a j ɐ
гургулица	ɡ u r ɡ u lʲ i t͡s ɐ
запридам	z ɐ p r i d ɐ m
енцелад	ɛ n t͡s ɛ ɫ a t
изправям	i s p r a vʲ ɐ m
ако	a k o
намака	n ɐ m a k ɐ
противоречив	p r o t i v o r ɛ t͡ʃ i f
тъмнина	t ɐ m n i n a
хавлия	x ɐ v lʲ i j ɐ
куфар	k u f ɐ r
парфюм	p ɐ r fʲ u m
ден	d ɛ n
бъчвар	b ɐ t͡ʃ v a r
спя	s pʲ ɤ
затека	z ɐ t ɛ k ɤ
поетеса	p o ɛ t ɛ s ɐ
скуа	s k u ɐ
корист	k ɔ r i s t
наблюдавам	n ɐ b lʲ u d a v ɐ m
листо	lʲ i s t ɔ
щелият	ʃ t ɛ lʲ i j ɐ t
млак	m ɫ a k
полски	p ɔ ɫ s kʲ i
азот	ɐ z ɔ t
роса	r o s a
алчност	a ɫ t͡ʃ n o s t
бор	b ɔ r
театър	t ɛ a t ɐ r
изопачен	i z o p ɐ t͡ʃ ɛ n
гемия	ɡʲ ɛ m i j ɐ
алчен	a ɫ t͡ʃ ɛ n
предполагам	p r ɛ t p o ɫ a ɡ ɐ m
мишца	m i ʃ t͡s ɐ
чопка	t͡ʃ ɔ p k ɐ
безпрецедентен	b ɛ s p r ɛ t͡s ɛ d ɛ n t ɛ n
приближа	p r i b lʲ i ʒ a
пека	p ɛ k ɤ
инстинкт	i n s t i n k t
единадесет	ɛ d i n a d ɛ s ɛ t
вестник	v ɛ s n i k
абсциса	ɐ p s t͡s i s ɐ
ватра	v a t r ɐ
дъждосвирец	d ɐ ʒ d o s v i r ɛ t͡s
беся	b ɛ sʲ ɐ
зад	z a t
пигментен	p i ɡ m ɛ n t ɛ n
антитяло	a n t i tʲ a ɫ o
свалям	s v a lʲ ɐ m
другаде	d r u ɡ ɐ d ɛ
ласка	ɫ a s k ɐ
раста	r ɐ s t ɤ
винце	v i n t͡s ɛ
кимна	kʲ i m n ɐ
довлея	d o v lʲ ɛ j ɐ
клей	k lʲ ɛ j
пасох	p a s o x
чинка	t͡ʃ i n k ɐ
начин	n a t͡ʃ i n
пижо	p i ʒ o
дизя	d i zʲ ɐ
роднина	r o d n i n ɐ
привнеса	p r i v n ɛ s ɤ
експедиционен	ɛ k s p ɛ d i t͡s i ɔ n ɛ n
картина	k ɐ r t i n ɐ
шунка	ʃ u n k ɐ
пакет	p ɐ kʲ ɛ t
богиня	b o ɡʲ i nʲ ɐ
плуг	p ɫ u k
грузински	ɡ r u z i n s kʲ i
ддс	d ɤ d ɤ s ɤ
щяхме	ʃ tʲ a x m ɛ
цвете	t͡s v ɛ t ɛ
акорд	ɐ k ɔ r t
исландски	i s ɫ a n t s kʲ i
трактор	t r a k t o r
жужел	ʒ u ʒ ɛ ɫ
полицай	p o lʲ i t͡s a j
уплашвам	u p ɫ a ʃ v ɐ m
негов	n ɛ ɡ o f
аби	ɐ b i
феникс	f ɛ n i k s
молба	m o ɫ b a
човешки	t͡ʃ o v ɛ ʃ kʲ i
хирургически	xʲ i r u r ɡʲ i t͡ʃ ɛ s kʲ i
имахте	i m a x t ɛ
каня	k a nʲ ɐ
узаконяла	u z ɐ k o nʲ a ɫ ɐ
четвъртък	t͡ʃ ɛ t v ɤ r t ɐ k
нит	n i t
мляко	m lʲ a k o
дупка	d u p k ɐ
хор	x ɔ r
апс	a p s
хлад	x ɫ a t
податък	p o d a t ɐ k
джамия	d ʒ ɐ m i j ɐ
висш	v i ʃ ʃ
мъгла	m ɐ ɡ ɫ a
хвърлям	x v ɤ r lʲ ɐ m
двамата	d v a m ɐ
съзвездие	s ɐ z v ɛ z d i ɛ
тъмница	t ɐ m n i t͡s ɐ
московий	m o s k ɔ v i
филолог	f i ɫ o ɫ ɔ k
авлия	ɐ v lʲ i j ɐ
става	s t a v ɐ
пазата	p ɐ z a t ɐ
плесен	p lʲ ɛ s ɛ n
зъболекар	z ɐ b o lʲ ɛ k ɐ r
индикативен	i n d i k ɐ t i v ɛ n
аерогара	a ɛ r o ɡ a r ɐ
чист	t͡ʃ i s t
паслия	p a s lʲ i j ɐ
взривен	v z r i v ɛ n
храня	x r a nʲ ɐ
лук	ɫ u k
стикс	s t i k s
череша	t͡ʃ ɛ r ɛ ʃ ɐ
бургас	b u r ɡ a s
тревога	t r ɛ v ɔ ɡ ɐ
нагриза	n ɐ ɡ r i z ɐ
дрехи	d r ɛ xʲ i
токачка	t o k a t͡ʃ k ɐ
моля	m ɔ lʲ ɐ
бълха	b ɐ ɫ x a
розов	r ɔ z o f
никой	n i k o j
логан	ɫ ɔ ɡ ɐ n
основателност	o s n o v a t ɛ ɫ n o s t
защо	z ɐ ʃ t ɔ
брегът	b r ɛ ɡ ɤ t
реален	r ɛ a lʲ ɛ n
буля	b u lʲ ɐ
кубик	k u b i k
възкръсна	v ɐ s k r ɤ s n ɐ
строг	s t r ɔ k
драгаш	d r ɐ ɡ a ʃ
румънец	r u m ɤ n ɛ t͡s
тежък	t ɛ ʒ ɐ k
черта	t͡ʃ ɛ r t a
закон	z ɐ k ɔ n
котка	k ɔ t k ɐ
узаконях	u z ɐ k o nʲ a x
сой	s ɔ j
рис	r i s
пащърнак	p ɐ ʃ t ɐ r n a k
юда	j u d ɐ
неловък	n ɛ ɫ ɔ v ɐ k
юрган	j u r ɡ a n
арес	a r ɛ s
адютантски	ɐ dʲ u t a n t s kʲ i
морскосин	m ɔ r s k o s i n
острие	o s t r i ɛ
воденица	v o d ɛ n i t͡s ɐ
светлосянката	s v ɛ t ɫ o sʲ a n k ɐ t ɐ
мрящото	m rʲ a ʃ t o t o
глина	ɡ lʲ i n ɐ
метна	m ɛ t n ɐ
ужасно	u ʒ a s n o
ледовит	lʲ ɛ d o v i t
малайзийо	m ɐ ɫ a j z i j o
магнезий	m ɐ ɡ n ɛ z i
българийо	b ɐ ɫ ɡ a r i j o
конкретен	k o n k r ɛ t ɛ n
въсат	v ɐ s a t
харем	x ɐ r ɛ m
интернационален	i n t ɛ r n ɐ t͡s i o n a lʲ ɛ n
орле	o r lʲ ɛ
медовина	m ɛ d o v i n ɐ
мряща	m rʲ a ʃ t ɐ
огромен	o ɡ r ɔ m ɛ n
издутина	i z d u t i n a
махам	m a x ɐ m
четирите	t͡ʃ ɛ t i r i t ɛ
изминаваща	i z m i n a v ɐ ʃ t ɐ
разлог	r ɐ z ɫ ɔ k
арка	a r k ɐ
лава	ɫ a v ɐ
мушитрънка	m u ʃ i t r ɤ n k ɐ
халост	x a ɫ o s t
почувствам	p o t͡ʃ u s t v ɐ m
дрипав	d r i p ɐ f
стефан	s t ɛ f ɐ n
роля	r ɔ lʲ ɐ
шестдесет	ʃ ɛ z d ɛ s ɛ t
закупи	z ɐ k u p i
радио	r a d i o
авиотакси	a v i o t ɐ k s i
успокоявам	u s p o k o j a v ɐ m
всякога	f sʲ a k o ɡ ɐ
среден	s r ɛ d ɛ n
изтребя	i s t r ɛ bʲ ɐ
узаконяваше	u z ɐ k o nʲ a v ɐ ʃ ɛ
туристка	t u r i s k ɐ
индийски	i n d i s kʲ i
мироглед	m i r o ɡ lʲ ɛ t
узаконяват	u z ɐ k o nʲ a v ɐ t
ой	ɔ j
говорих	ɡ o v o r i x
говорите	ɡ o v ɔ r i t ɛ
корея	k o r ɛ j ɐ
студентство	s t u d ɛ n t s t v o
авиационен	a v i ɐ t͡s i ɔ n ɛ n
щиглец	ʃ t i ɡ lʲ ɛ t͡s
узаконените	u z ɐ k o n ɛ n i t ɛ
офис	ɔ f i s
агрегатен	ɐ ɡ r ɛ ɡ a t ɛ n
спасяем	s p ɐ sʲ a ɛ m
финанси	f i n a n s i
зелен	z ɛ lʲ ɛ n
каквото	k ɐ k v ɔ t o
глаголе	ɡ ɫ ɐ ɡ ɔ lʲ ɛ
турна	t u r n a
вътре	v ɤ t r ɛ
обучение	o b u t͡ʃ ɛ n i ɛ
прям	p rʲ a m
зависим	z ɐ v i s i m
пуйка	p u j k ɐ
аман	a m a n
го	ɡ o
загина	z ɐ ɡʲ i n ɐ
опозиционен	o p o z i t͡s i ɔ n ɛ n
шествие	ʃ ɛ s t v i ɛ
парче	p ɐ r t͡ʃ ɛ
тръгна	t r ɐ ɡ n a
величав	v ɛ lʲ i t͡ʃ a f
операция	o p ɛ r a t͡s i j ɐ
поемам	p o ɛ m ɐ m
страх	s t r a x
блюя	b lʲ u j ɐ
носят	n ɔ sʲ ɐ t
пистолет	p i s t o lʲ ɛ t
наши	n a ʃ i
надонеса	n ɐ d o n ɛ s ɤ
олово	o ɫ ɔ v o
мишница	m i ʃ n i t͡s ɐ
навик	n a v i k
оръдие	o r ɤ d i ɛ
пиво	p i v o
продавам	p r o d a v ɐ m
греша	ɡ r ɛ ʃ ɤ
отговарям	o d ɡ o v a rʲ ɐ m
груб	ɡ r u p
прегръщам	p r ɛ ɡ r ɤ ʃ t ɐ m
недоимък	n ɛ d o i m ɐ k
здравеняк	z d r ɐ v ɛ nʲ a k
всякакъв	f sʲ a k ɐ k ɐ f
шантажирам	ʃ ɐ n t ɐ ʒ i r ɐ m
дърво	d ɐ r v ɔ
безсмъртен	b ɛ s s m ɤ r t ɛ n
ужасия	u ʒ ɐ s i j ɐ
остатък	o s t a t ɐ k
солен	s o lʲ ɛ n
гъделичкам	ɡ ɐ d ɛ lʲ i t͡ʃ k ɐ m
минута	m i n u t ɐ
седемдесет	s ɛ d ɛ m d ɛ s ɛ t
ухапете	u x a p ɛ t ɛ
прехапвам	p r ɛ x a p v ɐ m
арестувахме	a r ɛ s t u v a x m ɛ
спътник	s p ɤ t n i k
агне	a ɡ n ɛ
покажа	p o k a ʒ ɐ
блато	b ɫ a t o
долар	d ɔ ɫ ɐ r
генерал	ɡʲ ɛ n ɛ r a ɫ
жертва	ʒ ɛ r t v ɐ
падина	p ɐ d i n a
тъмносин	t ɤ m n o s i n
после	p ɔ s lʲ ɛ
мътен	m ɤ t ɛ n
фотоапарат	f ɔ t o ɐ p ɐ r a t
бихте	b i x t ɛ
забранявам	z ɐ b r ɐ nʲ a v ɐ m
глобус	ɡ ɫ ɔ b u s
черногорка	t͡ʃ ɛ r n o ɡ ɔ r k ɐ
чичо	t͡ʃ i t͡ʃ o
допринасям	d o p r i n a sʲ ɐ m
литий	lʲ i t i
градовете	ɡ r ɐ d o v ɛ t ɛ
трудно	t r u d n o
физичен	f i z i t͡ʃ ɛ n
щука	ʃ t u k ɐ
заемам	z ɐ ɛ m ɐ m
кюрий	kʲ u r i
бъркоч	b ɤ r k o t͡ʃ
забрани	z ɐ b r a n i
касационен	k ɐ s ɐ t͡s i ɔ n ɛ n
великански	v ɛ lʲ i k a n s kʲ i
отпущам	o t p u ʃ t ɐ m
потъна	p o t ɤ n ɐ
узаконявай	u z ɐ k o nʲ a v ɐ j
тук	t u k
обиталище	o b i t a lʲ i ʃ t ɛ
главоного	ɡ ɫ ɐ v o n ɔ ɡ o
израз	i z r ɐ s
бангладеш	b a n ɡ ɫ ɐ d ɛ ʃ
вашто	v a ʃ t o
освен	o s v ɛ n
боже	b ɔ ʒ ɛ
свитък	s v i t ɐ k
гяурин	ɡʲ ɐ u r i n
вътрешност	v ɤ t r ɛ ʃ n o s t
хала	x a ɫ ɐ
извън	i z v ɤ n
открия	o t k r i j ɐ
странен	s t r a n ɛ n
тогавашен	t o ɡ a v ɐ ʃ ɛ n
жидък	ʒ i d ɐ k
валя	v ɐ lʲ ɤ
сквозе	s k v ɔ z ɛ
лелек	lʲ ɛ lʲ ɛ k
основателно	o s n o v a t ɛ ɫ n o
стяг	s tʲ a k
къделя	k ɐ d ɛ lʲ ɐ
народен	n ɐ r ɔ d ɛ n
вярно	vʲ a r n o
означавам	o z n ɐ t͡ʃ a v ɐ m
харон	x ɐ r ɔ n
държа	d ɐ r ʒ ɤ
има	i m a
река	r ɛ k a
у	u
чифлик	t͡ʃ i f lʲ i k
съединител	s ɐ ɛ d i n i t ɛ ɫ
климатология	k lʲ i m ɐ t o ɫ ɔ ɡʲ i j ɐ
горест	ɡ ɔ r ɛ s t
отново	o t n ɔ v o
счетоводен	ʃ t͡ʃ ɛ t o v ɔ d ɛ n
бъдейки	b ɤ d ɛ j kʲ i
дворец	d v o r ɛ t͡s
ангина	ɐ n ɡʲ i n ɐ
солдат	s o ɫ d a t
чък	t͡ʃ ɤ k
боец	b o ɛ t͡s
божи	b ɔ ʒ i
значимост	z n ɐ t͡ʃ i m o s t
о	ɔ
юли	j u lʲ i
дилянка	d i lʲ a n k ɐ
одежда	o d ɛ ʒ d ɐ
узаконим	u z ɐ k o n i m
горица	ɡ o r i t͡s ɐ
четири	t͡ʃ ɛ t i r i
нашият	n a ʃ i j ɐ t
познавам	p o z n a v ɐ m
мюре	mʲ u r ɛ
атометър	ɐ t o m ɛ t ɐ r
кораб	k ɔ r ɐ p
узаконявалата	u z ɐ k o nʲ a v ɐ ɫ ɐ t ɐ
бекасина	b ɛ k ɐ s i n ɐ
затресе	z ɐ t r ɛ s ɛ
желалата	ʒ ɛ ɫ a ɫ ɐ t ɐ
икономичен	i k o n o m i t͡ʃ ɛ n
маниак	m ɐ n i a k
том	t ɔ m
клуб	k ɫ u p
запра	z ɐ p r ɤ
зестра	z ɛ s t r ɐ
жегавица	ʒ ɛ ɡ a v i t͡s ɐ
хлявав	x lʲ ɐ v a f
скверен	s k v ɛ r ɛ n
сковранец	s k o v r a n ɛ t͡s
създавам	s ɐ z d a v ɐ m
изковавам	i s k o v a v ɐ m
екип	ɛ kʲ i p
адет	ɐ d ɛ t
лечба	lʲ ɛ d͡ʒ b ɐ
дон	d ɔ n
фабрика	f a b r i k ɐ
законен	z ɐ k ɔ n ɛ n
нектаринка	n ɛ k t ɐ r i n k ɐ
помолвам	p o m ɔ ɫ v ɐ m
тепе	t ɛ p ɛ
космополитен	k o s m o p o lʲ i t ɛ n
гидия	ɡʲ i d i j ɐ
абсолютност	ɐ p s o lʲ u t n o s t
завоевател	z ɐ v o ɛ v a t ɛ ɫ
бивам	b i v ɐ m
актиний	ɐ k t i n i
честит	t͡ʃ ɛ s t i t
учителски	u t͡ʃ i t ɛ ɫ s kʲ i
авджия	ɐ v d ʒ i j ɐ
тералитър	t ɛ r ɐ lʲ i t ɐ r
сутиен	s u t i ɛ n
къжел	k ɤ ʒ ɛ ɫ
убийство	u b i s t v o
отвес	o t v ɛ s
наличие	n ɐ lʲ i t͡ʃ i ɛ
такава	t ɐ k a v ɐ
адютант	ɐ dʲ u t a n t
прозорче	p r o z ɔ r t͡ʃ ɛ
британия	b r i t a n i j ɐ
враговете	v r a ɡ o v ɛ t ɛ
немощ	n ɛ m o ʃ t
костница	k ɔ s n i t͡s ɐ
кожух	k o ʒ u x
аварски	ɐ v a r s kʲ i
бъди	b ɐ d i
пари	p a r i
видеоускорител	v i d ɛ o u s k o r i t ɛ ɫ
газ	ɡ a s
ютия	j u t i j ɐ
книжен	k n i ʒ ɛ n
гадолиний	ɡ ɐ d o lʲ i n i
твойто	t v ɔ j t o
герасим	ɡʲ ɛ r a s i m
заема	z ɐ ɛ m ɐ
целина	t͡s ɛ lʲ i n a
глас	ɡ ɫ a s
накажа	n ɐ k a ʒ ɐ
единица	ɛ d i n i t͡s ɐ
пръг	p r ɤ k
пристъп	p r i s t ɐ p
зашия	z ɐ ʃ i j ɐ
стилистка	s t i lʲ i s k ɐ
пате	p a t ɛ
май	m a j
канап	k ɐ n a p
строй	s t r ɔ j
мярка	mʲ a r k ɐ
ирландски	i r ɫ a n t s kʲ i
депонентен	d ɛ p o n ɛ n t ɛ n
половина	p o ɫ o v i n ɐ
отточник	o t t ɔ t͡ʃ n i k
тайна	t a j n ɐ
октан	o k t a n
купи	k u p i
вирус	v i r u s
ламаринен	ɫ ɐ m ɐ r i n ɛ n
обезглавя	o b ɛ z ɡ ɫ ɐ vʲ ɤ
бележит	b ɛ lʲ ɛ ʒ i t
любим	lʲ u b i m
скроб	s k r ɔ p
яка	j ɐ k a
космат	k o s m a t
бозайник	b o z a j n i k
отличие	o t lʲ i t͡ʃ i ɛ
завирушка	z ɐ v i r u ʃ k ɐ
експедиция	ɛ k s p ɛ d i t͡s i j ɐ
съглася	s ɐ ɡ ɫ ɐ sʲ a
железария	ʒ ɛ lʲ ɛ z ɐ r i j ɐ
любов	lʲ u b ɔ f
правист	p r ɐ v i s t
танц	t a n t͡s
зри	z r i
граждански	ɡ r a ʒ d ɐ n s kʲ i
каквато	k ɐ k v a t o
шилинг	ʃ i lʲ i n k
европеец	ɛ v r o p ɛ ɛ t͡s
тлъст	t ɫ ɤ s t
втори	f t ɔ r i
енциклопедия	ɛ n t͡s i k ɫ o p ɛ d i j ɐ
прозирам	p r o z i r ɐ m
козел	k o z ɛ ɫ
епископите	ɛ p i s k o p i t ɛ
безчестя	b ɛ ʃ t͡ʃ ɛ s tʲ a
пъртина	p ɐ r t i n ɐ
френски	f r ɛ n s kʲ i
антре	ɐ n t r ɛ
водолюбив	v o d o lʲ u b i f
обсъдя	o p s ɤ dʲ ɐ
шибой	ʃ i b ɔ j
почва	p o t͡ʃ v a
венера	v ɛ n ɛ r ɐ
ален	a lʲ ɛ n
знам	z n a m
авантюристически	ɐ v ɐ n tʲ u r i s t i t͡ʃ ɛ s kʲ i
селище	s ɛ lʲ i ʃ t ɛ
мъж	m ɤ ʃ
свойто	s v ɔ j t o
абдал	ɐ b d a ɫ
баба	b a b ɐ
случвам	s ɫ u t͡ʃ v ɐ m
калай	k ɐ ɫ a j
запъртък	z a p ɐ r t ɐ k
шок	ʃ ɔ k
прадеди	p r a d ɛ d i
съседен	s ɐ s ɛ d ɛ n
член	t͡ʃ lʲ ɛ n
напред	n ɐ p r ɛ t
биче	b i t͡ʃ ɛ
сноп	s n ɔ p
абатските	ɐ b a t s kʲ i t ɛ
сатанински	s ɐ t ɐ n i n s kʲ i
бруней	b r u n ɛ j
елементарен	ɛ lʲ ɛ m ɛ n t a r ɛ n
скоро	s k ɔ r o
шибам	ʃ i b ɐ m
як	j a k
братче	b r a t t͡ʃ ɛ
борий	b ɔ r i
ходене	x ɔ d ɛ n ɛ
прочут	p r o t͡ʃ u t
ималите	i m a lʲ i t ɛ
негър	n ɛ ɡ ɐ r
къща	k ɤ ʃ t ɐ
лош	ɫ ɔ ʃ
брънка	b r ɤ n k ɐ
пристоен	p r i s t ɔ ɛ n
плосък	p ɫ ɔ s ɐ k
археолог	ɐ r xʲ ɛ o ɫ ɔ k
писмо	p i s m ɔ
узаконилото	u z ɐ k o n i ɫ o t o
тетрев	t ɛ t r ɛ f
вой	v ɔ j
улулица	u ɫ u lʲ i t͡s ɐ
сипкав	s i p k ɐ f
алигатор	ɐ lʲ i ɡ a t o r
въоръжавам	v ɐ o r ɐ ʒ a v ɐ m
древен	d r ɛ v ɛ n
полуостров	p o ɫ u ɔ s t r o f
коноп	k o n ɔ p
изнесе	i z n ɛ s ɛ
пасяща	p ɐ sʲ a ʃ t ɐ
четка	t͡ʃ ɛ t k ɐ
проповедник	p r o p o v ɛ d n i k
едно	ɛ d n ɔ
абдоминалната	ɐ b d o m i n a ɫ n ɐ t ɐ
подчертавам	p o t t͡ʃ ɛ r t a v ɐ m
пречупвам	p r ɛ t͡ʃ u p v ɐ m
лебедица	lʲ ɛ b ɛ d i t͡s ɐ
дясно	dʲ a s n o
кроме	k r ɔ m ɛ
философия	f i ɫ o s ɔ f i j ɐ
влез	v lʲ ɛ s
поема	p o ɛ m ɐ
поща	p ɔ ʃ t ɐ
продан	p r ɔ d ɐ n
разтурия	r ɐ s t u r i j ɐ
полувреме	p o ɫ u v r ɛ m ɛ
кино	kʲ i n o
регистрационен	r ɛ ɡʲ i s t r ɐ t͡s i ɔ n ɛ n
прекалено	p r ɛ k ɐ lʲ ɛ n o
скакавица	s k ɐ k a v i t͡s ɐ
шумак	ʃ u m a k
католичка	k ɐ t o lʲ i t͡ʃ k ɐ
албатрос	ɐ ɫ b ɐ t r ɔ s
сприятеля	s p r i j ɐ t ɛ lʲ ɤ
кост	k ɔ s t
любопитен	lʲ u b o p i t ɛ n
тикам	t i k ɐ m
жаба	ʒ a b ɐ
родителен	r o d i t ɛ lʲ ɛ n
стърчиопашка	s t ɐ r t͡ʃ i o p a ʃ k ɐ
майтнерий	m ɐ j t n ɛ r i
кубирам	k u b i r ɐ m
игрив	i ɡ r i f
поглеждам	p o ɡ lʲ ɛ ʒ d ɐ m
рея	r ɛ j ɐ
чужденец	t͡ʃ u ʒ d ɛ n ɛ t͡s
извикам	i z v i k ɐ m
безименен	b ɛ z i m ɛ n ɛ n
автостоп	a f t o s t ɔ p
отдел	o d d ɛ ɫ
ветрило	v ɛ t r i ɫ o
утка	u t k ɐ
жълтеникав	ʒ ɐ ɫ t ɛ n i k ɐ f
ужасено	u ʒ ɐ s ɛ n o
фотограф	f o t o ɡ r a f
бонус	b ɔ n u s
никта	n i k t ɐ
аксиома	a k s i ɔ m ɐ
патладжан	p ɐ t ɫ ɐ d ʒ a n
забраня	z ɐ b r ɐ nʲ ɤ
корите	k o r i t ɛ
завлека	z ɐ v lʲ ɛ k ɤ
чушле	t͡ʃ u ʃ lʲ ɛ
ядящо	j a dʲ a ʃ t o
имате	i m ɐ t ɛ
монако	m o n a k o
бръмбар	b r ɤ m b ɐ r
вид	v i t
абразия	ɐ b r a z i j ɐ
наложа	n ɐ ɫ ɔ ʒ ɐ
фалшив	f ɐ ɫ ʃ i f
водород	v o d o r ɔ t
лимони	lʲ i m ɔ n i
тербий	t ɛ r b i
казан	k ɐ z a n
духов	d u x o f
дойда	d ɔ j d ɐ
разпределение	r ɐ s p r ɛ d ɛ lʲ ɛ n i ɛ
славянски	s ɫ ɐ vʲ a n s kʲ i
бруя	b r u j ɐ
мода	m ɔ d ɐ
господи	ɡ ɔ s p o d i
нужда	n u ʒ d a
бъдеш	b ɤ d ɛ ʃ
любима	lʲ u b i m ɐ
начален	n ɐ t͡ʃ a lʲ ɛ n
решение	r ɛ ʃ ɛ n i ɛ
червеношийка	t͡ʃ ɛ r v ɛ n o ʃ i k ɐ
главоч	ɡ ɫ ɐ v ɔ t͡ʃ
хокам	x ɔ k ɐ m
щелия	ʃ t ɛ lʲ i j ɐ
октомври	o k t ɔ m v r i
размяна	r ɐ z mʲ a n ɐ
предложа	p r ɛ d ɫ ɔ ʒ ɐ
места	m ɛ s t a
масло	m a s ɫ o
тигър	t i ɡ ɐ r
червей	t͡ʃ ɛ r v ɛ j
родий	r ɔ d i
лея	lʲ ɛ j ɐ
ватикана	v ɐ t i k a n ɐ
магаре	m ɐ ɡ a r ɛ
именит	i m ɛ n i t
мир	m i r
рицар	r i t͡s ɐ r
забоде	z ɐ b ɔ d ɛ
смущение	s m u ʃ t ɛ n i ɛ
бряга	b rʲ a ɡ ɐ
веда	v ɛ d ɐ
средище	s r ɛ d i ʃ t ɛ
узаконеният	u z ɐ k o n ɛ n i j ɐ t
бавноходка	b ɐ v n o x ɔ t k ɐ
кървавица	k ɐ r v ɐ v i t͡s ɐ
спичам	s p i t͡ʃ ɐ m
нежелан	n ɛ ʒ ɛ ɫ a n
оженя	o ʒ ɛ nʲ ɐ
българка	b ɤ ɫ ɡ ɐ r k ɐ
метър	m ɛ t ɐ r
слой	s ɫ ɔ j
торба	t o r b a
квебек	k v ɛ b ɛ k
корпорация	k o r p o r a t͡s i j ɐ
микроорганизъм	m i k r o o r ɡ ɐ n i z ɐ m
ядоха	j a d o x ɐ
момиче	m o m i t͡ʃ ɛ
за	z a
спор	s p ɔ r
акумулатор	ɐ k u m u ɫ a t o r
съвсем	s ɐ f s ɛ m
особено	o s ɔ b ɛ n o
полза	p ɔ ɫ z ɐ
сигурен	s i ɡ u r ɛ n
мразовит	m r ɐ z o v i t
колело	k o lʲ ɛ ɫ ɔ
предвиждам	p r ɛ d v i ʒ d ɐ m
брош	b r ɔ ʃ
сея	s ɛ j ɐ
необходим	n ɛ o p x o d i m
абитуриент	ɐ b i t u r i ɛ n t
охлюв	ɔ x lʲ u f
вляза	v lʲ a z ɐ
искря	i s k rʲ ɤ
звънлив	z v ɐ n lʲ i f
йерарх	j ɛ r a r x
дали	d a lʲ i
промеждутък	p r o m ɛ ʒ d u t ɐ k
имали	i m a lʲ i
чернодробен	t͡ʃ ɛ r n o d r ɔ b ɛ n
оди	ɔ d i
жрея	ʒ r ɛ j ɐ
августейши	a v ɡ u s t ɛ j ʃ i
ядох	j a d o x
двусмислие	d v u s m i s lʲ i ɛ
фир	f i r
ладия	ɫ ɐ d i j ɐ
дявол	dʲ a v o ɫ
мощен	m ɔ ʃ t ɛ n
подред	p o d r ɛ t
понапека	p o n ɐ p ɛ k ɤ
строя	s t r o j ɤ
гордо	ɡ ɔ r d o
абисински	ɐ b i s i n s kʲ i
изминавам	i z m i n a v ɐ m
членувано	t͡ʃ lʲ ɛ n u v ɐ n o
запека	z ɐ p ɛ k ɤ
помпа	p ɔ m p ɐ
казерна	k ɐ z ɛ r n ɐ
чивия	t͡ʃ i v i j ɐ
чук	t͡ʃ u k
етика	ɛ t i k ɐ
унион	u n i ɔ n
кукувица	k u k u v i t͡s ɐ
избода	i z b o d ɤ
диспросий	d i s p r ɔ s i
избия	i z b i j ɐ
мазен	m a z ɛ n
лактационен	ɫ ɐ k t ɐ t͡s i ɔ n ɛ n
твоето	t v ɔ ɛ t o
гной	ɡ n ɔ j
мрели	m r ɛ lʲ i
ниобий	n i ɔ b i
биолог	b i o ɫ ɔ k
случай	s ɫ u t͡ʃ a j
гира	ɡʲ i r ɐ
шоколад	ʃ o k o ɫ a t
властен	v ɫ a s t ɛ n
узаконявахте	u z ɐ k o nʲ a v ɐ x t ɛ
оса	o s a
плавен	p ɫ a v ɛ n
иней	i n ɛ j
хилядолетен	xʲ i lʲ ɐ d o lʲ ɛ t ɛ n
або	a b o
ерудиция	ɛ r u d i t͡s i j ɐ
разлат	r ɐ z ɫ a t
щастлив	ʃ t ɐ s lʲ i f
ищца	i ʃ t͡s a
хирургичен	xʲ i r u r ɡʲ i t͡ʃ ɛ n
всякаква	f sʲ a k ɐ k v ɐ
авлига	ɐ v lʲ i ɡ ɐ
милостив	m i ɫ o s t i f
мъжкар	m ɐ ʃ k a r
юфки	j u f kʲ i
бедя	b ɛ dʲ ɤ
оправдавам	o p r ɐ v d a v ɐ m
кон	k ɔ n
беларус	b ɛ ɫ ɐ r u s
измисля	i z m i s lʲ ɐ
сече	s ɛ t͡ʃ ɛ
декалитър	d ɛ k ɐ lʲ i t ɐ r
двойствен	d v ɔ j s t v ɛ n
нея	n ɛ j ɐ
през	p r ɛ s
пасохте	p a s o x t ɛ
толкоз	t ɔ ɫ k o s
азербайджан	ɐ z ɛ r b ɐ j d ʒ a n
ѝ	i
машина	m ɐ ʃ i n ɐ
аборигенче	a b o r i ɡʲ ɛ n t͡ʃ ɛ
пасинок	p a s i n o k
сирене	s i r ɛ n ɛ
самоличност	s ɐ m o lʲ i t͡ʃ n o s t
дърводелец	d ɐ r v o d ɛ lʲ ɛ t͡s
те	t ɛ
жито	ʒ i t o
мюсюлмански	mʲ u sʲ u ɫ m a n s kʲ i
отказвам	o t k a z v ɐ m
животи	ʒ i v ɔ t i
стипца	s t i p t͡s ɐ
огнище	o ɡ n i ʃ t ɛ
узаконило	u z ɐ k o n i ɫ o
круша	k r u ʃ ɐ
владика	v ɫ ɐ d i k ɐ
въглероден	v ɐ ɡ lʲ ɛ r ɔ d ɛ n
прах	p r a x
мощ	m ɔ ʃ t
мостик	m ɔ s t i k
навечерие	n ɐ v ɛ t͡ʃ ɛ r i ɛ
билет	b i lʲ ɛ t
техни	t ɛ x n i
ситен	s i t ɛ n
драгой	d r ɐ ɡ ɔ j
стерилен	s t ɛ r i lʲ ɛ n
основател	o s n o v a t ɛ ɫ
цървул	t͡s ɐ r v u ɫ
откриваем	o t k r i v a ɛ m
нашествие	n ɐ ʃ ɛ s t v i ɛ
загивам	z ɐ ɡʲ i v ɐ m
господарски	ɡ o s p o d a r s kʲ i
слюнка	s lʲ u n k ɐ
един	ɛ d i n
съдебен	s ɐ d ɛ b ɛ n
сеизмичен	s ɛ i z m i t͡ʃ ɛ n
дайка	d a j k ɐ
вадя	v a dʲ ɐ
благоевград	b ɫ ɐ ɡ ɔ ɛ v ɡ r ɐ t
гърци	ɡ ɤ r t͡s i
сера	s ɛ r ɤ
българин	b ɤ ɫ ɡ ɐ r i n
противен	p r o t i v ɛ n
лиляк	lʲ i lʲ ɐ k
пирон	p i r ɔ n
швеция	ʃ v ɛ t͡s i j ɐ
ядящата	j a dʲ a ʃ t ɐ t ɐ
вертикален	v ɛ r t i k a lʲ ɛ n
право	p r a v o
робия	r o b i j ɐ
странноприемница	s t r ɐ n n o p r i ɛ m n i t͡s ɐ
дръвце	d r ɐ f t͡s ɛ
стръмно	s t r ɤ m n o
вина	v i n a
оцветявам	o t͡s v ɛ tʲ a v ɐ m
ръка	r ɐ k a
творец	t v o r ɛ t͡s
варшава	v ɐ r ʃ a v ɐ
длето	d lʲ ɛ t ɔ
орех	ɔ r ɛ x
далече	d ɐ lʲ ɛ t͡ʃ ɛ
фрегата	f r ɛ ɡ a t ɐ
позволително	p o z v o lʲ i t ɛ ɫ n o
помислям	p o m i s lʲ ɐ m
израстък	i z r a s t ɐ k
ярост	j a r o s t
фермер	f ɛ r m ɛ r
електронен	ɛ lʲ ɛ k t r ɔ n ɛ n
съществувам	s ɐ ʃ t ɛ s t v u v ɐ m
напръстник	n a p r ɐ s n i k
определеност	o p r ɛ d ɛ lʲ ɛ n o s t
мренетата	m r ɛ n ɛ t ɐ t ɐ
педя	p ɛ dʲ ɐ
пола	p o ɫ a
пъргав	p ɤ r ɡ ɐ f
подозра	p o d o z r ɤ
миши	m i ʃ i
говорете	ɡ o v o r ɛ t ɛ
езерце	ɛ z ɛ r t͡s ɛ
било	b i ɫ o
сказуемо	s k ɐ z u ɛ m o
разум	r a z u m
абдоминален	ɐ b d o m i n a lʲ ɛ n
клоун	k ɫ ɔ u n
навестявам	n ɐ v ɛ s tʲ a v ɐ m
своя	s v ɔ j ɐ
вероятно	v ɛ r o j a t n o
кадифе	k ɐ d i f ɛ
велосипед	v ɛ ɫ o s i p ɛ t
прилика	p r i lʲ i k ɐ
обкова	o p k o v a
калинка	k ɐ lʲ i n k ɐ
кратък	k r a t ɐ k
началник	n ɐ t͡ʃ a ɫ n i k
лая	ɫ a j a
събитие	s ɐ b i t i ɛ
едновременен	ɛ d n o v r ɛ m ɛ n ɛ n
дреха	d r ɛ x ɐ
ялото	j a ɫ o t o
мрящата	m rʲ a ʃ t ɐ t ɐ
мърша	m ɤ r ʃ ɐ
шугав	ʃ u ɡ ɐ f
узаконявалият	u z ɐ k o nʲ a v ɐ lʲ i j ɐ t
мастит	m ɐ s t i t
сложа	s ɫ ɔ ʒ ɐ
августовски	a v ɡ u s t o f s kʲ i
слуга	s ɫ u ɡ a
сечко	s ɛ t͡ʃ k o
петалитър	p ɛ t ɐ lʲ i t ɐ r
падам	p a d ɐ m
царица	t͡s ɐ r i t͡s ɐ
тайван	t ɐ j v a n
наш	n a ʃ
матрак	m ɐ t r a k
плюто	p lʲ u t o
листояд	lʲ i s t o j a t
капя	k a pʲ ɐ
раждане	r a ʒ d ɐ n ɛ
хлебарка	x lʲ ɛ b a r k ɐ
ваксина	v ɐ k s i n ɐ
фобос	f ɔ b o s
безформен	b ɛ s f ɔ r m ɛ n
чедо	t͡ʃ ɛ d o
император	i m p ɛ r a t o r
благой	b ɫ ɐ ɡ ɔ j
задача	z ɐ d a t͡ʃ ɐ
избоде	i z b o d ɛ
бръзгам	b r ɤ z ɡ ɐ m
поисквам	p o i s k v ɐ m
любеница	lʲ u b ɛ n i t͡s ɐ
черешарка	t͡ʃ ɛ r ɛ ʃ a r k ɐ
доверие	d o v ɛ r i ɛ
архитектурен	ɐ r xʲ i t ɛ k t u r ɛ n
повярвам	p o vʲ a r v ɐ m
ядената	j a d ɛ n ɐ t ɐ
рудник	r u d n i k
променя	p r o m ɛ nʲ a
свързан	s v ɤ r z ɐ n
сенокосец	s ɛ n o k ɔ s ɛ t͡s
автомотриса	a f t o m o t r i s ɐ
пречупя	p r ɛ t͡ʃ u pʲ ɐ
реша	r ɛ ʃ ɤ
енклитичен	ɛ n k lʲ i t i t͡ʃ ɛ n
чуждица	t͡ʃ u ʒ d i t͡s ɐ
техен	t ɛ xʲ ɛ n
сияехме	s i j a ɛ x m ɛ
редактиране	r ɛ d ɐ k t i r ɐ n ɛ
еврейка	ɛ v r ɛ j k ɐ
потурнак	p o t u r n a k
между	m ɛ ʒ d u
роба	r ɔ b ɐ
коприварче	k o p r i v a r t͡ʃ ɛ
ландшафт	ɫ a n t ʃ ɐ f t
грънчарница	ɡ r ɐ n t͡ʃ a r n i t͡s ɐ
гълъбица	ɡ ɐ ɫ ɐ b i t͡s ɐ
адаш	ɐ d a ʃ
ястребов	j a s t r ɛ b o f
боядисам	b o j ɐ d i s ɐ m
щем	ʃ t ɛ m
напълно	n ɐ p ɤ ɫ n o
неголям	n ɛ ɡ o lʲ ɐ m
иманета	i m ɐ n ɛ t ɐ
зрете	z r ɛ t ɛ
портрет	p o r t r ɛ t
ран	r a n
кей	kʲ ɛ j
лейди	lʲ ɛ j d i
ядяхме	j a dʲ a x m ɛ
бръндза	b r ɤ n d z ɐ
квачка	k v a t͡ʃ k ɐ
сърце	s ɐ r t͡s ɛ
леща	lʲ ɛ ʃ t ɐ
числително	t͡ʃ i s lʲ i t ɛ ɫ n o
изпълвам	i s p ɤ ɫ v ɐ m
трескав	t r ɛ s k ɐ f
иглика	i ɡ lʲ i k ɐ
мацка	m a t͡s k ɐ
поличба	p o lʲ i d͡ʒ b ɐ
авантюристичен	ɐ v ɐ n tʲ u r i s t i t͡ʃ ɛ n
властник	v ɫ a s n i k
бъдете	b ɐ d ɛ t ɛ
позлата	p o z ɫ a t ɐ
кале	k ɐ lʲ ɛ
царкиня	t͡s ɐ r kʲ i nʲ ɐ
аперитив	a p ɛ r i t i f
говорихме	ɡ o v o r i x m ɛ
безделнича	b ɛ z d ɛ ɫ n i t͡ʃ ɐ
лъскав	ɫ ɤ s k ɐ f
узаконяха	u z ɐ k o nʲ a x ɐ
пошъл	p ɔ ʃ ɐ ɫ
мъка	m ɤ k ɐ
куя	k u j ɐ
цирконий	t͡s i r k ɔ n i
аджемилък	ɐ d ʒ ɛ m i ɫ ɤ k
изговори	i z ɡ o v o r i
ваш	v a ʃ
носия	n o s i j ɐ
боб	b ɔ p
криеница	k r i ɛ n i t͡s ɐ
вън	v ɤ n
сияхте	s i j a x t ɛ
против	p r o t i f
членестоного	t͡ʃ lʲ ɛ n ɛ s t o n ɔ ɡ o
гигаметър	ɡʲ i ɡ ɐ m ɛ t ɐ r
щипалка	ʃ t i p a ɫ k ɐ
ват	v a t
версия	v ɛ r s i j ɐ
девет	d ɛ v ɛ t
месец	m ɛ s ɛ t͡s
доведа	d o v ɛ d ɤ
хлорофил	x ɫ o r o f i ɫ
луча	ɫ u t͡ʃ ɐ
жираф	ʒ i r a f
апелационен	ɐ p ɛ ɫ ɐ t͡s i ɔ n ɛ n
шебой	ʃ ɛ b ɔ j
особняк	o s o b nʲ a k
просба	p r ɔ z b ɐ
плъх	p ɫ ɤ x
дроб	d r ɔ p
медицина	m ɛ d i t͡s i n ɐ
мраз	m r a s
неговото	n ɛ ɡ o v o t o
здание	z d a n i ɛ
единайсет	ɛ d i n a j s ɛ t
козле	k o z lʲ ɛ
смядов	s mʲ a d o f
багер	b a ɡʲ ɛ r
чинно	t͡ʃ i n n o
челяд	t͡ʃ ɛ lʲ ɐ t
нещастие	n ɛ ʃ t a s t i ɛ
барок	b ɐ r ɔ k
наоколо	n ɐ ɔ k o ɫ o
снощи	s n ɔ ʃ t i
мряхме	m rʲ a x m ɛ
ясмин	j ɐ s m i n
какви	k ɐ k v i
бяхте	bʲ a x t ɛ
опак	ɔ p ɐ k
зряхте	z rʲ a x t ɛ
мрящо	m rʲ a ʃ t o
протоме	p r o t ɔ m ɛ
панаир	p ɐ n ɐ i r
шести	ʃ ɛ s t i
струга	s t r u ɡ ɐ
традиция	t r ɐ d i t͡s i j ɐ
април	ɐ p r i ɫ
врабей	v r a b ɛ j
бухал	b u x ɐ ɫ
пряспа	p rʲ a s p ɐ
послушко	p o s ɫ u ʃ k o
често	t͡ʃ ɛ s t o
владичица	v ɫ ɐ d i t͡ʃ i t͡s ɐ
мрене	m r ɛ n ɛ
волан	v o ɫ a n
срака	s r a k ɐ
липса	lʲ i p s ɐ
лещарка	lʲ ɛ ʃ t a r k ɐ
легна	lʲ ɛ ɡ n a
легнете	lʲ ɛ ɡ n ɛ t ɛ
глуж	ɡ ɫ u ʃ
работничка	r ɐ b ɔ t n i t͡ʃ k ɐ
величавост	v ɛ lʲ i t͡ʃ a v o s t
скръндза	s k r ɤ n d z ɐ
ваште	v a ʃ t ɛ
приема	p r i ɛ m ɐ
загуба	z a ɡ u b ɐ
директор	d i r ɛ k t o r
нивя	n i vʲ a
доволен	d o v ɔ lʲ ɛ n
школа	ʃ k ɔ ɫ ɐ
автентичен	a f t ɛ n t i t͡ʃ ɛ n
рафт	r a f t
веселие	v ɛ s ɛ lʲ i ɛ
фокус	f ɔ k u s
небесносин	n ɛ b ɛ s n o s i n
сестричка	s ɛ s t r i t͡ʃ k ɐ
въвра	v ɐ v r ɤ
бог	b ɔ k
кочи	k ɔ t͡ʃ i
тези	t ɛ z i
къртичи	k ɐ r t i t͡ʃ i
пасохме	p a s o x m ɛ
говедо	ɡ o v ɛ d o
огорчен	o ɡ o r t͡ʃ ɛ n
диван	d i v a n
сънища	s ɤ n i ʃ t ɐ
червив	t͡ʃ ɛ r v i f
сладък	s ɫ a d ɐ k
принц	p r i n t͡s
австралия	ɐ f s t r a lʲ i j ɐ
господарство	ɡ o s p o d a r s t v o
англия	a n ɡ lʲ i j ɐ
всуе	f s u ɛ
наша	n a ʃ ɐ
обвиня	o b v i nʲ ɤ
съчетавам	s ɐ t͡ʃ ɛ t a v ɐ m
равен	r a v ɛ n
нейни	n ɛ j n i
меля	m ɛ lʲ ɐ
яденето	j a d ɛ n ɛ t o
местоимение	m ɛ s t o i m ɛ n i ɛ
всъщност	f s ɤ ʃ n o s t
одринлия	ɔ d r i n lʲ i j ɐ
подлец	p o d lʲ ɛ t͡s
дори	d o r i
прощален	p r o ʃ t a lʲ ɛ n
оцет	o t͡s ɛ t
храм	x r a m
ром	r ɔ m
недалечен	n ɛ d ɐ lʲ ɛ t͡ʃ ɛ n
джийн	d ʒ i n
шептя	ʃ ɛ p tʲ ɤ
гуде	ɡ u d ɛ
президент	p r ɛ z i d ɛ n t
чуващият	t͡ʃ u v ɐ ʃ t i j ɐ t
гуна	ɡ u n ɐ
чародей	t͡ʃ ɐ r o d ɛ j
парите	p ɐ r i t ɛ
стилов	s t i ɫ o f
смятам	s mʲ a t ɐ m
заплаши	z ɐ p ɫ a ʃ i
крастав	k r a s t ɐ f
плувам	p ɫ u v ɐ m
виме	v i m ɛ
остана	o s t a n ɐ
мързелив	m ɐ r z ɛ lʲ i f
имащия	i m ɐ ʃ t i j ɐ
делфин	d ɛ ɫ f i n
комитет	k o m i t ɛ t
окръжен	o k r ɤ ʒ ɛ n
получа	p o ɫ u t͡ʃ ɐ
светлик	s v ɛ t lʲ i k
каква	k ɐ k v a
коледа	k ɔ lʲ ɛ d ɐ
дългуч	d ɐ ɫ ɡ u t͡ʃ
работя	r ɐ b ɔ tʲ ɐ
нобелий	n o b ɛ lʲ i
нашта	n a ʃ t ɐ
рухо	r u x o
управителка	u p r a v i t ɛ ɫ k ɐ
домете	d o m ɛ t ɛ
автогара	a f t o ɡ a r ɐ
русин	r u s i n
разшифровам	r ɐ ʃ ʃ i f r ɔ v ɐ m
абревиатура	a b r ɛ v i ɐ t u r ɐ
киноцентър	kʲ i n o t͡s ɛ n t ɐ r
телефон	t ɛ lʲ ɛ f ɔ n
бая	b ɐ j a
балнеолечение	b a ɫ n ɛ o lʲ ɛ t͡ʃ ɛ n i ɛ
дебляци	d ɛ b lʲ ɐ t͡s i
пасящия	p ɐ sʲ a ʃ t i j ɐ
коларница	k o ɫ a r n i t͡s ɐ
кислород	kʲ i s ɫ o r ɔ t
пряк	p rʲ a k
деспотство	d ɛ s p ɔ t s v o
татба	t a d b ɐ
анализ	ɐ n a lʲ i s
балкон	b ɐ ɫ k ɔ n
богат	b o ɡ a t
чукундур	t͡ʃ u k u n d u r
ялите	j a lʲ i t ɛ
оберон	ɔ b ɛ r o n
мъхнат	m ɐ x n a t
запреда	z ɐ p r ɛ d ɤ
татко	t a t k o
пациентка	p ɐ t͡s i ɛ n t k ɐ
хващам	x v a ʃ t ɐ m
плавей	p ɫ a v ɛ j
димитър	d i m i t ɐ r
дружба	d r u ʒ b ɐ
канара	k ɐ n ɐ r a
ганимед	ɡ ɐ n i m ɛ t
бяг	bʲ a k
къщо	k ɤ ʃ t o
скарабей	s k ɐ r ɐ b ɛ j
спра	s p r ɤ
коля	k ɔ lʲ ɐ
мафия	m a f i j ɐ
предмет	p r ɛ d m ɛ t
плута	p ɫ u t ɐ
вожд	v ɔ ʃ t
хулиганство	x u lʲ i ɡ a n s t v o
техния	t ɛ x n i j ɐ
западняк	z ɐ p ɐ d nʲ a k
брия	b r i j ɐ
мрелият	m r ɛ lʲ i j ɐ t
собол	s o b ɔ ɫ
деспотизъм	d ɛ s p o t i z ɐ m
движа	d v i ʒ ɐ
би	b i
отличим	o t lʲ i t͡ʃ i m
гавед	ɡ a v ɛ t
гърбав	ɡ ɐ r b a f
узаконели	u z ɐ k o n ɛ lʲ i
петънце	p ɛ t ɐ n t͡s ɛ
похват	p o x v a t
доя	d o j ɤ
дециметър	d ɛ t͡s i m ɛ t ɐ r
образование	o b r ɐ z o v a n i ɛ
хвърля	x v ɤ r lʲ ɐ
треса	t r ɛ s ɤ
лис	lʲ i s
акушерка	ɐ k u ʃ ɛ r k ɐ
принудя	p r i n u dʲ ɐ
злъч	z ɫ ɤ t͡ʃ
гриза	ɡ r i z a
кълвач	k ɐ ɫ v a t͡ʃ
техният	t ɛ x n i j ɐ t
каменарка	k ɐ m ɛ n a r k ɐ
уши	u ʃ i
напротив	n ɐ p r ɔ t i f
юха	j u x a
златен	z ɫ a t ɛ n
долина	d o lʲ i n a
белтък	b ɛ ɫ t ɤ k
долен	d ɔ lʲ ɛ n
цент	t͡s ɛ n t
анасон	ɐ n ɐ s ɔ n
мерзавец	m ɛ r z a v ɛ t͡s
плутоний	p ɫ u t ɔ n i
безопасност	b ɛ z o p a s n o s t
съблазнявам	s ɐ b ɫ ɐ z nʲ a v ɐ m
загреб	z a ɡ r ɛ p
магнетофон	m ɐ ɡ n ɛ t o f ɔ n
кралство	k r a ɫ s t v o
правя	p r a vʲ ɐ
подозирам	p o d o z i r ɐ m
фиорд	f i ɔ r t
яли	j a lʲ i
влагалище	v ɫ ɐ ɡ a lʲ i ʃ t ɛ
копаница	k ɔ p ɐ n i t͡s ɐ
рунтав	r u n t ɐ f
лихва	lʲ i x v ɐ
агония	ɐ ɡ ɔ n i j ɐ
съдба	s ɐ d b a
връв	v r ɤ f
радвам	r a d v ɐ m
хълм	x ɤ ɫ m
сестрински	s ɛ s t r i n s kʲ i
тръпчив	t r ɐ p t͡ʃ i f
китайски	kʲ i t a j s kʲ i
деактивирам	d ɛ ɐ k t i v i r ɐ m
тоалет	t o ɐ lʲ ɛ t
снасям	s n a sʲ ɐ m
покрай	p o k r a j
превъзхождам	p r ɛ v ɐ s x ɔ ʒ d ɐ m
атентат	ɐ t ɛ n t a t
гълъб	ɡ ɤ ɫ ɐ p
рубидий	r u b i d i
гостилница	ɡ o s t i ɫ n i t͡s ɐ
учебник	u t͡ʃ ɛ b n i k
узаконихте	u z ɐ k o n i x t ɛ
арабски	ɐ r a p s kʲ i
възрастта	v ɐ z r ɐ s t a
изгубя	i z ɡ u bʲ ɐ
сприхав	s p r i x ɐ f
имаше	i m ɐ ʃ ɛ
почивш	p o t͡ʃ i f ʃ
охрид	o x r i t
ръждав	r ɐ ʒ d a f
вея	v ɛ j ɐ
поднеса	p o d n ɛ s ɤ
преперец	p r ɛ p ɛ r ɛ t͡s
християнин	x r i s t i j a n i n
сатрап	s ɐ t r a p
панталон	p ɐ n t ɐ ɫ ɔ n
серен	s ɛ r ɛ n
станой	s t ɐ n ɔ j
увал	u v a ɫ
вегав	v ɛ ɡ ɐ f
диалект	d i ɐ lʲ ɛ k t
рений	r ɛ n i
предишен	p r ɛ d i ʃ ɛ n
варя	v a rʲ ɐ
да	d a
патърдия	p ɐ t ɐ r d i j ɐ
веднага	v ɛ d n a ɡ ɐ
бодил	b o d i ɫ
плащ	p ɫ a ʃ t
банкнота	b ɐ n k n ɔ t ɐ
общ	ɔ p ʃ t
изказване	i s k a z v ɐ n ɛ
ме	m ɛ
лютив	lʲ u t i f
определен	o p r ɛ d ɛ lʲ ɛ n
плащам	p ɫ a ʃ t ɐ m
мас	m a s
саксия	s ɐ k s i j ɐ
ушия	u ʃ i j ɐ
пищен	p i ʃ t ɛ n
превъзнеса	p r ɛ v ɐ z n ɛ s ɤ
възел	v ɤ z ɛ ɫ
завеждам	z ɐ v ɛ ʒ d ɐ m
мекотело	m ɛ k o t ɛ ɫ o
гледка	ɡ lʲ ɛ t k ɐ
озаглавя	o z ɐ ɡ ɫ ɐ vʲ ɤ
молив	m o lʲ i f
кафе	k ɐ f ɛ
невъзможно	n ɛ v ɐ z m ɔ ʒ n o
байно	b a j n o
господин	ɡ o s p o d i n
камък	k a m ɐ k
бастилия	b ɐ s t i lʲ i j ɐ
узаконяването	u z ɐ k o nʲ a v ɐ n ɛ t o
щедър	ʃ t ɛ d ɐ r
пасящото	p ɐ sʲ a ʃ t o t o
кой	k ɔ j
стена	s t ɛ n a
капак	k ɐ p a k
огорча	o ɡ o r t͡ʃ a
много	m n ɔ ɡ o
бразилия	b r ɐ z i lʲ i j ɐ
скок	s k ɔ k
ярък	j a r ɐ k
клюн	k lʲ u n
абдикиралата	ɐ b d i kʲ i r ɐ ɫ ɐ t ɐ
мях	mʲ a x
накъде	n ɐ k ɐ d ɛ
уплаши	u p ɫ a ʃ i
извиквам	i z v i k v ɐ m
мрялото	m rʲ a ɫ o t o
белезници	b ɛ lʲ ɛ z n i t͡s i
тиква	t i k v ɐ
узаконявайте	u z ɐ k o nʲ a v ɐ j t ɛ
апсида	ɐ p s i d ɐ
напредък	n ɐ p r ɛ d ɐ k
култура	k u ɫ t u r ɐ
братски	b r a t s kʲ i
кърджалия	k ɐ r d ʒ a lʲ i j ɐ
никое	n i k o ɛ
разсипия	r ɐ s s i p i j ɐ
барий	b a r i
дърва	d ɐ r v a
лесно	lʲ ɛ s n o
който	k ɔ j t o
ядяща	j a dʲ a ʃ t ɐ
азе	a z ɛ
радой	r ɐ d ɔ j
бележа	b ɛ lʲ ɛ ʒ ɐ
зърна	z ɤ r n ɐ
изтребител	i s t r ɛ b i t ɛ ɫ
падна	p a d n ɐ
отнасям	o t n a sʲ ɐ m
двигател	d v i ɡ ɐ t ɛ ɫ
рехабилитационен	r ɛ x ɐ b i lʲ i t ɐ t͡s i ɔ n ɛ n
тръне	t r ɤ n ɛ
благодарност	b ɫ ɐ ɡ o d a r n o s t
чвор	t͡ʃ v ɔ r
годинак	ɡ o d i n a k
раждам	r a ʒ d ɐ m
глух	ɡ ɫ u x
лют	lʲ u t
овци	o f t͡s i
очен	ɔ t͡ʃ ɛ n
имана	i m ɐ n ɐ
производство	p r o i z v ɔ t s t v o
фикус	f i k u s
чуждестранен	t͡ʃ u ʒ d ɛ s t r a n ɛ n
парк	p a r k
торта	t ɔ r t ɐ
ляво	lʲ a v o
амвон	ɐ m v ɔ n
хелий	xʲ ɛ lʲ i
посетител	p o s ɛ t i t ɛ ɫ
лъч	ɫ ɤ t͡ʃ
твърд	t v ɤ r t
аташе	ɐ t ɐ ʃ ɛ
упреквам	u p r ɛ k v ɐ m
грапав	ɡ r a p ɐ f
ами	ɐ m i
опашка	o p a ʃ k ɐ
изслушвам	i s ɫ u ʃ v ɐ m
мегаметър	m ɛ ɡ ɐ m ɛ t ɐ r
сценарий	s t͡s ɛ n a r i
камшик	k ɐ m ʃ i k
целува	t͡s ɛ ɫ u v a
юпитер	j u p i t ɛ r
глупачка	ɡ ɫ u p a t͡ʃ k ɐ
вашето	v a ʃ ɛ t o
смрадливец	s m r ɐ d lʲ i v ɛ t͡s
университет	u n i v ɛ r s i t ɛ t
автобус	ɐ f t o b u s
ибис	i b i s
матерен	m a t ɛ r ɛ n
кралица	k r ɐ lʲ i t͡s ɐ
етажерка	ɛ t ɐ ʒ ɛ r k ɐ
краен	k r a ɛ n
оскъден	o s k ɤ d ɛ n
елит	ɛ lʲ i t
окрада	o k r ɐ d ɤ
невъзможен	o o o o o
юбилей	j u b i lʲ ɛ j
почвам	p ɔ t͡ʃ v ɐ m
тромав	t r ɔ m ɐ f
моя	m ɔ j ɐ
нар	n a r
контакт	k o n t a k t
топлик	t o p lʲ i k
картал	k ɐ r t a ɫ
седалка	s ɛ d a ɫ k ɐ
спасявам	s p ɐ sʲ a v ɐ m
бандит	b ɐ n d i t
причастие	p r i t͡ʃ a s t i ɛ
тъмен	t ɤ m ɛ n
католически	k ɐ t o lʲ i t͡ʃ ɛ s kʲ i
въртошийка	v ɐ r t o ʃ i k ɐ
дрозд	d r ɔ s t
петрол	p ɛ t r ɔ ɫ
деветнадесет	d ɛ v ɛ t n a d ɛ s ɛ t
свят	s vʲ a t
пасене	p ɐ s ɛ n ɛ
извличам	i z v lʲ i t͡ʃ ɐ m
корем	k o r ɛ m
ищах	i ʃ t a x
огън	ɔ ɡ ɐ n
колибри	k o lʲ i b r i
русло	r u s ɫ o
сматрям	s m a t rʲ ɐ m
кафенета	k ɐ f ɛ n ɛ t ɐ
носорог	n o s o r ɔ k
редя	r ɛ dʲ a
късно	k ɤ s n o
диаграма	d i ɐ ɡ r a m ɐ
желаещ	ʒ ɛ ɫ a ɛ ʃ t
свръхякане	s v r ɐ xʲ a k ɐ n ɛ
институт	i n s t i t u t
използвам	i s p ɔ ɫ z v ɐ m
труден	t r u d ɛ n
разногласие	r ɐ z n o ɡ ɫ a s i ɛ
глота	ɡ ɫ ɔ t ɐ
дома	d o m a
кралски	k r a ɫ s kʲ i
узаконена	u z ɐ k o n ɛ n ɐ
язовец	j a z o v ɛ t͡s
джип	d ʒ i p
боязън	b o j a z ɐ n
непорочност	n ɛ p o r ɔ t͡ʃ n o s t
направя	n ɐ p r a vʲ ɐ
ексалитър	ɐ t o lʲ i t ɐ r
абразивен	ɐ b r ɐ z i v ɛ n
стилист	s t i lʲ i s t
легализирам	lʲ ɛ ɡ ɐ lʲ i z i r ɐ m
вериго	v ɛ r i ɡ o
сладкарница	s ɫ ɐ t k a r n i t͡s ɐ
нула	n u ɫ a
приятен	p r i j a t ɛ n
бетонен	b ɛ t ɔ n ɛ n
гнилоч	ɡ n i ɫ ɔ t͡ʃ
светиня	s v ɛ t i nʲ ɐ
двуличен	d v u lʲ i t͡ʃ ɛ n
благ	b ɫ a k
удобен	u d ɔ b ɛ n
сърбин	s ɤ r b i n
трици	t r i t͡s i
ванадий	v ɐ n a d i
мрялата	m rʲ a ɫ ɐ t ɐ
вар	v a r
правилно	p r a v i ɫ n o
валог	v a ɫ o k
заявя	z ɐ j a vʲ a
сръбски	s r ɤ p s kʲ i
надежден	n ɐ d ɛ ʒ d ɛ n
смъртник	s m ɤ r t n i k
миризма	m i r i z m a
деепричастие	d ɛ ɛ p r i t͡ʃ a s t i ɛ
чуваш	t͡ʃ u v ɐ ʃ
имал	i m a ɫ
съвършенство	s ɐ v ɐ r ʃ ɛ n s t v o
манган	m ɐ n ɡ a n
ревност	r ɛ v n o s t
знак	z n a k
нелеп	n ɛ lʲ ɛ p
прегиня	p r ɛ ɡʲ i nʲ ɐ
отвръщам	o t v r ɤ ʃ t ɐ m
пубер	p u b ɛ r
бидейки	b i d ɛ j kʲ i
основа	o s n ɔ v ɐ
сърпоклюн	s ɐ r p o k lʲ u n
щяла	ʃ tʲ a ɫ ɐ
мамут	m ɐ m u t
столова	s t o ɫ ɔ v ɐ
разболявам	r ɐ z b o lʲ a v ɐ m
узаконят	u z ɐ k o nʲ ɤ t
другар	d r u ɡ a r
чорба	t͡ʃ o r b a
хардуер	x a r d u ɛ r
януари	j ɐ n u a r i
леко	lʲ ɛ k o
пръчица	p r ɤ t͡ʃ i t͡s ɐ
гигантски	ɡʲ i ɡ a n t s kʲ i
дълбочина	d ɐ ɫ b o t͡ʃ i n a
сиях	s i j a x
нож	n ɔ ʃ
временен	v r ɛ m ɛ n ɛ n
немощен	n ɛ m o ʃ t ɛ n
дума	d u m ɐ
изток	i s t o k
обущарница	o b u ʃ t a r n i t͡s ɐ
усмихвам	u s m i x v ɐ m
благословия	b ɫ ɐ ɡ o s ɫ o v i j ɐ
ухо	u x ɔ
ястреб	j a s t r ɛ p
сви	s v i
мултикултурализъм	m u ɫ t i k u ɫ t u r ɐ lʲ i z ɐ m
асансьор	ɐ s ɐ n sʲ ɔ r
повтором	p o f t ɔ r o m
кулминационен	k u ɫ m i n ɐ t͡s i ɔ n ɛ n
германски	ɡʲ ɛ r m a n s kʲ i
гибел	ɡʲ i b ɛ ɫ
багър	b a ɡ ɐ r
годеница	ɡ o d ɛ n i t͡s ɐ
безплатен	b ɛ s p ɫ a t ɛ n
аргатин	ɐ r ɡ a t i n
корона	k o r ɔ n ɐ
подбел	p ɔ d b ɛ ɫ
аерометър	a ɛ r o m ɛ t ɐ r
суровина	s u r o v i n a
